cbsa_code,cbsa_name_full,year,permits_sf,permits_mf,permits_tot,population,permits_per_capita
10100,"Aberdeen, SD",1990,54,26,80,39854,2.00732674261053
10100,"Aberdeen, SD",1991,43,16,59,39813,1.48192801346294
10100,"Aberdeen, SD",1992,77,8,85,39929,2.12877858198302
10100,"Aberdeen, SD",1993,71,17,88,40064,2.19648562300319
10100,"Aberdeen, SD",1994,62,22,84,40108,2.094345267777
10100,"Aberdeen, SD",1995,80,33,113,40170,2.81304456061738
10100,"Aberdeen, SD",1996,57,145,202,40194,5.02562571528089
10100,"Aberdeen, SD",1997,45,6,51,39912,1.27781118460613
10100,"Aberdeen, SD",1998,44,9,53,39590,1.33872189946956
10100,"Aberdeen, SD",1999,60,12,72,39390,1.82787509520183
10100,"Aberdeen, SD",2000,61,56,117,39825,2.93785310734463
10100,"Aberdeen, SD",2001,71,16,87,39602,2.19685874450785
10100,"Aberdeen, SD",2002,97,66,163,39417,4.13527158332699
10100,"Aberdeen, SD",2003,87,24,111,39419,2.81590096146528
10100,"Aberdeen, SD",2004,123,13,136,39440,3.44827586206897
10100,"Aberdeen, SD",2005,127,21,148,39569,3.74030175137102
10100,"Aberdeen, SD",2006,112,18,130,39604,3.28249671750328
10100,"Aberdeen, SD",2007,141,46,187,39847,4.69295053579943
10100,"Aberdeen, SD",2008,141,14,155,39915,3.88325191030941
10100,"Aberdeen, SD",2009,126,173,299,40219,7.43429722270569
10100,"Aberdeen, SD",2010,101,90,191,40717,4.6909153424859404
10100,"Aberdeen, SD",2011,131,92,223,40962,5.44407011376398
10100,"Aberdeen, SD",2012,139,203,342,41576,8.22589955743698
10100,"Aberdeen, SD",2013,141,177,318,42155,7.54358913533389
10100,"Aberdeen, SD",2014,91,69,160,42220,3.78967314069162
10100,"Aberdeen, SD",2015,92,97,189,42404,4.45712668616168
10100,"Aberdeen, SD",2016,109,0,109,42849,2.54381665849845
10100,"Aberdeen, SD",2017,84,72,156,43235,3.60818781080143
10100,"Aberdeen, SD",2018,63,20,83,43191,1.921696649765
10140,"Aberdeen, WA",1990,126,2,128,64397,1.98767023308539
10140,"Aberdeen, WA",1991,163,6,169,64650,2.61407579273008
10140,"Aberdeen, WA",1992,185,13,198,65418,3.02668990186187
10140,"Aberdeen, WA",1993,197,55,252,65992,3.81864468420415
10140,"Aberdeen, WA",1994,207,104,311,66647,4.66637658109142
10140,"Aberdeen, WA",1995,215,15,230,67277,3.41870178515689
10140,"Aberdeen, WA",1996,341,94,435,67769,6.41886408239756
10140,"Aberdeen, WA",1997,235,65,300,68030,4.40981919741291
10140,"Aberdeen, WA",1998,180,52,232,67477,3.43820857477363
10140,"Aberdeen, WA",1999,189,28,217,67278,3.22542287226136
10140,"Aberdeen, WA",2000,186,34,220,67075,3.27991054789415
10140,"Aberdeen, WA",2001,207,11,218,67896,3.21079297749499
10140,"Aberdeen, WA",2002,218,8,226,68264,3.310676198289
10140,"Aberdeen, WA",2003,291,38,329,69065,4.76362846593788
10140,"Aberdeen, WA",2004,294,76,370,69775,5.30275886778932
10140,"Aberdeen, WA",2005,335,85,420,70423,5.96396063785979
10140,"Aberdeen, WA",2006,444,89,533,71256,7.48007185359829
10140,"Aberdeen, WA",2007,462,41,503,71827,7.00293761398917
10140,"Aberdeen, WA",2008,250,84,334,72027,4.63714995765477
10140,"Aberdeen, WA",2009,142,24,166,72468,2.29066622509245
10140,"Aberdeen, WA",2010,163,3,166,72843,2.27887374215779
10140,"Aberdeen, WA",2011,104,10,114,72357,1.57552137319126
10140,"Aberdeen, WA",2012,125,0,125,71770,1.74167479448237
10140,"Aberdeen, WA",2013,122,0,122,71046,1.71719730878586
10140,"Aberdeen, WA",2014,140,2,142,70783,2.00613141573542
10140,"Aberdeen, WA",2015,174,4,178,71027,2.5060892336717
10140,"Aberdeen, WA",2016,207,0,207,71572,2.89219247750517
10140,"Aberdeen, WA",2017,251,0,251,72553,3.45953992253939
10140,"Aberdeen, WA",2018,455,8,463,73901,6.26513849609613
10180,"Abilene, TX",1990,109,13,122,147693,0.826037794614504
10180,"Abilene, TX",1991,148,4,152,146701,1.03612108983579
10180,"Abilene, TX",1992,275,8,283,148648,1.90382648942468
10180,"Abilene, TX",1993,300,18,318,150992,2.10607184486595
10180,"Abilene, TX",1994,264,202,466,151259,3.0808084147059
10180,"Abilene, TX",1995,243,182,425,152929,2.7790674103669
10180,"Abilene, TX",1996,258,128,386,152568,2.53001940118504
10180,"Abilene, TX",1997,224,3,227,153007,1.48359225394917
10180,"Abilene, TX",1998,262,4,266,153264,1.73556738699238
10180,"Abilene, TX",1999,189,6,195,154098,1.26542849355605
10180,"Abilene, TX",2000,171,210,381,160288,2.3769714513875
10180,"Abilene, TX",2001,178,412,590,158917,3.71262986338781
10180,"Abilene, TX",2002,165,28,193,159012,1.21374487460066
10180,"Abilene, TX",2003,199,22,221,158810,1.39160002518733
10180,"Abilene, TX",2004,283,8,291,160156,1.81697844601514
10180,"Abilene, TX",2005,310,36,346,160761,2.15226329769036
10180,"Abilene, TX",2006,333,32,365,161389,2.26161634312128
10180,"Abilene, TX",2007,283,10,293,162023,1.80838522925757
10180,"Abilene, TX",2008,190,6,196,162508,1.20609446919536
10180,"Abilene, TX",2009,214,0,214,163888,1.30576979400566
10180,"Abilene, TX",2010,272,118,390,165583,2.35531425327479
10180,"Abilene, TX",2011,153,6,159,166616,0.954290104191674
10180,"Abilene, TX",2012,241,214,455,167447,2.71727770578153
10180,"Abilene, TX",2013,292,14,306,167472,1.82717110920034
10180,"Abilene, TX",2014,284,0,284,168355,1.68691158563749
10180,"Abilene, TX",2015,303,232,535,169704,3.15254796586999
10180,"Abilene, TX",2016,298,8,306,170018,1.7998094319425
10180,"Abilene, TX",2017,282,40,322,170516,1.88838584062493
10180,"Abilene, TX",2018,335,22,357,171451,2.08222757522557
10220,"Ada, OK",1990,6,0,6,34101,0.175947919415853
10220,"Ada, OK",1991,17,0,17,34022,0.499676679795427
10220,"Ada, OK",1992,14,0,14,33918,0.412760186331741
10220,"Ada, OK",1993,23,0,23,33944,0.677586613245345
10220,"Ada, OK",1994,15,8,23,34185,0.672809711861928
10220,"Ada, OK",1995,18,0,18,34572,0.520652551197501
10220,"Ada, OK",1996,19,0,19,34937,0.54383604774308
10220,"Ada, OK",1997,21,0,21,34625,0.606498194945848
10220,"Ada, OK",1998,17,0,17,34631,0.490889665328752
10220,"Ada, OK",1999,18,0,18,34561,0.520818263360435
10220,"Ada, OK",2000,18,14,32,35148,0.910435871173324
10220,"Ada, OK",2001,19,12,31,34866,0.889118338782768
10220,"Ada, OK",2002,21,12,33,34929,0.944773683758481
10220,"Ada, OK",2003,23,10,33,35048,0.941565852545081
10220,"Ada, OK",2004,25,8,33,35097,0.940251303530216
10220,"Ada, OK",2005,20,2,22,35267,0.623812629370233
10220,"Ada, OK",2006,34,58,92,35525,2.58972554539057
10220,"Ada, OK",2007,23,0,23,36157,0.636114721907238
10220,"Ada, OK",2008,22,38,60,36687,1.63545670128383
10220,"Ada, OK",2009,60,0,60,37283,1.60931255532012
10220,"Ada, OK",2010,38,48,86,37599,2.28729487486369
10220,"Ada, OK",2011,5,0,5,37760,0.132415254237288
10220,"Ada, OK",2012,7,18,25,38080,0.656512605042017
10220,"Ada, OK",2013,15,2,17,38178,0.445282623500445
10220,"Ada, OK",2014,14,92,106,38308,2.76704604782291
10220,"Ada, OK",2015,21,6,27,38354,0.703968295353809
10220,"Ada, OK",2016,21,52,73,38525,1.89487345879299
10220,"Ada, OK",2017,25,0,25,38354,0.651822495697972
10220,"Ada, OK",2018,19,10,29,38247,0.758229403613355
10300,"Adrian, MI",1990,287,110,397,91783,4.32541974003901
10300,"Adrian, MI",1991,263,97,360,93351,3.85641289327377
10300,"Adrian, MI",1992,230,75,305,93945,3.24658044600564
10300,"Adrian, MI",1993,290,40,330,94823,3.4801683135948
10300,"Adrian, MI",1994,345,43,388,95321,4.07045666747097
10300,"Adrian, MI",1995,339,125,464,96326,4.81697568673048
10300,"Adrian, MI",1996,352,35,387,97068,3.98689578439857
10300,"Adrian, MI",1997,389,88,477,97886,4.87301554869951
10300,"Adrian, MI",1998,558,60,618,98657,6.26412722868119
10300,"Adrian, MI",1999,574,65,639,99782,6.40396063418252
10300,"Adrian, MI",2000,475,23,498,99069,5.02679950337643
10300,"Adrian, MI",2001,538,12,550,99626,5.52064722060506
10300,"Adrian, MI",2002,499,28,527,100293,5.25460401024997
10300,"Adrian, MI",2003,548,8,556,100704,5.52113123609787
10300,"Adrian, MI",2004,533,4,537,101216,5.30548529876699
10300,"Adrian, MI",2005,454,78,532,101367,5.24825633588841
10300,"Adrian, MI",2006,358,44,402,101715,3.95221943666126
10300,"Adrian, MI",2007,242,8,250,101657,2.45925022379177
10300,"Adrian, MI",2008,154,0,154,101169,1.52220541865591
10300,"Adrian, MI",2009,103,0,103,100250,1.02743142144638
10300,"Adrian, MI",2010,102,0,102,99635,1.02373663873137
10300,"Adrian, MI",2011,94,0,94,99337,0.946273795262591
10300,"Adrian, MI",2012,131,0,131,99004,1.32317886146014
10300,"Adrian, MI",2013,117,0,117,98803,1.18417456959809
10300,"Adrian, MI",2014,92,0,92,98737,0.931768232780012
10300,"Adrian, MI",2015,75,6,81,98385,0.82329623418204
10300,"Adrian, MI",2016,110,0,110,98499,1.11676260672697
10300,"Adrian, MI",2017,105,0,105,98482,1.06618468349546
10300,"Adrian, MI",2018,105,0,105,98266,1.06852828038182
10420,"Akron, OH",1990,2166,1166,3332,658573,5.05942393629863
10420,"Akron, OH",1991,2051,327,2378,664067,3.5809639689971
10420,"Akron, OH",1992,2441,1341,3782,669000,5.65321375186846
10420,"Akron, OH",1993,2564,451,3015,673025,4.47977415400617
10420,"Akron, OH",1994,2915,874,3789,676637,5.5997528955703
10420,"Akron, OH",1995,2526,566,3092,680386,4.54447916329848
10420,"Akron, OH",1996,2645,1253,3898,685162,5.68916548203199
10420,"Akron, OH",1997,2347,1360,3707,687033,5.39566512816706
10420,"Akron, OH",1998,2645,1368,4013,688288,5.83040820121809
10420,"Akron, OH",1999,3150,494,3644,690053,5.2807537971721
10420,"Akron, OH",2000,2576,766,3342,695946,4.80209671440026
10420,"Akron, OH",2001,2511,719,3230,698108,4.62679127011866
10420,"Akron, OH",2002,2182,452,2634,699533,3.76536918201143
10420,"Akron, OH",2003,2730,460,3190,701139,4.54973978055706
10420,"Akron, OH",2004,2480,454,2934,701811,4.18061272906808
10420,"Akron, OH",2005,2310,414,2724,702498,3.87759111057967
10420,"Akron, OH",2006,1746,463,2209,702433,3.14478391533427
10420,"Akron, OH",2007,1379,215,1594,703423,2.26606181486815
10420,"Akron, OH",2008,871,168,1039,703300,1.47732120005687
10420,"Akron, OH",2009,670,71,741,703361,1.05351306086064
10420,"Akron, OH",2010,657,79,736,703035,1.04688955741891
10420,"Akron, OH",2011,637,485,1122,703123,1.59573787232106
10420,"Akron, OH",2012,611,7,618,702080,0.880241567912489
10420,"Akron, OH",2013,666,24,690,703625,0.980635992183336
10420,"Akron, OH",2014,684,79,763,704921,1.08239079272713
10420,"Akron, OH",2015,792,175,967,704448,1.37270600526937
10420,"Akron, OH",2016,905,4,909,703690,1.29176199747048
10420,"Akron, OH",2017,901,19,920,704367,1.30613728354679
10420,"Akron, OH",2018,1011,199,1210,704845,1.71668948492222
10460,"Alamogordo, NM",1990,52,0,52,51791,1.00403545017474
10460,"Alamogordo, NM",1991,57,0,57,52076,1.09455411321914
10460,"Alamogordo, NM",1992,113,0,113,51869,2.17856523164125
10460,"Alamogordo, NM",1993,132,0,132,52870,2.4966899943257
10460,"Alamogordo, NM",1994,138,0,138,54267,2.54298192271546
10460,"Alamogordo, NM",1995,152,2,154,55159,2.79192878768651
10460,"Alamogordo, NM",1996,99,106,205,55537,3.69123287177917
10460,"Alamogordo, NM",1997,103,70,173,55396,3.12296916744891
10460,"Alamogordo, NM",1998,61,284,345,54363,6.34622813310524
10460,"Alamogordo, NM",1999,98,2,100,54147,1.84682438546919
10460,"Alamogordo, NM",2000,96,48,144,62151,2.31693778056668
10460,"Alamogordo, NM",2001,79,0,79,61277,1.2892276057901
10460,"Alamogordo, NM",2002,104,0,104,61194,1.69951302415269
10460,"Alamogordo, NM",2003,168,0,168,61371,2.73744928386371
10460,"Alamogordo, NM",2004,209,14,223,62662,3.55877565350611
10460,"Alamogordo, NM",2005,228,62,290,62533,4.63755137287512
10460,"Alamogordo, NM",2006,200,25,225,62200,3.61736334405145
10460,"Alamogordo, NM",2007,159,3,162,62466,2.59341081548362
10460,"Alamogordo, NM",2008,65,3,68,62498,1.08803481711415
10460,"Alamogordo, NM",2009,3,0,3,62462,0.0480292017546668
10460,"Alamogordo, NM",2010,2,0,2,64399,0.0310563828630879
10460,"Alamogordo, NM",2011,1,0,1,65644,0.015233684723661
10460,"Alamogordo, NM",2012,5,0,5,66226,0.0754990487119862
10460,"Alamogordo, NM",2013,4,0,4,66326,0.0603081747730905
10460,"Alamogordo, NM",2014,0,0,0,65362,0
10460,"Alamogordo, NM",2015,0,0,0,64739,0
10460,"Alamogordo, NM",2016,2,0,2,65644,0.0304673694473219
10460,"Alamogordo, NM",2017,4,0,4,66198,0.0604247862473187
10460,"Alamogordo, NM",2018,0,0,0,66781,0
10500,"Albany, GA",1990,352,109,461,142967,3.22452034385557
10500,"Albany, GA",1991,421,158,579,143874,4.02435464364652
10500,"Albany, GA",1992,450,227,677,145799,4.64337889834635
10500,"Albany, GA",1993,489,365,854,147324,5.79674730525916
10500,"Albany, GA",1994,544,303,847,148306,5.71116475395466
10500,"Albany, GA",1995,700,560,1260,148794,8.46808339045929
10500,"Albany, GA",1996,891,186,1077,150021,7.1789949407083
10500,"Albany, GA",1997,898,123,1021,150840,6.76876160169716
10500,"Albany, GA",1998,708,12,720,151320,4.75812846946868
10500,"Albany, GA",1999,727,26,753,151161,4.98144362633219
10500,"Albany, GA",2000,555,218,773,153585,5.03304359149656
10500,"Albany, GA",2001,600,18,618,153730,4.02003512652052
10500,"Albany, GA",2002,627,58,685,153024,4.47642199916353
10500,"Albany, GA",2003,611,296,907,152790,5.93625237253747
10500,"Albany, GA",2004,671,202,873,156911,5.56366347802257
10500,"Albany, GA",2005,689,62,751,156886,4.78691533980088
10500,"Albany, GA",2006,647,80,727,157412,4.61845348512185
10500,"Albany, GA",2007,463,127,590,157367,3.74919773523039
10500,"Albany, GA",2008,237,57,294,157551,1.86606241788373
10500,"Albany, GA",2009,183,30,213,157969,1.34836581860998
10500,"Albany, GA",2010,172,76,248,157589,1.57371390135098
10500,"Albany, GA",2011,182,24,206,157853,1.30501162473947
10500,"Albany, GA",2012,201,28,229,157349,1.45536355490025
10500,"Albany, GA",2013,222,35,257,156019,1.64723527262705
10500,"Albany, GA",2014,235,36,271,155248,1.74559414614037
10500,"Albany, GA",2015,166,37,203,153604,1.32158016718315
10500,"Albany, GA",2016,176,54,230,152353,1.50965192677532
10500,"Albany, GA",2017,411,5,416,151293,2.74963150971955
10500,"Albany, GA",2018,170,18,188,153009,1.2286858942938
10540,"Albany, OR",1990,140,17,157,91737,1.71141415132389
10540,"Albany, OR",1991,184,43,227,93385,2.43079723724367
10540,"Albany, OR",1992,223,89,312,94547,3.29994605857404
10540,"Albany, OR",1993,348,103,451,96135,4.69131949862173
10540,"Albany, OR",1994,321,307,628,97769,6.4233039102374
10540,"Albany, OR",1995,291,233,524,99927,5.24382799443594
10540,"Albany, OR",1996,342,48,390,101885,3.82784511949747
10540,"Albany, OR",1997,426,266,692,103591,6.68011699858096
10540,"Albany, OR",1998,503,301,804,104536,7.69113032830795
10540,"Albany, OR",1999,348,268,616,105459,5.84113257284822
10540,"Albany, OR",2000,369,143,512,103020,4.96990875558144
10540,"Albany, OR",2001,430,129,559,103544,5.39867109634551
10540,"Albany, OR",2002,544,24,568,104561,5.43223572842647
10540,"Albany, OR",2003,630,47,677,106035,6.384684302353
10540,"Albany, OR",2004,792,113,905,106799,8.47386211481381
10540,"Albany, OR",2005,865,150,1015,108132,9.38667554470462
10540,"Albany, OR",2006,783,108,891,110764,8.04412986168791
10540,"Albany, OR",2007,616,183,799,112932,7.07505401480537
10540,"Albany, OR",2008,260,280,540,114967,4.69700000869815
10540,"Albany, OR",2009,236,10,246,116001,2.12067137352264
10540,"Albany, OR",2010,161,13,174,116887,1.48861721149486
10540,"Albany, OR",2011,130,50,180,118155,1.52342262282595
10540,"Albany, OR",2012,152,76,228,118273,1.92774344102204
10540,"Albany, OR",2013,269,186,455,118416,3.84238616403189
10540,"Albany, OR",2014,270,123,393,119063,3.30077354005862
10540,"Albany, OR",2015,344,21,365,120244,3.03549449452779
10540,"Albany, OR",2016,395,10,405,122730,3.29992666829626
10540,"Albany, OR",2017,481,58,539,124977,4.31279355401394
10540,"Albany, OR",2018,446,94,540,127335,4.24078218871481
10580,"Albany-Schenectady-Troy, NY",1990,2062,791,2853,811248,3.5168037394237
10580,"Albany-Schenectady-Troy, NY",1991,2321,583,2904,817743,3.55123798063695
10580,"Albany-Schenectady-Troy, NY",1992,2527,541,3068,823324,3.72635803158902
10580,"Albany-Schenectady-Troy, NY",1993,2675,409,3084,826435,3.7316909375813
10580,"Albany-Schenectady-Troy, NY",1994,2267,600,2867,829030,3.45825844661834
10580,"Albany-Schenectady-Troy, NY",1995,1675,771,2446,828254,2.95320034675353
10580,"Albany-Schenectady-Troy, NY",1996,1696,860,2556,825442,3.09652283261574
10580,"Albany-Schenectady-Troy, NY",1997,1761,505,2266,821776,2.75744241739842
10580,"Albany-Schenectady-Troy, NY",1998,2248,1107,3355,820425,4.08934393759332
10580,"Albany-Schenectady-Troy, NY",1999,2258,582,2840,820502,3.46129564583633
10580,"Albany-Schenectady-Troy, NY",2000,2184,413,2597,827399,3.1387516784526
10580,"Albany-Schenectady-Troy, NY",2001,2377,532,2909,831034,3.50045846499662
10580,"Albany-Schenectady-Troy, NY",2002,2639,587,3226,836753,3.85537906646286
10580,"Albany-Schenectady-Troy, NY",2003,2602,620,3222,844619,3.81473776933742
10580,"Albany-Schenectady-Troy, NY",2004,2608,660,3268,850384,3.84296976424768
10580,"Albany-Schenectady-Troy, NY",2005,2284,1355,3639,854604,4.25811252931182
10580,"Albany-Schenectady-Troy, NY",2006,1836,614,2450,860365,2.8476286227357
10580,"Albany-Schenectady-Troy, NY",2007,1591,1112,2703,863068,3.13185056102184
10580,"Albany-Schenectady-Troy, NY",2008,1208,684,1892,866282,2.18404630362861
10580,"Albany-Schenectady-Troy, NY",2009,1109,271,1380,869361,1.58737279450079
10580,"Albany-Schenectady-Troy, NY",2010,1099,330,1429,871080,1.64049226247876
10580,"Albany-Schenectady-Troy, NY",2011,890,874,1764,872701,2.02131084987871
10580,"Albany-Schenectady-Troy, NY",2012,1149,1077,2226,874674,2.54494817497719
10580,"Albany-Schenectady-Troy, NY",2013,1221,788,2009,877095,2.29051585062051
10580,"Albany-Schenectady-Troy, NY",2014,1203,1028,2231,878184,2.54046987874978
10580,"Albany-Schenectady-Troy, NY",2015,1185,2438,3623,879131,4.12111505566292
10580,"Albany-Schenectady-Troy, NY",2016,1380,1473,2853,879790,3.24281930915332
10580,"Albany-Schenectady-Troy, NY",2017,1212,1134,2346,882130,2.65947195991521
10580,"Albany-Schenectady-Troy, NY",2018,1231,1008,2239,883169,2.53518862188324
10620,"Albemarle, NC",1990,190,8,198,51877,3.81672031921661
10620,"Albemarle, NC",1991,178,2,180,52500,3.42857142857143
10620,"Albemarle, NC",1992,210,13,223,52826,4.2214061257714
10620,"Albemarle, NC",1993,228,21,249,53198,4.68062709124403
10620,"Albemarle, NC",1994,208,20,228,53863,4.23296140207564
10620,"Albemarle, NC",1995,193,24,217,54162,4.00649902145416
10620,"Albemarle, NC",1996,190,2,192,54689,3.51076084770246
10620,"Albemarle, NC",1997,246,10,256,55511,4.61169858226297
10620,"Albemarle, NC",1998,235,8,243,55886,4.34813727946176
10620,"Albemarle, NC",1999,270,8,278,56618,4.91009926171889
10620,"Albemarle, NC",2000,275,12,287,58246,4.92737698726093
10620,"Albemarle, NC",2001,278,70,348,58674,5.93107679721853
10620,"Albemarle, NC",2002,308,69,377,58689,6.42369098127417
10620,"Albemarle, NC",2003,331,85,416,58748,7.08109212228501
10620,"Albemarle, NC",2004,390,86,476,58638,8.11760291960845
10620,"Albemarle, NC",2005,426,90,516,58931,8.75600278291561
10620,"Albemarle, NC",2006,376,85,461,59185,7.78913576075019
10620,"Albemarle, NC",2007,288,69,357,59849,5.96501194673261
10620,"Albemarle, NC",2008,196,61,257,60418,4.25369922870668
10620,"Albemarle, NC",2009,132,21,153,60496,2.52909283258397
10620,"Albemarle, NC",2010,118,12,130,60576,2.14606444796619
10620,"Albemarle, NC",2011,98,0,98,60520,1.61929940515532
10620,"Albemarle, NC",2012,88,38,126,60456,2.08416038110361
10620,"Albemarle, NC",2013,103,0,103,60631,1.69880094341179
10620,"Albemarle, NC",2014,92,0,92,60619,1.51767597617909
10620,"Albemarle, NC",2015,92,0,92,60635,1.5172755009483
10620,"Albemarle, NC",2016,199,0,199,60792,3.27345703382024
10620,"Albemarle, NC",2017,263,0,263,61451,4.27983271224227
10620,"Albemarle, NC",2018,272,0,272,62075,4.38179621425695
10660,"Albert Lea, MN",1990,34,14,48,33049,1.45238887712185
10660,"Albert Lea, MN",1991,32,16,48,32723,1.46685817315038
10660,"Albert Lea, MN",1992,37,12,49,32559,1.50496022605117
10660,"Albert Lea, MN",1993,37,2,39,32619,1.19562218339005
10660,"Albert Lea, MN",1994,31,89,120,32396,3.70416100753179
10660,"Albert Lea, MN",1995,35,0,35,31878,1.09793588054458
10660,"Albert Lea, MN",1996,52,13,65,31823,2.04254784275524
10660,"Albert Lea, MN",1997,40,8,48,31595,1.519227725906
10660,"Albert Lea, MN",1998,64,17,81,31587,2.5643460917466
10660,"Albert Lea, MN",1999,70,74,144,31478,4.57462354660398
10660,"Albert Lea, MN",2000,64,42,106,32555,3.25602825986792
10660,"Albert Lea, MN",2001,44,0,44,32474,1.35493009792449
10660,"Albert Lea, MN",2002,50,0,50,32053,1.55991638848158
10660,"Albert Lea, MN",2003,48,0,48,32031,1.49854828135244
10660,"Albert Lea, MN",2004,1,0,1,31948,0.0313008639038437
10660,"Albert Lea, MN",2005,1,0,1,31704,0.0315417612919505
10660,"Albert Lea, MN",2006,33,8,41,31622,1.29656568212004
10660,"Albert Lea, MN",2007,36,23,59,31511,1.87236203230618
10660,"Albert Lea, MN",2008,28,0,28,31270,0.895426926766869
10660,"Albert Lea, MN",2009,24,6,30,31313,0.958068533835787
10660,"Albert Lea, MN",2010,26,8,34,31204,1.08960389693629
10660,"Albert Lea, MN",2011,26,8,34,31065,1.09447931755995
10660,"Albert Lea, MN",2012,28,10,38,31023,1.22489765657738
10660,"Albert Lea, MN",2013,26,2,28,30922,0.905504171787077
10660,"Albert Lea, MN",2014,26,0,26,30742,0.845748487411359
10660,"Albert Lea, MN",2015,26,112,138,30496,4.52518363064008
10660,"Albert Lea, MN",2016,27,0,27,30409,0.887895031076326
10660,"Albert Lea, MN",2017,33,0,33,30537,1.08065625307005
10660,"Albert Lea, MN",2018,25,0,25,30444,0.821179871238996
10700,"Albertville, AL",1990,162,30,192,71020,2.70346381301042
10700,"Albertville, AL",1991,181,4,185,71801,2.57656578599184
10700,"Albertville, AL",1992,220,4,224,73270,3.0571857513307
10700,"Albertville, AL",1993,231,17,248,75062,3.3039354133916
10700,"Albertville, AL",1994,224,4,228,76679,2.97343470832953
10700,"Albertville, AL",1995,159,41,200,78130,2.55983617048509
10700,"Albertville, AL",1996,218,40,258,79324,3.25248348545207
10700,"Albertville, AL",1997,175,16,191,79950,2.38899312070044
10700,"Albertville, AL",1998,165,76,241,80186,3.0055121841718
10700,"Albertville, AL",1999,202,46,248,80552,3.07875657960075
10700,"Albertville, AL",2000,153,0,153,82429,1.85614286234214
10700,"Albertville, AL",2001,147,6,153,82477,1.85506262351928
10700,"Albertville, AL",2002,168,69,237,83417,2.84114748792213
10700,"Albertville, AL",2003,167,26,193,84348,2.28813961208327
10700,"Albertville, AL",2004,175,9,184,85131,2.16137482233264
10700,"Albertville, AL",2005,266,77,343,86516,3.96458458551019
10700,"Albertville, AL",2006,188,98,286,88209,3.24229953859583
10700,"Albertville, AL",2007,191,75,266,89605,2.96858434239161
10700,"Albertville, AL",2008,103,16,119,91072,1.3066584680253
10700,"Albertville, AL",2009,44,0,44,92213,0.477156149349875
10700,"Albertville, AL",2010,51,2,53,93124,0.569133628280572
10700,"Albertville, AL",2011,44,2,46,93892,0.48992459421463
10700,"Albertville, AL",2012,40,0,40,94268,0.424322145372767
10700,"Albertville, AL",2013,41,0,41,94370,0.434460103846561
10700,"Albertville, AL",2014,28,0,28,94277,0.296997146705983
10700,"Albertville, AL",2015,28,0,28,94606,0.295964315159715
10700,"Albertville, AL",2016,38,0,38,95123,0.399482774933507
10700,"Albertville, AL",2017,66,0,66,95609,0.69031158154567
10700,"Albertville, AL",2018,77,0,77,96109,0.801173667398475
10740,"Albuquerque, NM",1990,2041,432,2473,601898,4.10866957524365
10740,"Albuquerque, NM",1991,2121,286,2407,612833,3.92766055352763
10740,"Albuquerque, NM",1992,3186,64,3250,615656,5.27892199540003
10740,"Albuquerque, NM",1993,3982,353,4335,629115,6.89063207839584
10740,"Albuquerque, NM",1994,4678,1827,6505,645136,10.0831452592942
10740,"Albuquerque, NM",1995,4650,1931,6581,659043,9.98569137370399
10740,"Albuquerque, NM",1996,4662,1093,5755,667325,8.62398381598172
10740,"Albuquerque, NM",1997,4430,1667,6097,672779,9.06241128215952
10740,"Albuquerque, NM",1998,4947,419,5366,676682,7.92986956945803
10740,"Albuquerque, NM",1999,4927,384,5311,678752,7.82465466031776
10740,"Albuquerque, NM",2000,4663,110,4773,715305,6.6726780883679
10740,"Albuquerque, NM",2001,5240,685,5925,725272,8.16934887876548
10740,"Albuquerque, NM",2002,5803,1219,7022,741196,9.47387735497763
10740,"Albuquerque, NM",2003,6822,1114,7936,755249,10.5077927941646
10740,"Albuquerque, NM",2004,7065,390,7455,772053,9.65607283437795
10740,"Albuquerque, NM",2005,6712,326,7038,792849,8.87684792438409
10740,"Albuquerque, NM",2006,6062,760,6822,814524,8.37544381749341
10740,"Albuquerque, NM",2007,3696,803,4499,833082,5.40042876931683
10740,"Albuquerque, NM",2008,2037,518,2555,847126,3.01608025252442
10740,"Albuquerque, NM",2009,1519,173,1692,860034,1.96736408095494
10740,"Albuquerque, NM",2010,1553,211,1764,873175,2.0202135883414
10740,"Albuquerque, NM",2011,1354,280,1634,881540,1.85357442657168
10740,"Albuquerque, NM",2012,1259,825,2084,885864,2.35250557647675
10740,"Albuquerque, NM",2013,1456,1150,2606,889325,2.9303123155202
10740,"Albuquerque, NM",2014,2128,415,2543,889183,2.85992872108441
10740,"Albuquerque, NM",2015,2012,283,2295,890940,2.57593103912721
10740,"Albuquerque, NM",2016,1931,534,2465,894318,2.75629026811492
10740,"Albuquerque, NM",2017,1996,260,2256,897304,2.51419808671309
10740,"Albuquerque, NM",2018,2086,100,2186,900336,2.4279824421105
10780,"Alexandria, LA",1990,56,4,60,131516,0.456218254813103
10780,"Alexandria, LA",1991,115,0,115,149221,0.770669007713392
10780,"Alexandria, LA",1992,199,24,223,147932,1.50744936862883
10780,"Alexandria, LA",1993,211,60,271,142664,1.89956821622834
10780,"Alexandria, LA",1994,362,6,368,143664,2.56153246463972
10780,"Alexandria, LA",1995,294,39,333,144887,2.29834284649416
10780,"Alexandria, LA",1996,371,65,436,144839,3.0102389549776
10780,"Alexandria, LA",1997,315,16,331,144998,2.28279010744976
10780,"Alexandria, LA",1998,398,102,500,145492,3.43661507161906
10780,"Alexandria, LA",1999,420,90,510,146118,3.49032973350306
10780,"Alexandria, LA",2000,377,64,441,145179,3.03762940921208
10780,"Alexandria, LA",2001,358,91,449,145102,3.09437499138537
10780,"Alexandria, LA",2002,432,102,534,145416,3.67222313913187
10780,"Alexandria, LA",2003,537,43,580,146017,3.97214023024716
10780,"Alexandria, LA",2004,683,2,685,146973,4.66071999618978
10780,"Alexandria, LA",2005,708,2,710,147930,4.79956736294193
10780,"Alexandria, LA",2006,951,0,951,151142,6.29209617445846
10780,"Alexandria, LA",2007,564,8,572,151506,3.77542803585337
10780,"Alexandria, LA",2008,374,8,382,152442,2.50587108539641
10780,"Alexandria, LA",2009,348,48,396,153164,2.58546394714163
10780,"Alexandria, LA",2010,340,94,434,154092,2.81649923422371
10780,"Alexandria, LA",2011,280,96,376,154378,2.43558019925119
10780,"Alexandria, LA",2012,339,143,482,154384,3.12208519017515
10780,"Alexandria, LA",2013,340,62,402,154617,2.5999728361047
10780,"Alexandria, LA",2014,311,12,323,154560,2.0898033126294
10780,"Alexandria, LA",2015,241,48,289,154102,1.87538124099622
10780,"Alexandria, LA",2016,326,64,390,154160,2.52983912817852
10780,"Alexandria, LA",2017,292,10,302,153604,1.96609463295227
10780,"Alexandria, LA",2018,289,16,305,153044,1.99289093332636
10820,"Alexandria, MN",1990,163,2,165,28696,5.7499303038751
10820,"Alexandria, MN",1991,171,21,192,29038,6.61202562159928
10820,"Alexandria, MN",1992,206,50,256,29257,8.75004272481799
10820,"Alexandria, MN",1993,185,24,209,29637,7.05199581604076
10820,"Alexandria, MN",1994,254,16,270,29871,9.03886712865321
10820,"Alexandria, MN",1995,240,26,266,30149,8.82284652890643
10820,"Alexandria, MN",1996,272,32,304,30483,9.97277170882131
10820,"Alexandria, MN",1997,284,2,286,30715,9.31141136252645
10820,"Alexandria, MN",1998,330,18,348,31097,11.1907901083706
10820,"Alexandria, MN",1999,294,66,360,31237,11.5247943144348
10820,"Alexandria, MN",2000,326,30,356,32882,10.8265920564443
10820,"Alexandria, MN",2001,498,40,538,33201,16.2043311948435
10820,"Alexandria, MN",2002,504,44,548,33601,16.3090384214756
10820,"Alexandria, MN",2003,581,18,599,34125,17.5531135531136
10820,"Alexandria, MN",2004,502,64,566,34555,16.379684560845
10820,"Alexandria, MN",2005,441,48,489,35110,13.9276559384791
10820,"Alexandria, MN",2006,306,0,306,35472,8.62652232746955
10820,"Alexandria, MN",2007,228,0,228,35903,6.35044425256942
10820,"Alexandria, MN",2008,158,0,158,36108,4.37576160407666
10820,"Alexandria, MN",2009,94,0,94,36076,2.6056103780907
10820,"Alexandria, MN",2010,101,295,396,35987,11.003973657154
10820,"Alexandria, MN",2011,96,0,96,36175,2.65376641326883
10820,"Alexandria, MN",2012,89,0,89,36287,2.45266899991733
10820,"Alexandria, MN",2013,155,26,181,36343,4.98032633519522
10820,"Alexandria, MN",2014,117,67,184,36568,5.03172172391162
10820,"Alexandria, MN",2015,160,138,298,36782,8.10178891849274
10820,"Alexandria, MN",2016,153,54,207,37147,5.57245537997685
10820,"Alexandria, MN",2017,148,86,234,37556,6.23069549472787
10820,"Alexandria, MN",2018,188,10,198,37964,5.21546728479612
10860,"Alice, TX",1990,15,0,15,37640,0.398512221041445
10860,"Alice, TX",1991,17,0,17,38019,0.447144848628317
10860,"Alice, TX",1992,10,0,10,38112,0.262384550797649
10860,"Alice, TX",1993,43,0,43,38698,1.11116853584165
10860,"Alice, TX",1994,53,0,53,39040,1.35758196721311
10860,"Alice, TX",1995,21,0,21,39519,0.53138996432096
10860,"Alice, TX",1996,26,0,26,39623,0.65618453928274
10860,"Alice, TX",1997,37,0,37,39775,0.930232558139535
10860,"Alice, TX",1998,27,0,27,40045,0.674241478336871
10860,"Alice, TX",1999,37,0,37,40203,0.920329328657065
10860,"Alice, TX",2000,24,0,24,39361,0.609740606183786
10860,"Alice, TX",2001,23,4,27,39701,0.680083625097605
10860,"Alice, TX",2002,34,0,34,39821,0.853820848296125
10860,"Alice, TX",2003,38,4,42,40008,1.0497900419916
10860,"Alice, TX",2004,45,2,47,40309,1.1659927063435
10860,"Alice, TX",2005,82,72,154,40449,3.80726346757645
10860,"Alice, TX",2006,57,2,59,40393,1.46064912237269
10860,"Alice, TX",2007,32,50,82,40654,2.01702169528214
10860,"Alice, TX",2008,31,2,33,40554,0.813729841692558
10860,"Alice, TX",2009,11,0,11,40633,0.270715920557183
10860,"Alice, TX",2010,18,0,18,40885,0.440259263788676
10860,"Alice, TX",2011,23,0,23,41211,0.558103418990076
10860,"Alice, TX",2012,35,0,35,41644,0.840457208721545
10860,"Alice, TX",2013,29,0,29,41679,0.695794044962691
10860,"Alice, TX",2014,26,0,26,41503,0.626460737777992
10860,"Alice, TX",2015,12,0,12,41526,0.288975581563358
10860,"Alice, TX",2016,15,2,17,41181,0.412811733566451
10860,"Alice, TX",2017,14,0,14,40930,0.34204739799658
10860,"Alice, TX",2018,6,0,6,40822,0.146979569839792
10900,"Allentown-Bethlehem-Easton, PA-NJ",1990,1867,284,2151,688346,3.12488196343118
10900,"Allentown-Bethlehem-Easton, PA-NJ",1991,2144,373,2517,693867,3.62749633575311
10900,"Allentown-Bethlehem-Easton, PA-NJ",1992,2587,455,3042,698764,4.35340114831331
10900,"Allentown-Bethlehem-Easton, PA-NJ",1993,2627,489,3116,702700,4.43432474740287
10900,"Allentown-Bethlehem-Easton, PA-NJ",1994,2525,363,2888,706039,4.090425599719
10900,"Allentown-Bethlehem-Easton, PA-NJ",1995,2457,247,2704,707811,3.82022884640109
10900,"Allentown-Bethlehem-Easton, PA-NJ",1996,2518,391,2909,710264,4.09566020521947
10900,"Allentown-Bethlehem-Easton, PA-NJ",1997,2516,300,2816,712727,3.9510219200339
10900,"Allentown-Bethlehem-Easton, PA-NJ",1998,3116,276,3392,715088,4.74347213210122
10900,"Allentown-Bethlehem-Easton, PA-NJ",1999,3514,490,4004,718651,5.57155002915184
10900,"Allentown-Bethlehem-Easton, PA-NJ",2000,3259,500,3759,741817,5.06728748464918
10900,"Allentown-Bethlehem-Easton, PA-NJ",2001,3513,626,4139,748705,5.52821204613299
10900,"Allentown-Bethlehem-Easton, PA-NJ",2002,4202,361,4563,756628,6.03070465274877
10900,"Allentown-Bethlehem-Easton, PA-NJ",2003,3999,377,4376,766938,5.70580672753208
10900,"Allentown-Bethlehem-Easton, PA-NJ",2004,4461,151,4612,777277,5.93353463437102
10900,"Allentown-Bethlehem-Easton, PA-NJ",2005,4319,529,4848,787738,6.15433050075025
10900,"Allentown-Bethlehem-Easton, PA-NJ",2006,3860,284,4144,798586,5.18917186126479
10900,"Allentown-Bethlehem-Easton, PA-NJ",2007,2640,149,2789,807578,3.45353637667197
10900,"Allentown-Bethlehem-Easton, PA-NJ",2008,1508,186,1694,814050,2.08095325839936
10900,"Allentown-Bethlehem-Easton, PA-NJ",2009,1401,247,1648,817779,2.01521437943503
10900,"Allentown-Bethlehem-Easton, PA-NJ",2010,1177,211,1388,821914,1.68874115783403
10900,"Allentown-Bethlehem-Easton, PA-NJ",2011,1059,74,1133,824863,1.37356142777649
10900,"Allentown-Bethlehem-Easton, PA-NJ",2012,829,240,1069,826139,1.29397111139893
10900,"Allentown-Bethlehem-Easton, PA-NJ",2013,1139,211,1350,825783,1.63481205110786
10900,"Allentown-Bethlehem-Easton, PA-NJ",2014,1051,750,1801,828581,2.17359558087863
10900,"Allentown-Bethlehem-Easton, PA-NJ",2015,943,413,1356,830361,1.63302467240152
10900,"Allentown-Bethlehem-Easton, PA-NJ",2016,1059,204,1263,833144,1.51594442257281
10900,"Allentown-Bethlehem-Easton, PA-NJ",2017,938,180,1118,838081,1.33399993556709
10900,"Allentown-Bethlehem-Easton, PA-NJ",2018,1082,164,1246,842913,1.47820712220597
10940,"Alma, MI",1990,53,8,61,39049,1.56213987554099
10940,"Alma, MI",1991,71,4,75,39422,1.90249099487596
10940,"Alma, MI",1992,56,4,60,39624,1.51423379769836
10940,"Alma, MI",1993,48,0,48,39687,1.20946405624008
10940,"Alma, MI",1994,115,50,165,39743,4.15167450871852
10940,"Alma, MI",1995,14,6,20,39933,0.500838905166153
10940,"Alma, MI",1996,83,8,91,39856,2.28321959052589
10940,"Alma, MI",1997,59,16,75,39972,1.87631341939358
10940,"Alma, MI",1998,68,20,88,40146,2.19199920290938
10940,"Alma, MI",1999,66,54,120,39905,3.00714196216013
10940,"Alma, MI",2000,62,50,112,42472,2.63703145601808
10940,"Alma, MI",2001,63,2,65,42521,1.52865642858823
10940,"Alma, MI",2002,64,48,112,42428,2.63976619213727
10940,"Alma, MI",2003,60,0,60,42546,1.41023833027782
10940,"Alma, MI",2004,83,25,108,42583,2.53622337552544
10940,"Alma, MI",2005,55,30,85,42479,2.00098872384002
10940,"Alma, MI",2006,41,0,41,42714,0.959872641288571
10940,"Alma, MI",2007,31,0,31,42824,0.723893144031384
10940,"Alma, MI",2008,22,0,22,42774,0.514331135736662
10940,"Alma, MI",2009,5,0,5,42285,0.118245240629065
10940,"Alma, MI",2010,9,0,9,42431,0.212109071197945
10940,"Alma, MI",2011,22,0,22,42112,0.52241641337386
10940,"Alma, MI",2012,17,0,17,41978,0.404974034017819
10940,"Alma, MI",2013,17,0,17,41931,0.405427964990103
10940,"Alma, MI",2014,17,0,17,41462,0.410013988712556
10940,"Alma, MI",2015,23,0,23,41319,0.556644642900361
10940,"Alma, MI",2016,29,0,29,40943,0.708301785408983
10940,"Alma, MI",2017,30,0,30,41011,0.731511058008827
10940,"Alma, MI",2018,29,0,29,40599,0.71430330796325
10980,"Alpena, MI",1990,62,0,62,30657,2.02237661871677
10980,"Alpena, MI",1991,79,0,79,30769,2.56751925639442
10980,"Alpena, MI",1992,122,0,122,30864,3.95282529808191
10980,"Alpena, MI",1993,93,2,95,30897,3.07473217464479
10980,"Alpena, MI",1994,110,0,110,30585,3.59653424881478
10980,"Alpena, MI",1995,115,0,115,30647,3.7524064345613
10980,"Alpena, MI",1996,104,40,144,30674,4.6945295690161
10980,"Alpena, MI",1997,120,0,120,30606,3.92079984316801
10980,"Alpena, MI",1998,109,0,109,30493,3.57459088971239
10980,"Alpena, MI",1999,101,0,101,30696,3.29033098775085
10980,"Alpena, MI",2000,90,0,90,31269,2.87825002398542
10980,"Alpena, MI",2001,97,0,97,31179,3.11106834728503
10980,"Alpena, MI",2002,42,0,42,30956,1.35676443985011
10980,"Alpena, MI",2003,38,0,38,30824,1.23280560602128
10980,"Alpena, MI",2004,44,0,44,30735,1.43159264681959
10980,"Alpena, MI",2005,51,2,53,30494,1.73804682888437
10980,"Alpena, MI",2006,38,2,40,30209,1.32410870932504
10980,"Alpena, MI",2007,41,48,89,30180,2.94897282968854
10980,"Alpena, MI",2008,26,7,33,30119,1.09565390617218
10980,"Alpena, MI",2009,13,0,13,29755,0.436901361115779
10980,"Alpena, MI",2010,11,0,11,29517,0.372666598909103
10980,"Alpena, MI",2011,11,0,11,29344,0.374863685932388
10980,"Alpena, MI",2012,20,2,22,29172,0.754147812971342
10980,"Alpena, MI",2013,18,4,22,28965,0.759537372691179
10980,"Alpena, MI",2014,18,5,23,28887,0.796205905770762
10980,"Alpena, MI",2015,22,0,22,28719,0.766043385911766
10980,"Alpena, MI",2016,24,8,32,28656,1.11669458403127
10980,"Alpena, MI",2017,23,0,23,28438,0.808776988536465
10980,"Alpena, MI",2018,24,0,24,28360,0.846262341325811
11020,"Altoona, PA",1990,286,51,337,130599,2.58041792050475
11020,"Altoona, PA",1991,292,65,357,131187,2.72130622698895
11020,"Altoona, PA",1992,275,97,372,131318,2.83281804474634
11020,"Altoona, PA",1993,295,8,303,131732,2.3001244951872
11020,"Altoona, PA",1994,274,2,276,132218,2.08746161642136
11020,"Altoona, PA",1995,308,71,379,131920,2.87295330503335
11020,"Altoona, PA",1996,239,20,259,131221,1.97376944239108
11020,"Altoona, PA",1997,179,11,190,131097,1.4493085272737
11020,"Altoona, PA",1998,259,136,395,130700,3.02218821729151
11020,"Altoona, PA",1999,233,28,261,129973,2.00810937656282
11020,"Altoona, PA",2000,212,14,226,128981,1.75219605988479
11020,"Altoona, PA",2001,227,28,255,128471,1.98488374808322
11020,"Altoona, PA",2002,236,86,322,127631,2.52289804201174
11020,"Altoona, PA",2003,241,121,362,127353,2.84249291339819
11020,"Altoona, PA",2004,293,203,496,127194,3.89955501045647
11020,"Altoona, PA",2005,176,4,180,126730,1.42034246034877
11020,"Altoona, PA",2006,188,5,193,127002,1.51966110769909
11020,"Altoona, PA",2007,140,154,294,127048,2.31408601473459
11020,"Altoona, PA",2008,179,16,195,127112,1.53408018125747
11020,"Altoona, PA",2009,103,22,125,127161,0.983005795802172
11020,"Altoona, PA",2010,112,47,159,127043,1.25154475256409
11020,"Altoona, PA",2011,69,6,75,126959,0.590741893052088
11020,"Altoona, PA",2012,81,16,97,126540,0.766556029713924
11020,"Altoona, PA",2013,93,8,101,125835,0.802638375650654
11020,"Altoona, PA",2014,88,12,100,125276,0.798237491618506
11020,"Altoona, PA",2015,108,9,117,124585,0.939117871332825
11020,"Altoona, PA",2016,102,81,183,123680,1.47962483829237
11020,"Altoona, PA",2017,88,26,114,123175,0.925512482240714
11020,"Altoona, PA",2018,101,0,101,122492,0.824543643666525
11060,"Altus, OK",1990,22,0,22,28625,0.768558951965066
11060,"Altus, OK",1991,21,0,21,28415,0.739046278374098
11060,"Altus, OK",1992,47,0,47,28662,1.63980182820459
11060,"Altus, OK",1993,75,0,75,28816,2.60272071071627
11060,"Altus, OK",1994,74,0,74,28968,2.55454294393814
11060,"Altus, OK",1995,25,0,25,29752,0.840279645065878
11060,"Altus, OK",1996,20,0,20,29857,0.669859664400308
11060,"Altus, OK",1997,29,0,29,28557,1.01551283398116
11060,"Altus, OK",1998,18,0,18,28531,0.630892713189163
11060,"Altus, OK",1999,28,0,28,28317,0.988805311297101
11060,"Altus, OK",2000,14,0,14,28278,0.495084517999859
11060,"Altus, OK",2001,9,0,9,28036,0.321015836781281
11060,"Altus, OK",2002,19,0,19,27513,0.690582633664086
11060,"Altus, OK",2003,30,0,30,27242,1.10124073122385
11060,"Altus, OK",2004,26,0,26,27480,0.946142649199418
11060,"Altus, OK",2005,38,0,38,26862,1.41463777827414
11060,"Altus, OK",2006,49,0,49,26805,1.82801716097743
11060,"Altus, OK",2007,45,0,45,26335,1.70875261059427
11060,"Altus, OK",2008,49,0,49,26038,1.8818649665873
11060,"Altus, OK",2009,32,0,32,26256,1.2187690432663
11060,"Altus, OK",2010,33,0,33,26483,1.24608239247819
11060,"Altus, OK",2011,33,0,33,26420,1.24905374716124
11060,"Altus, OK",2012,29,0,29,26229,1.10564642189942
11060,"Altus, OK",2013,32,0,32,26112,1.22549019607843
11060,"Altus, OK",2014,27,0,27,25826,1.04545806551537
11060,"Altus, OK",2015,31,4,35,25467,1.37432756115758
11060,"Altus, OK",2016,34,0,34,25466,1.33511348464619
11060,"Altus, OK",2017,21,0,21,25213,0.8329036608099
11060,"Altus, OK",2018,22,0,22,24949,0.881798869694176
11100,"Amarillo, TX",1990,153,6,159,196318,0.809910451410467
11100,"Amarillo, TX",1991,219,0,219,199867,1.09572865955861
11100,"Amarillo, TX",1992,363,12,375,201987,1.85655512483477
11100,"Amarillo, TX",1993,550,13,563,205248,2.74302307452448
11100,"Amarillo, TX",1994,503,26,529,208599,2.53596613598339
11100,"Amarillo, TX",1995,455,2,457,213955,2.13596316982543
11100,"Amarillo, TX",1996,576,5,581,215667,2.69396801550539
11100,"Amarillo, TX",1997,438,434,872,217216,4.0144372421921
11100,"Amarillo, TX",1998,498,4,502,218020,2.3025410512797
11100,"Amarillo, TX",1999,541,170,711,220358,3.22656767623594
11100,"Amarillo, TX",2000,550,10,560,229215,2.44312108718888
11100,"Amarillo, TX",2001,578,436,1014,230351,4.40197785119231
11100,"Amarillo, TX",2002,733,188,921,232326,3.96425712145864
11100,"Amarillo, TX",2003,783,270,1053,235138,4.47822129983244
11100,"Amarillo, TX",2004,741,273,1014,237566,4.26828754956517
11100,"Amarillo, TX",2005,866,314,1180,240380,4.90889425076961
11100,"Amarillo, TX",2006,712,472,1184,242656,4.87933535540024
11100,"Amarillo, TX",2007,676,640,1316,244608,5.38003663003663
11100,"Amarillo, TX",2008,514,254,768,246458,3.11614960764106
11100,"Amarillo, TX",2009,609,36,645,249373,2.58648690916819
11100,"Amarillo, TX",2010,576,355,931,252677,3.68454588268817
11100,"Amarillo, TX",2011,657,47,704,255972,2.75030081415155
11100,"Amarillo, TX",2012,656,974,1630,257821,6.32221580088511
11100,"Amarillo, TX",2013,624,274,898,258938,3.46801164757587
11100,"Amarillo, TX",2014,496,422,918,260874,3.51894017801697
11100,"Amarillo, TX",2015,564,316,880,261804,3.36129318115842
11100,"Amarillo, TX",2016,718,22,740,263327,2.81019416922685
11100,"Amarillo, TX",2017,555,220,775,264955,2.925025004246
11100,"Amarillo, TX",2018,637,113,750,265947,2.8201107739512
11140,"Americus, GA",1990,60,6,66,33889,1.94753459824722
11140,"Americus, GA",1991,18,6,24,34142,0.702946517485795
11140,"Americus, GA",1992,20,6,26,34406,0.755682148462477
11140,"Americus, GA",1993,19,28,47,34763,1.35201219687599
11140,"Americus, GA",1994,57,69,126,34873,3.61311042927193
11140,"Americus, GA",1995,40,18,58,34798,1.66676245761251
11140,"Americus, GA",1996,44,76,120,35287,3.40068580497067
11140,"Americus, GA",1997,28,44,72,35344,2.03712086917157
11140,"Americus, GA",1998,53,24,77,35219,2.18631988415344
11140,"Americus, GA",1999,54,32,86,35243,2.44020089095707
11140,"Americus, GA",2000,53,23,76,37239,2.04087112972958
11140,"Americus, GA",2001,82,22,104,37307,2.78768059613477
11140,"Americus, GA",2002,74,0,74,37282,1.98487205622016
11140,"Americus, GA",2003,69,10,79,37154,2.12628519136567
11140,"Americus, GA",2004,116,4,120,36972,3.24569944823109
11140,"Americus, GA",2005,60,2,62,36892,1.68058115580614
11140,"Americus, GA",2006,81,0,81,37159,2.17982184665895
11140,"Americus, GA",2007,64,6,70,37588,1.86229647759923
11140,"Americus, GA",2008,39,44,83,37847,2.19304039950326
11140,"Americus, GA",2009,25,0,25,37678,0.663517171824407
11140,"Americus, GA",2010,19,0,19,37700,0.503978779840849
11140,"Americus, GA",2011,25,0,25,37109,0.673691018351343
11140,"Americus, GA",2012,23,0,23,36608,0.628277972027972
11140,"Americus, GA",2013,62,0,62,36432,1.70180061484409
11140,"Americus, GA",2014,11,0,11,36356,0.302563538343052
11140,"Americus, GA",2015,16,0,16,35891,0.445794210247694
11140,"Americus, GA",2016,22,0,22,35529,0.619212474316755
11140,"Americus, GA",2017,26,0,26,35071,0.741353254825925
11140,"Americus, GA",2018,28,0,28,34969,0.800709199576768
11180,"Ames, IA",1990,133,157,290,74286,3.903831139111
11180,"Ames, IA",1991,163,195,358,74018,4.83666135264395
11180,"Ames, IA",1992,243,202,445,74262,5.99229754113813
11180,"Ames, IA",1993,256,260,516,74744,6.90356416568554
11180,"Ames, IA",1994,287,188,475,74254,6.39696177983678
11180,"Ames, IA",1995,226,235,461,74229,6.21051071683574
11180,"Ames, IA",1996,245,142,387,74499,5.19470060000805
11180,"Ames, IA",1997,280,391,671,74980,8.94905308082155
11180,"Ames, IA",1998,326,453,779,74969,10.3909615974603
11180,"Ames, IA",1999,295,542,837,75683,11.0592867618884
11180,"Ames, IA",2000,254,420,674,80152,8.40902285657251
11180,"Ames, IA",2001,242,258,500,80260,6.22975330176925
11180,"Ames, IA",2002,305,577,882,81885,10.7712035171277
11180,"Ames, IA",2003,406,338,744,82068,9.06565287322708
11180,"Ames, IA",2004,317,419,736,82754,8.89382990550306
11180,"Ames, IA",2005,381,565,946,82884,11.4135418174799
11180,"Ames, IA",2006,278,206,484,84739,5.71165579013205
11180,"Ames, IA",2007,244,116,360,86540,4.15992604575919
11180,"Ames, IA",2008,126,201,327,87831,3.72305905659733
11180,"Ames, IA",2009,122,0,122,89285,1.36641093128745
11180,"Ames, IA",2010,93,74,167,89654,1.86271666629487
11180,"Ames, IA",2011,99,358,457,91125,5.01508916323731
11180,"Ames, IA",2012,152,295,447,91999,4.85874846465722
11180,"Ames, IA",2013,246,290,536,93871,5.709963673552
11180,"Ames, IA",2014,179,360,539,95797,5.62648099627337
11180,"Ames, IA",2015,196,359,555,96605,5.74504425236789
11180,"Ames, IA",2016,210,499,709,96845,7.3209768186277
11180,"Ames, IA",2017,257,645,902,97260,9.27411063129755
11180,"Ames, IA",2018,273,353,626,98105,6.38091840375108
11220,"Amsterdam, NY",1990,76,0,76,52052,1.46007838315531
11220,"Amsterdam, NY",1991,99,14,113,51977,2.17403851703638
11220,"Amsterdam, NY",1992,82,4,86,52073,1.65152766308836
11220,"Amsterdam, NY",1993,74,32,106,52017,2.03779533614011
11220,"Amsterdam, NY",1994,76,0,76,52026,1.46080805750971
11220,"Amsterdam, NY",1995,61,28,89,51988,1.71193352312072
11220,"Amsterdam, NY",1996,63,34,97,51707,1.87595489972344
11220,"Amsterdam, NY",1997,55,4,59,51261,1.15097247420066
11220,"Amsterdam, NY",1998,59,0,59,50844,1.16041224136575
11220,"Amsterdam, NY",1999,58,0,58,50502,1.1484693675498
11220,"Amsterdam, NY",2000,53,0,53,49605,1.06844068138293
11220,"Amsterdam, NY",2001,49,0,49,49472,0.990459249676585
11220,"Amsterdam, NY",2002,69,0,69,49298,1.39965110146456
11220,"Amsterdam, NY",2003,91,0,91,49449,1.84027988432526
11220,"Amsterdam, NY",2004,79,0,79,49460,1.59725030327537
11220,"Amsterdam, NY",2005,82,0,82,49505,1.65639834360166
11220,"Amsterdam, NY",2006,76,0,76,49724,1.52843697208591
11220,"Amsterdam, NY",2007,59,0,59,49798,1.18478653761195
11220,"Amsterdam, NY",2008,40,0,40,49951,0.800784769073692
11220,"Amsterdam, NY",2009,40,0,40,50001,0.799984000319994
11220,"Amsterdam, NY",2010,32,108,140,50300,2.78330019880716
11220,"Amsterdam, NY",2011,37,86,123,49901,2.46488046331737
11220,"Amsterdam, NY",2012,40,98,138,49822,2.76986070410662
11220,"Amsterdam, NY",2013,30,0,30,49738,0.603160561341429
11220,"Amsterdam, NY",2014,46,0,46,49673,0.9260564089143
11220,"Amsterdam, NY",2015,25,0,25,49579,0.504245749208334
11220,"Amsterdam, NY",2016,28,2,30,49206,0.609681746128521
11220,"Amsterdam, NY",2017,49,0,49,49216,0.995611183355007
11220,"Amsterdam, NY",2018,36,0,36,49455,0.727934485896269
11260,"Anchorage, AK",1990,3,0,3,40151,0.0747179397773405
11260,"Anchorage, AK",1991,13,0,13,42286,0.307430355200303
11260,"Anchorage, AK",1992,39,6,45,44714,1.00639620700452
11260,"Anchorage, AK",1993,23,10,33,46397,0.711252882729487
11260,"Anchorage, AK",1994,70,24,94,47972,1.95947636121071
11260,"Anchorage, AK",1995,113,0,113,49978,2.2609948377286
11260,"Anchorage, AK",1996,78,20,98,51996,1.88476036618201
11260,"Anchorage, AK",1997,106,2,108,53902,2.00363622871137
11260,"Anchorage, AK",1998,146,44,190,55808,3.40452981651376
11260,"Anchorage, AK",1999,60,6,66,57994,1.13804876366521
11260,"Anchorage, AK",2000,61,59,120,59802,2.00662185211197
11260,"Anchorage, AK",2001,61,120,181,61807,2.92847088517482
11260,"Anchorage, AK",2002,84,124,208,64353,3.23217254828835
11260,"Anchorage, AK",2003,81,79,160,67162,2.38229951460647
11260,"Anchorage, AK",2004,155,112,267,70761,3.77326493407385
11260,"Anchorage, AK",2005,191,42,233,74409,3.13134163878025
11260,"Anchorage, AK",2006,115,111,226,78633,2.87411137817456
11260,"Anchorage, AK",2007,70,65,135,81402,1.65843591066559
11260,"Anchorage, AK",2008,44,16,60,84079,0.713614576767088
11260,"Anchorage, AK",2009,56,4,60,86885,0.690567992173563
11260,"Anchorage, AK",2010,43,10,53,89735,0.590627960104753
11260,"Anchorage, AK",2011,57,20,77,91716,0.839548170439182
11260,"Anchorage, AK",2012,33,10,43,93670,0.459058396498345
11260,"Anchorage, AK",2013,25,18,43,95877,0.448491296139846
11260,"Anchorage, AK",2014,99,18,117,98104,1.19261192204191
11260,"Anchorage, AK",2015,47,52,99,101068,0.979538528515455
11260,"Anchorage, AK",2016,32,84,116,104157,1.11370335167104
11260,"Anchorage, AK",2017,51,78,129,106383,1.21259975748005
11260,"Anchorage, AK",2018,69,107,176,107610,1.63553573088003
11380,"Andrews, TX",1990,5,0,5,14284,0.350042005040605
11380,"Andrews, TX",1991,4,0,4,14473,0.276376701444068
11380,"Andrews, TX",1992,3,0,3,14447,0.207655568630165
11380,"Andrews, TX",1993,2,0,2,14137,0.141472731131074
11380,"Andrews, TX",1994,3,24,27,14180,1.90409026798307
11380,"Andrews, TX",1995,3,0,3,14000,0.214285714285714
11380,"Andrews, TX",1996,10,0,10,13910,0.718907260963336
11380,"Andrews, TX",1997,10,0,10,13943,0.717205766334361
11380,"Andrews, TX",1998,8,0,8,14029,0.570247344785801
11380,"Andrews, TX",1999,6,0,6,13700,0.437956204379562
11380,"Andrews, TX",2000,24,0,24,12949,1.85342497490154
11380,"Andrews, TX",2001,11,0,11,12856,0.855631611698818
11380,"Andrews, TX",2002,13,0,13,13022,0.998310551374597
11380,"Andrews, TX",2003,11,0,11,12976,0.847718865598027
11380,"Andrews, TX",2004,12,0,12,13006,0.922651084115024
11380,"Andrews, TX",2005,24,0,24,13016,1.84388444990781
11380,"Andrews, TX",2006,40,0,40,13195,3.03145130731338
11380,"Andrews, TX",2007,154,0,154,13513,11.3964330644564
11380,"Andrews, TX",2008,57,4,61,14099,4.32654798212639
11380,"Andrews, TX",2009,46,0,46,14601,3.15046914594891
11380,"Andrews, TX",2010,31,40,71,14849,4.78146676543875
11380,"Andrews, TX",2011,60,0,60,15388,3.89914218871848
11380,"Andrews, TX",2012,54,0,54,16113,3.3513312232359
11380,"Andrews, TX",2013,58,0,58,16788,3.45484870145342
11380,"Andrews, TX",2014,53,102,155,17445,8.88506735454285
11380,"Andrews, TX",2015,22,0,22,18083,1.21661228778411
11380,"Andrews, TX",2016,8,0,8,17805,0.44931199101376
11380,"Andrews, TX",2017,18,0,18,17631,1.02092904543134
11380,"Andrews, TX",2018,22,0,22,18128,1.21359223300971
11420,"Angola, IN",1990,173,26,199,27464,7.24584911156423
11420,"Angola, IN",1991,183,6,189,27754,6.80982921380702
11420,"Angola, IN",1992,227,36,263,28279,9.30018741822554
11420,"Angola, IN",1993,246,26,272,28734,9.46613767662003
11420,"Angola, IN",1994,246,14,260,29252,8.8882811431697
11420,"Angola, IN",1995,234,12,246,30122,8.16678839386495
11420,"Angola, IN",1996,286,30,316,30745,10.2780939990242
11420,"Angola, IN",1997,287,168,455,31027,14.6646469204241
11420,"Angola, IN",1998,266,4,270,31459,8.58259957404876
11420,"Angola, IN",1999,299,48,347,31794,10.914008932503
11420,"Angola, IN",2000,240,35,275,33339,8.24859773838448
11420,"Angola, IN",2001,247,49,296,33556,8.82107521754679
11420,"Angola, IN",2002,208,54,262,33496,7.82182947217578
11420,"Angola, IN",2003,279,42,321,33789,9.50013317943709
11420,"Angola, IN",2004,307,0,307,33718,9.10492911797853
11420,"Angola, IN",2005,297,5,302,33926,8.90172728880504
11420,"Angola, IN",2006,207,0,207,34044,6.08036658442016
11420,"Angola, IN",2007,167,0,167,34004,4.91118691918598
11420,"Angola, IN",2008,117,0,117,34055,3.43561885185729
11420,"Angola, IN",2009,74,0,74,34194,2.16412236064807
11420,"Angola, IN",2010,71,0,71,34136,2.07991563159128
11420,"Angola, IN",2011,92,0,92,34091,2.69865947024141
11420,"Angola, IN",2012,107,0,107,34182,3.13030249839097
11420,"Angola, IN",2013,113,0,113,34397,3.28517021833299
11420,"Angola, IN",2014,98,0,98,34517,2.83918069357128
11420,"Angola, IN",2015,121,0,121,34491,3.5081615493897
11420,"Angola, IN",2016,125,8,133,34354,3.87145601676661
11420,"Angola, IN",2017,151,8,159,34421,4.61927311815461
11420,"Angola, IN",2018,145,10,155,34586,4.48158214306367
11460,"Ann Arbor, MI",1990,830,979,1809,283706,6.37631914728628
11460,"Ann Arbor, MI",1991,855,304,1159,285708,4.05658924496339
11460,"Ann Arbor, MI",1992,1089,67,1156,287745,4.01744600253697
11460,"Ann Arbor, MI",1993,1522,176,1698,287887,5.89814753705447
11460,"Ann Arbor, MI",1994,1646,409,2055,288771,7.11636556302399
11460,"Ann Arbor, MI",1995,1658,348,2006,291801,6.87454806529107
11460,"Ann Arbor, MI",1996,1965,547,2512,295731,8.49420588304912
11460,"Ann Arbor, MI",1997,1714,719,2433,299687,8.11847027064904
11460,"Ann Arbor, MI",1998,2122,780,2902,302580,9.59085200608104
11460,"Ann Arbor, MI",1999,2192,425,2617,306860,8.52831910317409
11460,"Ann Arbor, MI",2000,1863,117,1980,324372,6.10410269690355
11460,"Ann Arbor, MI",2001,1813,292,2105,328749,6.40306130208761
11460,"Ann Arbor, MI",2002,2285,48,2333,332763,7.01099581383748
11460,"Ann Arbor, MI",2003,2153,374,2527,336154,7.51738786389571
11460,"Ann Arbor, MI",2004,1994,714,2708,339422,7.97826893955018
11460,"Ann Arbor, MI",2005,1441,235,1676,342234,4.89723405623053
11460,"Ann Arbor, MI",2006,627,148,775,344018,2.25278909824486
11460,"Ann Arbor, MI",2007,490,75,565,345310,1.63621094089369
11460,"Ann Arbor, MI",2008,278,69,347,341595,1.01582283113043
11460,"Ann Arbor, MI",2009,210,43,253,343520,0.736492780624127
11460,"Ann Arbor, MI",2010,317,51,368,345658,1.06463614323985
11460,"Ann Arbor, MI",2011,200,277,477,349676,1.36411992816207
11460,"Ann Arbor, MI",2012,262,14,276,352262,0.783507730041844
11460,"Ann Arbor, MI",2013,394,364,758,356015,2.12912377287474
11460,"Ann Arbor, MI",2014,385,185,570,360035,1.58317941311261
11460,"Ann Arbor, MI",2015,390,30,420,363109,1.15667747150305
11460,"Ann Arbor, MI",2016,438,0,438,366488,1.19512780773177
11460,"Ann Arbor, MI",2017,583,74,657,369208,1.77948473489198
11460,"Ann Arbor, MI",2018,652,153,805,370963,2.17002773861544
11500,"Anniston-Oxford-Jacksonville, AL",1990,163,68,231,116114,1.98942418657526
11500,"Anniston-Oxford-Jacksonville, AL",1991,117,38,155,115226,1.34518251089164
11500,"Anniston-Oxford-Jacksonville, AL",1992,155,24,179,115764,1.54624926574756
11500,"Anniston-Oxford-Jacksonville, AL",1993,165,24,189,116268,1.62555475281247
11500,"Anniston-Oxford-Jacksonville, AL",1994,200,69,269,116089,2.31718767497351
11500,"Anniston-Oxford-Jacksonville, AL",1995,182,93,275,116701,2.3564493877516
11500,"Anniston-Oxford-Jacksonville, AL",1996,196,116,312,116580,2.67627380339681
11500,"Anniston-Oxford-Jacksonville, AL",1997,155,77,232,117135,1.98062065138515
11500,"Anniston-Oxford-Jacksonville, AL",1998,166,101,267,117046,2.28115441792116
11500,"Anniston-Oxford-Jacksonville, AL",1999,180,242,422,114767,3.6770151698659
11500,"Anniston-Oxford-Jacksonville, AL",2000,252,84,336,111081,3.02481972614579
11500,"Anniston-Oxford-Jacksonville, AL",2001,243,16,259,111266,2.32775510937753
11500,"Anniston-Oxford-Jacksonville, AL",2002,215,18,233,111625,2.08734602463606
11500,"Anniston-Oxford-Jacksonville, AL",2003,163,0,163,112705,1.44625349363382
11500,"Anniston-Oxford-Jacksonville, AL",2004,204,18,222,113462,1.95660221043169
11500,"Anniston-Oxford-Jacksonville, AL",2005,258,8,266,114477,2.32361085632922
11500,"Anniston-Oxford-Jacksonville, AL",2006,232,45,277,115388,2.40059624917669
11500,"Anniston-Oxford-Jacksonville, AL",2007,264,208,472,116211,4.06157764755488
11500,"Anniston-Oxford-Jacksonville, AL",2008,183,14,197,117274,1.67982673056261
11500,"Anniston-Oxford-Jacksonville, AL",2009,139,55,194,118363,1.63902570904759
11500,"Anniston-Oxford-Jacksonville, AL",2010,99,8,107,118477,0.903128877334841
11500,"Anniston-Oxford-Jacksonville, AL",2011,73,10,83,117797,0.70460198477041
11500,"Anniston-Oxford-Jacksonville, AL",2012,71,0,71,117257,0.605507560316228
11500,"Anniston-Oxford-Jacksonville, AL",2013,59,0,59,116541,0.506259599625883
11500,"Anniston-Oxford-Jacksonville, AL",2014,102,12,114,115995,0.982800982800983
11500,"Anniston-Oxford-Jacksonville, AL",2015,61,0,61,115536,0.527973964824817
11500,"Anniston-Oxford-Jacksonville, AL",2016,62,15,77,115018,0.669460432280165
11500,"Anniston-Oxford-Jacksonville, AL",2017,69,0,69,114664,0.6017581804228
11500,"Anniston-Oxford-Jacksonville, AL",2018,66,4,70,114277,0.612546706686385
11540,"Appleton, WI",1990,595,371,966,175277,5.51127643672587
11540,"Appleton, WI",1991,1108,645,1753,176757,9.9175704498266
11540,"Appleton, WI",1992,1375,714,2089,179016,11.669347991241
11540,"Appleton, WI",1993,1304,717,2021,181558,11.1314290750063
11540,"Appleton, WI",1994,1098,573,1671,184804,9.04201207766066
11540,"Appleton, WI",1995,903,493,1396,187396,7.44946530342163
11540,"Appleton, WI",1996,1045,553,1598,190065,8.40765001446873
11540,"Appleton, WI",1997,924,818,1742,192267,9.06031716311171
11540,"Appleton, WI",1998,1212,451,1663,194723,8.54033678610128
11540,"Appleton, WI",1999,1188,594,1782,197165,9.03811528415287
11540,"Appleton, WI",2000,1234,642,1876,202618,9.25880227817864
11540,"Appleton, WI",2001,1303,875,2178,205676,10.5894708181801
11540,"Appleton, WI",2002,1442,723,2165,208747,10.3714065351837
11540,"Appleton, WI",2003,1477,264,1741,211350,8.23752070026023
11540,"Appleton, WI",2004,1325,203,1528,213592,7.15382598599198
11540,"Appleton, WI",2005,1148,336,1484,215925,6.8727567442399
11540,"Appleton, WI",2006,807,158,965,218441,4.41766884421881
11540,"Appleton, WI",2007,673,127,800,220368,3.63029114935018
11540,"Appleton, WI",2008,488,206,694,222402,3.12047553529195
11540,"Appleton, WI",2009,421,96,517,224632,2.30154207770932
11540,"Appleton, WI",2010,413,174,587,225944,2.5979888822009
11540,"Appleton, WI",2011,298,350,648,227521,2.84808874785185
11540,"Appleton, WI",2012,375,458,833,228643,3.64323421228728
11540,"Appleton, WI",2013,516,313,829,229973,3.60477099485592
11540,"Appleton, WI",2014,508,422,930,231642,4.01481596601653
11540,"Appleton, WI",2015,568,551,1119,233229,4.79785961437043
11540,"Appleton, WI",2016,549,194,743,234355,3.17040387446395
11540,"Appleton, WI",2017,616,314,930,236058,3.93970973235391
11540,"Appleton, WI",2018,781,206,987,237524,4.15536956265472
11580,"Arcadia, FL",1990,102,36,138,23942,5.76392949628268
11580,"Arcadia, FL",1991,92,26,118,24476,4.82104919104429
11580,"Arcadia, FL",1992,72,46,118,24341,4.84778768333265
11580,"Arcadia, FL",1993,68,29,97,24610,3.94148720032507
11580,"Arcadia, FL",1994,74,4,78,24859,3.13769660887405
11580,"Arcadia, FL",1995,76,46,122,25010,4.8780487804878
11580,"Arcadia, FL",1996,78,46,124,24721,5.01597831802921
11580,"Arcadia, FL",1997,103,90,193,24814,7.7778673329572
11580,"Arcadia, FL",1998,66,20,86,24658,3.48771189877525
11580,"Arcadia, FL",1999,85,153,238,24790,9.60064542154094
11580,"Arcadia, FL",2000,45,76,121,32196,3.75823083612871
11580,"Arcadia, FL",2001,54,85,139,32402,4.28985865070057
11580,"Arcadia, FL",2002,109,32,141,32446,4.34568205633976
11580,"Arcadia, FL",2003,95,0,95,33271,2.85533948483664
11580,"Arcadia, FL",2004,149,0,149,33895,4.3959286030388
11580,"Arcadia, FL",2005,166,0,166,33864,4.90196078431373
11580,"Arcadia, FL",2006,167,20,187,34300,5.45189504373178
11580,"Arcadia, FL",2007,141,0,141,34537,4.0825781046414
11580,"Arcadia, FL",2008,163,0,163,34374,4.74195612963286
11580,"Arcadia, FL",2009,109,0,109,34592,3.15101757631822
11580,"Arcadia, FL",2010,96,0,96,34933,2.74811782555177
11580,"Arcadia, FL",2011,95,0,95,34841,2.72667259837548
11580,"Arcadia, FL",2012,99,0,99,35006,2.82808661372336
11580,"Arcadia, FL",2013,117,0,117,34905,3.35195530726257
11580,"Arcadia, FL",2014,112,0,112,35344,3.168854685378
11580,"Arcadia, FL",2015,118,0,118,35650,3.30995792426367
11580,"Arcadia, FL",2016,71,0,71,36261,1.95802652988059
11580,"Arcadia, FL",2017,79,0,79,37252,2.1206915064963
11580,"Arcadia, FL",2018,71,17,88,37489,2.3473552241991
11620,"Ardmore, OK",1990,33,0,33,42875,0.769679300291545
11620,"Ardmore, OK",1991,37,0,37,42712,0.866267091215583
11620,"Ardmore, OK",1992,48,0,48,43089,1.11397340388498
11620,"Ardmore, OK",1993,91,12,103,43488,2.36846946284032
11620,"Ardmore, OK",1994,86,73,159,43639,3.64352987007035
11620,"Ardmore, OK",1995,96,16,112,43963,2.54759684279963
11620,"Ardmore, OK",1996,90,22,112,44079,2.54089248848658
11620,"Ardmore, OK",1997,79,23,102,44304,2.30227518959913
11620,"Ardmore, OK",1998,70,102,172,44390,3.87474656454156
11620,"Ardmore, OK",1999,75,18,93,44639,2.08338000403235
11620,"Ardmore, OK",2000,74,74,148,45547,3.24939073923639
11620,"Ardmore, OK",2001,79,6,85,45455,1.869981300187
11620,"Ardmore, OK",2002,80,0,80,45656,1.75223409847556
11620,"Ardmore, OK",2003,107,79,186,45854,4.05635277184106
11620,"Ardmore, OK",2004,102,5,107,46218,2.31511532303432
11620,"Ardmore, OK",2005,133,159,292,46169,6.32459009291949
11620,"Ardmore, OK",2006,95,0,95,46430,2.04609088951109
11620,"Ardmore, OK",2007,92,0,92,46582,1.9750118071358
11620,"Ardmore, OK",2008,94,12,106,46910,2.25964613088894
11620,"Ardmore, OK",2009,123,16,139,47421,2.93119082263132
11620,"Ardmore, OK",2010,137,8,145,47808,3.03296519410977
11620,"Ardmore, OK",2011,97,4,101,48054,2.10180213926
11620,"Ardmore, OK",2012,73,4,77,48016,1.60363212262579
11620,"Ardmore, OK",2013,112,6,118,48461,2.43494768989497
11620,"Ardmore, OK",2014,71,0,71,48581,1.46147670900146
11620,"Ardmore, OK",2015,61,0,61,48556,1.25628140703518
11620,"Ardmore, OK",2016,61,9,70,48421,1.44565374527581
11620,"Ardmore, OK",2017,124,0,124,48295,2.56755357697484
11620,"Ardmore, OK",2018,77,0,77,48177,1.59827303485065
11660,"Arkadelphia, AR",1990,24,7,31,21390,1.44927536231884
11660,"Arkadelphia, AR",1991,29,10,39,21377,1.82439070028535
11660,"Arkadelphia, AR",1992,40,30,70,21449,3.26355541050865
11660,"Arkadelphia, AR",1993,26,18,44,21831,2.01548257065641
11660,"Arkadelphia, AR",1994,24,74,98,22136,4.42717744850018
11660,"Arkadelphia, AR",1995,34,22,56,22105,2.53336349242253
11660,"Arkadelphia, AR",1996,40,14,54,22045,2.44953504195963
11660,"Arkadelphia, AR",1997,31,24,55,22223,2.47491337803177
11660,"Arkadelphia, AR",1998,47,59,106,21671,4.89132942642241
11660,"Arkadelphia, AR",1999,43,0,43,21536,1.99665676077266
11660,"Arkadelphia, AR",2000,29,0,29,23474,1.23540938911136
11660,"Arkadelphia, AR",2001,41,147,188,23516,7.99455689743154
11660,"Arkadelphia, AR",2002,38,0,38,23334,1.62852489928859
11660,"Arkadelphia, AR",2003,15,10,25,23032,1.08544633553317
11660,"Arkadelphia, AR",2004,17,10,27,22904,1.17883339154733
11660,"Arkadelphia, AR",2005,15,4,19,22800,0.833333333333333
11660,"Arkadelphia, AR",2006,20,0,20,22924,0.872448089338684
11660,"Arkadelphia, AR",2007,37,0,37,23139,1.59903193742167
11660,"Arkadelphia, AR",2008,15,0,15,23272,0.644551392231007
11660,"Arkadelphia, AR",2009,13,0,13,23100,0.562770562770563
11660,"Arkadelphia, AR",2010,13,0,13,22927,0.56701705412832
11660,"Arkadelphia, AR",2011,10,4,14,22927,0.61063375059973
11660,"Arkadelphia, AR",2012,8,36,44,22759,1.93330111164814
11660,"Arkadelphia, AR",2013,9,28,37,22588,1.63803789622809
11660,"Arkadelphia, AR",2014,3,0,3,22565,0.132949257699978
11660,"Arkadelphia, AR",2015,3,0,3,22517,0.133232668650353
11660,"Arkadelphia, AR",2016,4,36,40,22600,1.76991150442478
11660,"Arkadelphia, AR",2017,18,0,18,22180,0.811541929666366
11660,"Arkadelphia, AR",2018,13,28,41,22061,1.85848329631476
11680,"Arkansas City-Winfield, KS",1990,20,0,20,36944,0.5413598960589
11680,"Arkansas City-Winfield, KS",1991,15,2,17,36661,0.463708027604266
11680,"Arkansas City-Winfield, KS",1992,18,14,32,36951,0.866011745284295
11680,"Arkansas City-Winfield, KS",1993,34,35,69,37126,1.85853579701557
11680,"Arkansas City-Winfield, KS",1994,44,59,103,37271,2.7635427007593
11680,"Arkansas City-Winfield, KS",1995,56,0,56,37464,1.49476831091181
11680,"Arkansas City-Winfield, KS",1996,46,6,52,37566,1.38423042112549
11680,"Arkansas City-Winfield, KS",1997,42,6,48,37416,1.28287363694676
11680,"Arkansas City-Winfield, KS",1998,35,20,55,37038,1.48496139100383
11680,"Arkansas City-Winfield, KS",1999,37,0,37,36846,1.00417955816099
11680,"Arkansas City-Winfield, KS",2000,58,50,108,36342,2.97176820208024
11680,"Arkansas City-Winfield, KS",2001,59,158,217,36103,6.01058083815749
11680,"Arkansas City-Winfield, KS",2002,68,0,68,36680,1.85387131952017
11680,"Arkansas City-Winfield, KS",2003,41,0,41,36300,1.12947658402204
11680,"Arkansas City-Winfield, KS",2004,81,0,81,36317,2.23036043726079
11680,"Arkansas City-Winfield, KS",2005,79,0,79,35928,2.19884212870185
11680,"Arkansas City-Winfield, KS",2006,71,10,81,35787,2.2633917344287
11680,"Arkansas City-Winfield, KS",2007,73,20,93,36148,2.57275644572314
11680,"Arkansas City-Winfield, KS",2008,45,6,51,36284,1.40557821629368
11680,"Arkansas City-Winfield, KS",2009,30,8,38,36195,1.0498687664042
11680,"Arkansas City-Winfield, KS",2010,35,2,37,36312,1.01894690460454
11680,"Arkansas City-Winfield, KS",2011,36,24,60,36242,1.65553777385354
11680,"Arkansas City-Winfield, KS",2012,32,2,34,36263,0.937594793591264
11680,"Arkansas City-Winfield, KS",2013,35,4,39,36164,1.07842052870258
11680,"Arkansas City-Winfield, KS",2014,31,4,35,35889,0.975229178857031
11680,"Arkansas City-Winfield, KS",2015,36,75,111,35773,3.10289883431638
11680,"Arkansas City-Winfield, KS",2016,32,2,34,35717,0.951927653498334
11680,"Arkansas City-Winfield, KS",2017,33,6,39,35356,1.10306595768752
11680,"Arkansas City-Winfield, KS",2018,28,6,34,35218,0.965415412573116
11700,"Asheville, NC",1990,1593,116,1709,309130,5.52841846472358
11700,"Asheville, NC",1991,1640,246,1886,313274,6.02028894833277
11700,"Asheville, NC",1992,1834,408,2242,317782,7.05515101547602
11700,"Asheville, NC",1993,1897,224,2121,323124,6.56404352508634
11700,"Asheville, NC",1994,1903,388,2291,328091,6.98281879112807
11700,"Asheville, NC",1995,1750,326,2076,333202,6.23045479919088
11700,"Asheville, NC",1996,1986,914,2900,337600,8.59004739336493
11700,"Asheville, NC",1997,2135,447,2582,341891,7.5521145628285
11700,"Asheville, NC",1998,2337,378,2715,345874,7.84967936300502
11700,"Asheville, NC",1999,2375,370,2745,349227,7.86021699353143
11700,"Asheville, NC",2000,2197,386,2583,370615,6.96949664746435
11700,"Asheville, NC",2001,2401,1340,3741,374904,9.97855450995455
11700,"Asheville, NC",2002,2726,1042,3768,379818,9.9205408906371
11700,"Asheville, NC",2003,2859,410,3269,385178,8.48698523799386
11700,"Asheville, NC",2004,3138,616,3754,390713,9.60807549275299
11700,"Asheville, NC",2005,3446,793,4239,396408,10.6935278803657
11700,"Asheville, NC",2006,3750,560,4310,404546,10.6539182194361
11700,"Asheville, NC",2007,3324,324,3648,411842,8.85776584224047
11700,"Asheville, NC",2008,1742,830,2572,417457,6.16111359972404
11700,"Asheville, NC",2009,1171,294,1465,422014,3.47144881449431
11700,"Asheville, NC",2010,1045,993,2038,425338,4.79148347902139
11700,"Asheville, NC",2011,932,69,1001,428073,2.3383862098287
11700,"Asheville, NC",2012,1264,6,1270,430951,2.9469707692986
11700,"Asheville, NC",2013,1332,192,1524,435823,3.49683242967902
11700,"Asheville, NC",2014,1408,424,1832,439715,4.16633501245125
11700,"Asheville, NC",2015,1794,367,2161,444673,4.8597508731135
11700,"Asheville, NC",2016,1919,1284,3203,450459,7.1105250422347
11700,"Asheville, NC",2017,2103,668,2771,455255,6.08669866338645
11700,"Asheville, NC",2018,2233,572,2805,459585,6.10333235418911
11740,"Ashland, OH",1990,136,3,139,47559,2.9226855064236
11740,"Ashland, OH",1991,172,2,174,48050,3.62122788761707
11740,"Ashland, OH",1992,161,15,176,48620,3.61990950226244
11740,"Ashland, OH",1993,215,8,223,49733,4.48394426236101
11740,"Ashland, OH",1994,225,28,253,50433,5.01655661967363
11740,"Ashland, OH",1995,202,14,216,50366,4.28860739387682
11740,"Ashland, OH",1996,188,30,218,50790,4.29218350068911
11740,"Ashland, OH",1997,203,23,226,51208,4.41337291048274
11740,"Ashland, OH",1998,198,6,204,51670,3.94813237855622
11740,"Ashland, OH",1999,204,19,223,52044,4.28483590807778
11740,"Ashland, OH",2000,171,14,185,52502,3.52367528856044
11740,"Ashland, OH",2001,162,0,162,52560,3.08219178082192
11740,"Ashland, OH",2002,181,34,215,52595,4.08784104952942
11740,"Ashland, OH",2003,142,8,150,52867,2.83730871810392
11740,"Ashland, OH",2004,191,23,214,52852,4.0490426095512
11740,"Ashland, OH",2005,162,196,358,53048,6.74860503694767
11740,"Ashland, OH",2006,133,8,141,53231,2.64883244725818
11740,"Ashland, OH",2007,129,36,165,53544,3.08157776781712
11740,"Ashland, OH",2008,69,2,71,53499,1.32712760986187
11740,"Ashland, OH",2009,48,0,48,53305,0.900478379138918
11740,"Ashland, OH",2010,38,2,40,53323,0.750145340659753
11740,"Ashland, OH",2011,35,2,37,53247,0.694874828628843
11740,"Ashland, OH",2012,40,2,42,53237,0.788924995773616
11740,"Ashland, OH",2013,39,4,43,53152,0.80900060204696
11740,"Ashland, OH",2014,44,4,48,53158,0.90296850897325
11740,"Ashland, OH",2015,63,4,67,53289,1.25729512657396
11740,"Ashland, OH",2016,56,2,58,53506,1.08399058049565
11740,"Ashland, OH",2017,61,0,61,53685,1.13625780013039
11740,"Ashland, OH",2018,54,0,54,53745,1.0047446274072
11780,"Ashtabula, OH",1990,132,36,168,100003,1.67994960151195
11780,"Ashtabula, OH",1991,155,26,181,100307,1.80446030685795
11780,"Ashtabula, OH",1992,204,83,287,100751,2.8486069617175
11780,"Ashtabula, OH",1993,231,50,281,101229,2.77588438095803
11780,"Ashtabula, OH",1994,260,42,302,101660,2.97068660240016
11780,"Ashtabula, OH",1995,274,25,299,102047,2.9300224406401
11780,"Ashtabula, OH",1996,300,20,320,102398,3.12506103634837
11780,"Ashtabula, OH",1997,239,6,245,103021,2.37815590996011
11780,"Ashtabula, OH",1998,200,0,200,103200,1.93798449612403
11780,"Ashtabula, OH",1999,474,7,481,103207,4.66053659151027
11780,"Ashtabula, OH",2000,445,4,449,102705,4.37174431624556
11780,"Ashtabula, OH",2001,412,0,412,102450,4.02147388970229
11780,"Ashtabula, OH",2002,441,0,441,102577,4.29920937442117
11780,"Ashtabula, OH",2003,331,0,331,102667,3.22401550644316
11780,"Ashtabula, OH",2004,371,4,375,102648,3.65326163198504
11780,"Ashtabula, OH",2005,214,0,214,102638,2.08499775911456
11780,"Ashtabula, OH",2006,227,0,227,102340,2.21809654094196
11780,"Ashtabula, OH",2007,135,0,135,102156,1.3215082814519
11780,"Ashtabula, OH",2008,96,21,117,101826,1.14901891461906
11780,"Ashtabula, OH",2009,66,0,66,101584,0.649708615530005
11780,"Ashtabula, OH",2010,77,4,81,101402,0.798800812607246
11780,"Ashtabula, OH",2011,64,0,64,101070,0.633224497872761
11780,"Ashtabula, OH",2012,76,9,85,100236,0.847998723013688
11780,"Ashtabula, OH",2013,57,6,63,99732,0.631692937071351
11780,"Ashtabula, OH",2014,71,20,91,99017,0.919034105254653
11780,"Ashtabula, OH",2015,68,20,88,98372,0.894563493677063
11780,"Ashtabula, OH",2016,74,18,92,98108,0.937742080156562
11780,"Ashtabula, OH",2017,80,22,102,97692,1.04409777668591
11780,"Ashtabula, OH",2018,92,22,114,97493,1.16931472003118
11820,"Astoria, OR",1990,173,86,259,33424,7.7489229296314
11820,"Astoria, OR",1991,173,18,191,33793,5.65205811854526
11820,"Astoria, OR",1992,138,22,160,34199,4.67849937132665
11820,"Astoria, OR",1993,153,99,252,34577,7.28808167278827
11820,"Astoria, OR",1994,173,75,248,35079,7.06975683457339
11820,"Astoria, OR",1995,142,38,180,35267,5.10392151302918
11820,"Astoria, OR",1996,187,102,289,35136,8.22518214936248
11820,"Astoria, OR",1997,170,87,257,35410,7.25783676927422
11820,"Astoria, OR",1998,158,105,263,35352,7.43946594252093
11820,"Astoria, OR",1999,147,10,157,35264,4.45213248638838
11820,"Astoria, OR",2000,137,17,154,35560,4.33070866141732
11820,"Astoria, OR",2001,139,2,141,35509,3.97082429806528
11820,"Astoria, OR",2002,155,12,167,35519,4.70170894450857
11820,"Astoria, OR",2003,202,16,218,35612,6.1215320678423
11820,"Astoria, OR",2004,215,55,270,35912,7.51837825796391
11820,"Astoria, OR",2005,227,53,280,36282,7.71732539551293
11820,"Astoria, OR",2006,240,108,348,36603,9.50741742480125
11820,"Astoria, OR",2007,214,2,216,36818,5.86669563800315
11820,"Astoria, OR",2008,167,44,211,36825,5.72980312287848
11820,"Astoria, OR",2009,80,2,82,36972,2.21789462295791
11820,"Astoria, OR",2010,127,33,160,37086,4.31429650002696
11820,"Astoria, OR",2011,91,38,129,37220,3.46587855991402
11820,"Astoria, OR",2012,78,8,86,37408,2.29897348160821
11820,"Astoria, OR",2013,82,30,112,37105,3.01846112383776
11820,"Astoria, OR",2014,96,6,102,37440,2.72435897435897
11820,"Astoria, OR",2015,122,86,208,37800,5.5026455026455
11820,"Astoria, OR",2016,136,26,162,38686,4.18756139171793
11820,"Astoria, OR",2017,128,40,168,39119,4.29458830747207
11820,"Astoria, OR",2018,140,10,150,39764,3.77225631224223
11860,"Atchison, KS",1990,13,0,13,16906,0.768957766473441
11860,"Atchison, KS",1991,11,0,11,16832,0.65351711026616
11860,"Atchison, KS",1992,8,0,8,16851,0.474749273040176
11860,"Atchison, KS",1993,10,0,10,16955,0.589796520200531
11860,"Atchison, KS",1994,22,0,22,16805,1.30913418625409
11860,"Atchison, KS",1995,12,19,31,16806,1.84457931691063
11860,"Atchison, KS",1996,15,0,15,16823,0.89163645009808
11860,"Atchison, KS",1997,13,48,61,16817,3.62728191710769
11860,"Atchison, KS",1998,9,0,9,16847,0.534219742387369
11860,"Atchison, KS",1999,14,0,14,16879,0.82943302328337
11860,"Atchison, KS",2000,11,0,11,16796,0.654917837580376
11860,"Atchison, KS",2001,16,0,16,16868,0.948541617263458
11860,"Atchison, KS",2002,18,0,18,16823,1.0699637401177
11860,"Atchison, KS",2003,17,18,35,16875,2.07407407407407
11860,"Atchison, KS",2004,21,6,27,16937,1.59414300053138
11860,"Atchison, KS",2005,23,2,25,16865,1.48235991698784
11860,"Atchison, KS",2006,33,0,33,16902,1.95243166489173
11860,"Atchison, KS",2007,9,0,9,16864,0.533681214421252
11860,"Atchison, KS",2008,10,36,46,16820,2.73483947681332
11860,"Atchison, KS",2009,1,6,7,16965,0.412614205717654
11860,"Atchison, KS",2010,4,0,4,16857,0.237290146526665
11860,"Atchison, KS",2011,6,0,6,16754,0.35812343320998
11860,"Atchison, KS",2012,5,0,5,16775,0.29806259314456
11860,"Atchison, KS",2013,4,2,6,16690,0.359496704613541
11860,"Atchison, KS",2014,2,0,2,16524,0.121036068748487
11860,"Atchison, KS",2015,2,0,2,16419,0.121810098057129
11860,"Atchison, KS",2016,5,0,5,16376,0.305324865657059
11860,"Atchison, KS",2017,4,0,4,16301,0.245383718790258
11860,"Atchison, KS",2018,5,2,7,16193,0.432285555486939
11900,"Athens, OH",1990,25,0,25,59517,0.42004805349732
11900,"Athens, OH",1991,28,58,86,59758,1.43913785601928
11900,"Athens, OH",1992,17,73,90,59792,1.50521808937651
11900,"Athens, OH",1993,16,0,16,60317,0.265265182286917
11900,"Athens, OH",1994,15,14,29,60479,0.479505282825444
11900,"Athens, OH",1995,19,62,81,61009,1.32767296628366
11900,"Athens, OH",1996,20,51,71,61359,1.15712446421878
11900,"Athens, OH",1997,12,61,73,61352,1.18985526144217
11900,"Athens, OH",1998,7,54,61,61624,0.9898740750357
11900,"Athens, OH",1999,14,31,45,62091,0.724742716335701
11900,"Athens, OH",2000,38,3,41,62324,0.657852512675695
11900,"Athens, OH",2001,24,11,35,62997,0.555582011841834
11900,"Athens, OH",2002,25,0,25,63401,0.39431554707339
11900,"Athens, OH",2003,17,23,40,63827,0.626694032306077
11900,"Athens, OH",2004,14,29,43,63230,0.680056934999209
11900,"Athens, OH",2005,17,9,26,64075,0.405774483027702
11900,"Athens, OH",2006,26,71,97,64237,1.51003315846008
11900,"Athens, OH",2007,72,32,104,64102,1.62241427724564
11900,"Athens, OH",2008,33,239,272,64546,4.21404889536145
11900,"Athens, OH",2009,6,19,25,64618,0.386889102107772
11900,"Athens, OH",2010,2,193,195,65175,2.99194476409666
11900,"Athens, OH",2011,7,67,74,65070,1.13723682188412
11900,"Athens, OH",2012,6,5,11,64603,0.170270730461434
11900,"Athens, OH",2013,4,6,10,64584,0.15483711135885
11900,"Athens, OH",2014,15,78,93,64778,1.43567260489672
11900,"Athens, OH",2015,10,81,91,65948,1.37987505307212
11900,"Athens, OH",2016,12,10,22,66470,0.33097638032195
11900,"Athens, OH",2017,16,10,26,66664,0.390015600624025
11900,"Athens, OH",2018,4,2,6,65818,0.0911604728189857
11940,"Athens, TN",1990,32,118,150,42434,3.53490125842485
11940,"Athens, TN",1991,51,6,57,42792,1.33202467750981
11940,"Athens, TN",1992,51,4,55,43503,1.26428062432476
11940,"Athens, TN",1993,57,12,69,43870,1.57282881240027
11940,"Athens, TN",1994,90,22,112,44378,2.52377304069584
11940,"Athens, TN",1995,70,21,91,45058,2.01961915753029
11940,"Athens, TN",1996,61,4,65,45449,1.43017448128672
11940,"Athens, TN",1997,63,0,63,45972,1.37039937353171
11940,"Athens, TN",1998,58,202,260,46218,5.62551386905535
11940,"Athens, TN",1999,46,2,48,46500,1.03225806451613
11940,"Athens, TN",2000,61,4,65,49148,1.32253601367299
11940,"Athens, TN",2001,45,0,45,49711,0.905232242360846
11940,"Athens, TN",2002,49,0,49,49934,0.981295309808948
11940,"Athens, TN",2003,59,3,62,50257,1.23365899277713
11940,"Athens, TN",2004,76,22,98,50441,1.94286394004877
11940,"Athens, TN",2005,69,0,69,50999,1.35296770524912
11940,"Athens, TN",2006,71,0,71,51610,1.37570238325906
11940,"Athens, TN",2007,64,0,64,51912,1.23285560178764
11940,"Athens, TN",2008,41,2,43,52284,0.822431336546553
11940,"Athens, TN",2009,15,0,15,52332,0.286631506535198
11940,"Athens, TN",2010,0,0,0,52169,0
11940,"Athens, TN",2011,13,0,13,52319,0.248475697165466
11940,"Athens, TN",2012,8,0,8,52376,0.152741713762028
11940,"Athens, TN",2013,10,0,10,52345,0.19104021396504
11940,"Athens, TN",2014,14,10,24,52555,0.45666444677005
11940,"Athens, TN",2015,15,0,15,52469,0.285883092873887
11940,"Athens, TN",2016,16,2,18,52660,0.341815419673376
11940,"Athens, TN",2017,14,0,14,52895,0.264675300122885
11940,"Athens, TN",2018,18,6,24,53285,0.450408182415314
11980,"Athens, TX",1990,53,0,53,58625,0.904051172707889
11980,"Athens, TX",1991,35,0,35,59109,0.592126410529699
11980,"Athens, TX",1992,42,0,42,59958,0.700490343240268
11980,"Athens, TX",1993,73,0,73,61033,1.19607425491128
11980,"Athens, TX",1994,65,3,68,62067,1.09559024924678
11980,"Athens, TX",1995,99,0,99,63907,1.54912607382603
11980,"Athens, TX",1996,86,0,86,65298,1.31703880670158
11980,"Athens, TX",1997,100,8,108,67272,1.60542276132715
11980,"Athens, TX",1998,107,10,117,68935,1.69725103358236
11980,"Athens, TX",1999,139,18,157,70486,2.22739267372244
11980,"Athens, TX",2000,111,4,115,73332,1.56821033109693
11980,"Athens, TX",2001,94,8,102,73762,1.38282584528619
11980,"Athens, TX",2002,127,0,127,74712,1.69986079880073
11980,"Athens, TX",2003,135,7,142,76349,1.85988028657874
11980,"Athens, TX",2004,139,6,145,77807,1.86358553857622
11980,"Athens, TX",2005,141,36,177,78001,2.26920167690158
11980,"Athens, TX",2006,131,8,139,78404,1.77286873118718
11980,"Athens, TX",2007,114,48,162,78178,2.07219422343882
11980,"Athens, TX",2008,49,0,49,78033,0.627939461509874
11980,"Athens, TX",2009,50,2,52,78231,0.664698137566949
11980,"Athens, TX",2010,60,0,60,78622,0.763145175650581
11980,"Athens, TX",2011,56,0,56,78792,0.710732054015636
11980,"Athens, TX",2012,142,16,158,78951,2.00124127623463
11980,"Athens, TX",2013,67,0,67,78639,0.851994557407902
11980,"Athens, TX",2014,68,0,68,79302,0.857481526317117
11980,"Athens, TX",2015,47,0,47,79507,0.591142918233615
11980,"Athens, TX",2016,40,54,94,80129,1.17310836276504
11980,"Athens, TX",2017,95,0,95,81061,1.17195692133085
11980,"Athens, TX",2018,138,0,138,82299,1.67681259796595
12020,"Athens-Clarke County, GA",1990,650,138,788,126827,6.21318804355539
12020,"Athens-Clarke County, GA",1991,576,548,1124,137935,8.14876572298546
12020,"Athens-Clarke County, GA",1992,663,169,832,139304,5.97254924481709
12020,"Athens-Clarke County, GA",1993,716,190,906,141118,6.42015901585907
12020,"Athens-Clarke County, GA",1994,725,451,1176,143871,8.17398919865713
12020,"Athens-Clarke County, GA",1995,781,736,1517,134631,11.2678357881914
12020,"Athens-Clarke County, GA",1996,780,1111,1891,136530,13.8504358016553
12020,"Athens-Clarke County, GA",1997,765,277,1042,138089,7.5458581060041
12020,"Athens-Clarke County, GA",1998,1080,366,1446,138606,10.4324488117398
12020,"Athens-Clarke County, GA",1999,897,610,1507,140223,10.7471670125443
12020,"Athens-Clarke County, GA",2000,931,427,1358,154075,8.81388933960733
12020,"Athens-Clarke County, GA",2001,959,468,1427,156071,9.14327453530765
12020,"Athens-Clarke County, GA",2002,1319,945,2264,157686,14.3576474766308
12020,"Athens-Clarke County, GA",2003,1413,543,1956,160478,12.1885865975398
12020,"Athens-Clarke County, GA",2004,1958,155,2113,178106,11.8637216039886
12020,"Athens-Clarke County, GA",2005,1719,277,1996,178974,11.1524578989127
12020,"Athens-Clarke County, GA",2006,1411,480,1891,183171,10.3236866097799
12020,"Athens-Clarke County, GA",2007,1164,527,1691,186781,9.05338337411193
12020,"Athens-Clarke County, GA",2008,530,61,591,189948,3.11137785078021
12020,"Athens-Clarke County, GA",2009,277,20,297,192021,1.54670582904995
12020,"Athens-Clarke County, GA",2010,226,0,226,193435,1.16835112570114
12020,"Athens-Clarke County, GA",2011,240,87,327,194349,1.68254017257614
12020,"Athens-Clarke County, GA",2012,447,172,619,195981,3.15846944346646
12020,"Athens-Clarke County, GA",2013,698,381,1079,197592,5.46074739868011
12020,"Athens-Clarke County, GA",2014,502,428,930,198378,4.68801984090978
12020,"Athens-Clarke County, GA",2015,562,597,1159,202533,5.72252423061921
12020,"Athens-Clarke County, GA",2016,523,61,584,205296,2.84467305743902
12020,"Athens-Clarke County, GA",2017,581,190,771,208997,3.68904816815552
12020,"Athens-Clarke County, GA",2018,729,340,1069,211306,5.0590139418663
12060,"Atlanta-Sandy Springs-Roswell, GA",1990,22617,6063,28680,3100751,9.24937216822634
12060,"Atlanta-Sandy Springs-Roswell, GA",1991,23712,1985,25697,3177706,8.08665118799536
12060,"Atlanta-Sandy Springs-Roswell, GA",1992,29361,929,30290,3259486,9.29287623876893
12060,"Atlanta-Sandy Springs-Roswell, GA",1993,34029,3746,37775,3354232,11.2618924391634
12060,"Atlanta-Sandy Springs-Roswell, GA",1994,33869,8515,42384,3459456,12.2516372516373
12060,"Atlanta-Sandy Springs-Roswell, GA",1995,36262,13211,49473,3563747,13.8822986031276
12060,"Atlanta-Sandy Springs-Roswell, GA",1996,38835,10821,49656,3667577,13.5391840443977
12060,"Atlanta-Sandy Springs-Roswell, GA",1997,39828,11351,51179,3772654,13.5657815426488
12060,"Atlanta-Sandy Springs-Roswell, GA",1998,47466,12353,59819,3887500,15.3875241157556
12060,"Atlanta-Sandy Springs-Roswell, GA",1999,49783,12825,62608,4005104,15.6320534997343
12060,"Atlanta-Sandy Springs-Roswell, GA",2000,48223,17544,65767,4293475,15.3178951781482
12060,"Atlanta-Sandy Springs-Roswell, GA",2001,50096,16905,67001,4402455,15.2190084850385
12060,"Atlanta-Sandy Springs-Roswell, GA",2002,52056,16480,68536,4489288,15.2665634283209
12060,"Atlanta-Sandy Springs-Roswell, GA",2003,55205,11404,66609,4572541,14.5671739192716
12060,"Atlanta-Sandy Springs-Roswell, GA",2004,57527,16729,74256,4659574,15.9362207789811
12060,"Atlanta-Sandy Springs-Roswell, GA",2005,61837,11307,73144,4770870,15.3313756191219
12060,"Atlanta-Sandy Springs-Roswell, GA",2006,54156,14339,68495,4931848,13.8883031269415
12060,"Atlanta-Sandy Springs-Roswell, GA",2007,31262,13681,44943,5066356,8.87087287194189
12060,"Atlanta-Sandy Springs-Roswell, GA",2008,12057,7305,19362,5170099,3.7449959855701
12060,"Atlanta-Sandy Springs-Roswell, GA",2009,5455,1112,6567,5240828,1.25304627436733
12060,"Atlanta-Sandy Springs-Roswell, GA",2010,6417,1191,7608,5302703,1.43473998072304
12060,"Atlanta-Sandy Springs-Roswell, GA",2011,6248,2420,8668,5366252,1.61528008748005
12060,"Atlanta-Sandy Springs-Roswell, GA",2012,9182,5213,14395,5444763,2.64382490110222
12060,"Atlanta-Sandy Springs-Roswell, GA",2013,14864,9473,24337,5511323,4.4158181257023
12060,"Atlanta-Sandy Springs-Roswell, GA",2014,16984,9699,26683,5594545,4.76946740083421
12060,"Atlanta-Sandy Springs-Roswell, GA",2015,19995,10347,30342,5688284,5.33412185467533
12060,"Atlanta-Sandy Springs-Roswell, GA",2016,23100,13257,36357,5790280,6.27897096513467
12060,"Atlanta-Sandy Springs-Roswell, GA",2017,24973,8859,33832,5874249,5.75937451749151
12060,"Atlanta-Sandy Springs-Roswell, GA",2018,26506,12935,39441,5949951,6.62879408586726
12100,"Atlantic City-Hammonton, NJ",1990,670,356,1026,225155,4.55686082920655
12100,"Atlantic City-Hammonton, NJ",1991,494,187,681,227362,2.99522347621854
12100,"Atlantic City-Hammonton, NJ",1992,484,14,498,229063,2.17407438128375
12100,"Atlantic City-Hammonton, NJ",1993,622,39,661,230575,2.86674617803318
12100,"Atlantic City-Hammonton, NJ",1994,987,14,1001,231701,4.32022304608094
12100,"Atlantic City-Hammonton, NJ",1995,561,117,678,233124,2.90832346733927
12100,"Atlantic City-Hammonton, NJ",1996,917,124,1041,234835,4.4328996955309
12100,"Atlantic City-Hammonton, NJ",1997,994,9,1003,236218,4.24607777561405
12100,"Atlantic City-Hammonton, NJ",1998,1148,72,1220,238037,5.12525363703962
12100,"Atlantic City-Hammonton, NJ",1999,1239,162,1401,239333,5.85376859856351
12100,"Atlantic City-Hammonton, NJ",2000,1433,192,1625,253674,6.40585948895038
12100,"Atlantic City-Hammonton, NJ",2001,1583,102,1685,255737,6.58880021271854
12100,"Atlantic City-Hammonton, NJ",2002,1851,169,2020,259263,7.79131615386692
12100,"Atlantic City-Hammonton, NJ",2003,2058,227,2285,263285,8.67880813567047
12100,"Atlantic City-Hammonton, NJ",2004,1970,105,2075,267723,7.75054814117577
12100,"Atlantic City-Hammonton, NJ",2005,1839,163,2002,270332,7.40570853617034
12100,"Atlantic City-Hammonton, NJ",2006,1536,357,1893,271759,6.96573066577372
12100,"Atlantic City-Hammonton, NJ",2007,1025,111,1136,272303,4.17182329978002
12100,"Atlantic City-Hammonton, NJ",2008,690,104,794,273014,2.90827576607793
12100,"Atlantic City-Hammonton, NJ",2009,486,26,512,274049,1.86827903039238
12100,"Atlantic City-Hammonton, NJ",2010,419,93,512,274649,1.86419757581495
12100,"Atlantic City-Hammonton, NJ",2011,337,53,390,274606,1.42021660123959
12100,"Atlantic City-Hammonton, NJ",2012,372,69,441,274651,1.60567411005239
12100,"Atlantic City-Hammonton, NJ",2013,397,87,484,274369,1.76404768760319
12100,"Atlantic City-Hammonton, NJ",2014,392,330,722,272656,2.64802535062496
12100,"Atlantic City-Hammonton, NJ",2015,351,359,710,270471,2.62505037508642
12100,"Atlantic City-Hammonton, NJ",2016,336,747,1083,267813,4.04386642918753
12100,"Atlantic City-Hammonton, NJ",2017,304,786,1090,266328,4.09269772611216
12100,"Atlantic City-Hammonton, NJ",2018,349,484,833,265429,3.13831570777873
12180,"Auburn, NY",1990,234,27,261,82430,3.16632294067694
12180,"Auburn, NY",1991,159,0,159,82797,1.9203594333128
12180,"Auburn, NY",1992,177,0,177,82738,2.13928303802364
12180,"Auburn, NY",1993,212,2,214,82741,2.58638401759708
12180,"Auburn, NY",1994,208,32,240,82650,2.9038112522686
12180,"Auburn, NY",1995,152,0,152,82615,1.83985958966289
12180,"Auburn, NY",1996,147,3,150,82432,1.81968167701863
12180,"Auburn, NY",1997,124,3,127,82215,1.54473028036246
12180,"Auburn, NY",1998,141,4,145,81957,1.76922044486743
12180,"Auburn, NY",1999,145,10,155,81434,1.9033818798045
12180,"Auburn, NY",2000,142,6,148,81871,1.80772190397088
12180,"Auburn, NY",2001,165,4,169,81313,2.07838844957141
12180,"Auburn, NY",2002,160,2,162,81401,1.990147541185
12180,"Auburn, NY",2003,166,0,166,81395,2.03943731187419
12180,"Auburn, NY",2004,171,2,173,81284,2.12834014074111
12180,"Auburn, NY",2005,161,0,161,81104,1.9851055434997
12180,"Auburn, NY",2006,127,4,131,80892,1.61944320822826
12180,"Auburn, NY",2007,113,2,115,80629,1.42628582767987
12180,"Auburn, NY",2008,80,0,80,80482,0.994011083223578
12180,"Auburn, NY",2009,61,30,91,80172,1.1350596218131
12180,"Auburn, NY",2010,72,13,85,79901,1.0638164728852
12180,"Auburn, NY",2011,69,0,69,79693,0.865822594205263
12180,"Auburn, NY",2012,74,24,98,79509,1.23256486687042
12180,"Auburn, NY",2013,95,0,95,79090,1.20116323176128
12180,"Auburn, NY",2014,61,110,171,78768,2.1709323583181
12180,"Auburn, NY",2015,80,28,108,78300,1.37931034482759
12180,"Auburn, NY",2016,125,2,127,77666,1.63520716916025
12180,"Auburn, NY",2017,97,0,97,77463,1.25221073286601
12180,"Auburn, NY",2018,114,2,116,77145,1.50366193531661
12220,"Auburn-Opelika, AL",1990,192,392,584,87497,6.67451455478474
12220,"Auburn-Opelika, AL",1991,243,110,353,88298,3.99782554531246
12220,"Auburn-Opelika, AL",1992,289,201,490,89355,5.4837446141794
12220,"Auburn-Opelika, AL",1993,278,128,406,91016,4.46075415311594
12220,"Auburn-Opelika, AL",1994,360,158,518,91714,5.64799267287437
12220,"Auburn-Opelika, AL",1995,258,147,405,93866,4.31466132571964
12220,"Auburn-Opelika, AL",1996,429,114,543,95465,5.68794846278741
12220,"Auburn-Opelika, AL",1997,317,476,793,98494,8.05125185290474
12220,"Auburn-Opelika, AL",1998,274,505,779,100500,7.75124378109453
12220,"Auburn-Opelika, AL",1999,343,214,557,102093,5.45580989881774
12220,"Auburn-Opelika, AL",2000,330,244,574,115430,4.97271073377805
12220,"Auburn-Opelika, AL",2001,365,598,963,116819,8.2435220298068
12220,"Auburn-Opelika, AL",2002,737,903,1640,118392,13.8522873167106
12220,"Auburn-Opelika, AL",2003,665,502,1167,120071,9.71924944407892
12220,"Auburn-Opelika, AL",2004,1203,297,1500,122274,12.2675303007998
12220,"Auburn-Opelika, AL",2005,1413,353,1766,126133,14.0010940832296
12220,"Auburn-Opelika, AL",2006,1687,517,2204,129247,17.0526201768706
12220,"Auburn-Opelika, AL",2007,1181,322,1503,131934,11.3920596661967
12220,"Auburn-Opelika, AL",2008,726,571,1297,134524,9.64140227766049
12220,"Auburn-Opelika, AL",2009,650,603,1253,138566,9.04262228829583
12220,"Auburn-Opelika, AL",2010,623,348,971,140806,6.89601295399344
12220,"Auburn-Opelika, AL",2011,739,218,957,144130,6.63983903420523
12220,"Auburn-Opelika, AL",2012,650,56,706,148581,4.75161696313795
12220,"Auburn-Opelika, AL",2013,676,50,726,151831,4.78163220949608
12220,"Auburn-Opelika, AL",2014,751,192,943,154545,6.10178265230192
12220,"Auburn-Opelika, AL",2015,826,12,838,157009,5.33727365947175
12220,"Auburn-Opelika, AL",2016,853,38,891,159297,5.59332567468314
12220,"Auburn-Opelika, AL",2017,971,390,1361,161641,8.41989346762269
12220,"Auburn-Opelika, AL",2018,1036,95,1131,163941,6.89882335718338
12260,"Augusta-Richmond County, GA-SC",1990,2490,78,2568,445846,5.75983635605119
12260,"Augusta-Richmond County, GA-SC",1991,2464,233,2697,457957,5.88919920429211
12260,"Augusta-Richmond County, GA-SC",1992,2848,75,2923,471025,6.20561541319463
12260,"Augusta-Richmond County, GA-SC",1993,2571,100,2671,472050,5.65829890901388
12260,"Augusta-Richmond County, GA-SC",1994,2468,241,2709,477102,5.67803111284379
12260,"Augusta-Richmond County, GA-SC",1995,1952,241,2193,481442,4.5550658230898
12260,"Augusta-Richmond County, GA-SC",1996,2167,214,2381,481761,4.94228465982095
12260,"Augusta-Richmond County, GA-SC",1997,2100,147,2247,485598,4.62728429688755
12260,"Augusta-Richmond County, GA-SC",1998,2571,521,3092,488757,6.32625210482919
12260,"Augusta-Richmond County, GA-SC",1999,2589,768,3357,491622,6.82841695448942
12260,"Augusta-Richmond County, GA-SC",2000,2312,50,2362,508896,4.64141985788845
12260,"Augusta-Richmond County, GA-SC",2001,2662,204,2866,512626,5.59082059825292
12260,"Augusta-Richmond County, GA-SC",2002,2971,611,3582,516818,6.93087315070296
12260,"Augusta-Richmond County, GA-SC",2003,3351,292,3643,520120,7.00415288779512
12260,"Augusta-Richmond County, GA-SC",2004,3729,14,3743,526789,7.10531161432756
12260,"Augusta-Richmond County, GA-SC",2005,3834,107,3941,531294,7.4177385778872
12260,"Augusta-Richmond County, GA-SC",2006,3644,18,3662,538643,6.79856602610634
12260,"Augusta-Richmond County, GA-SC",2007,3060,342,3402,545524,6.23620592311246
12260,"Augusta-Richmond County, GA-SC",2008,1826,108,1934,552627,3.49964804470285
12260,"Augusta-Richmond County, GA-SC",2009,2180,112,2292,558096,4.10682033198589
12260,"Augusta-Richmond County, GA-SC",2010,2420,70,2490,566492,4.39547248681358
12260,"Augusta-Richmond County, GA-SC",2011,2247,168,2415,570596,4.23241663103141
12260,"Augusta-Richmond County, GA-SC",2012,2181,103,2284,576021,3.96513321562929
12260,"Augusta-Richmond County, GA-SC",2013,2410,35,2445,579673,4.21789526163889
12260,"Augusta-Richmond County, GA-SC",2014,2416,431,2847,582953,4.88375563724691
12260,"Augusta-Richmond County, GA-SC",2015,2669,366,3035,589476,5.1486404874838
12260,"Augusta-Richmond County, GA-SC",2016,2560,408,2968,594894,4.98912411286717
12260,"Augusta-Richmond County, GA-SC",2017,2690,648,3338,600006,5.56327770055633
12260,"Augusta-Richmond County, GA-SC",2018,2584,283,2867,604167,4.74537669220596
12300,"Augusta-Waterville, ME",1990,524,14,538,116254,4.62779775319559
12300,"Augusta-Waterville, ME",1991,435,33,468,117003,3.99989743852722
12300,"Augusta-Waterville, ME",1992,416,8,424,116996,3.62405552326575
12300,"Augusta-Waterville, ME",1993,398,14,412,116955,3.52272241460391
12300,"Augusta-Waterville, ME",1994,382,19,401,116944,3.42899165412505
12300,"Augusta-Waterville, ME",1995,329,9,338,116636,2.8979045920642
12300,"Augusta-Waterville, ME",1996,329,6,335,115926,2.88977451132619
12300,"Augusta-Waterville, ME",1997,288,60,348,115623,3.00978179082017
12300,"Augusta-Waterville, ME",1998,329,54,383,115137,3.32647194212113
12300,"Augusta-Waterville, ME",1999,369,19,388,115258,3.36636068645994
12300,"Augusta-Waterville, ME",2000,348,41,389,117177,3.3197641175316
12300,"Augusta-Waterville, ME",2001,381,64,445,118024,3.77041957567952
12300,"Augusta-Waterville, ME",2002,538,78,616,118611,5.19344748800701
12300,"Augusta-Waterville, ME",2003,507,89,596,119538,4.98586223627633
12300,"Augusta-Waterville, ME",2004,584,131,715,120303,5.94332643408726
12300,"Augusta-Waterville, ME",2005,642,164,806,120957,6.66352505435816
12300,"Augusta-Waterville, ME",2006,514,165,679,121508,5.58810942489383
12300,"Augusta-Waterville, ME",2007,383,130,513,121741,4.21386385851932
12300,"Augusta-Waterville, ME",2008,283,180,463,122147,3.79051470768828
12300,"Augusta-Waterville, ME",2009,249,68,317,122084,2.59657285147931
12300,"Augusta-Waterville, ME",2010,232,71,303,122076,2.4820603558439
12300,"Augusta-Waterville, ME",2011,181,79,260,121776,2.13506766522139
12300,"Augusta-Waterville, ME",2012,158,116,274,121583,2.25360453352854
12300,"Augusta-Waterville, ME",2013,160,162,322,121140,2.65808155852732
12300,"Augusta-Waterville, ME",2014,181,163,344,121236,2.83744102411825
12300,"Augusta-Waterville, ME",2015,165,38,203,121005,1.67761662741209
12300,"Augusta-Waterville, ME",2016,212,4,216,121470,1.7782168436651
12300,"Augusta-Waterville, ME",2017,255,28,283,121929,2.32102289037063
12300,"Augusta-Waterville, ME",2018,273,33,306,122083,2.50649148530098
12380,"Austin, MN",1990,48,0,48,37373,1.28434966419608
12380,"Austin, MN",1991,51,0,51,37411,1.36323541204459
12380,"Austin, MN",1992,73,2,75,37293,2.01110127906041
12380,"Austin, MN",1993,70,80,150,37496,4.00042671218263
12380,"Austin, MN",1994,71,35,106,37394,2.83467936032519
12380,"Austin, MN",1995,68,16,84,37238,2.25576024491111
12380,"Austin, MN",1996,53,0,53,37119,1.42784018966028
12380,"Austin, MN",1997,47,39,86,37069,2.31999784186247
12380,"Austin, MN",1998,72,22,94,37130,2.53164556962025
12380,"Austin, MN",1999,85,32,117,37168,3.14786913473956
12380,"Austin, MN",2000,107,13,120,38669,3.10326101011146
12380,"Austin, MN",2001,82,160,242,38755,6.24435556702361
12380,"Austin, MN",2002,131,8,139,38663,3.59516850735846
12380,"Austin, MN",2003,141,4,145,38735,3.7433845359494
12380,"Austin, MN",2004,132,24,156,38900,4.01028277634961
12380,"Austin, MN",2005,101,0,101,38659,2.61258697845262
12380,"Austin, MN",2006,81,62,143,38697,3.69537690260227
12380,"Austin, MN",2007,66,0,66,38672,1.70666115018618
12380,"Austin, MN",2008,40,0,40,38695,1.03372528750485
12380,"Austin, MN",2009,30,0,30,39023,0.768777387694437
12380,"Austin, MN",2010,29,0,29,39206,0.739682701627302
12380,"Austin, MN",2011,36,0,36,39341,0.915075875041305
12380,"Austin, MN",2012,30,0,30,39393,0.761556621734826
12380,"Austin, MN",2013,46,0,46,39325,1.16973935155753
12380,"Austin, MN",2014,32,0,32,39413,0.811914850430061
12380,"Austin, MN",2015,36,2,38,39420,0.963977676306443
12380,"Austin, MN",2016,39,0,39,39469,0.988117256581114
12380,"Austin, MN",2017,37,0,37,39699,0.932013400841331
12380,"Austin, MN",2018,68,0,68,40011,1.69953262852715
12420,"Austin-Round Rock, TX",1990,1916,46,1962,850684,2.30637933709815
12420,"Austin-Round Rock, TX",1991,2994,228,3222,874416,3.68474501838942
12420,"Austin-Round Rock, TX",1992,4641,1030,5671,901181,6.29285348892176
12420,"Austin-Round Rock, TX",1993,6369,2174,8543,932406,9.16231770280329
12420,"Austin-Round Rock, TX",1994,6267,4518,10785,965528,11.1700541051114
12420,"Austin-Round Rock, TX",1995,7435,6330,13765,1001762,13.7407887302573
12420,"Austin-Round Rock, TX",1996,10095,6982,17077,1036707,16.4723494680754
12420,"Austin-Round Rock, TX",1997,8456,5161,13617,1068233,12.7472190055915
12420,"Austin-Round Rock, TX",1998,10805,5618,16423,1105271,14.8587993351857
12420,"Austin-Round Rock, TX",1999,11704,8193,19897,1147860,17.3339954349834
12420,"Austin-Round Rock, TX",2000,13045,8844,21889,1264950,17.3042412743587
12420,"Austin-Round Rock, TX",2001,9174,8699,17873,1321316,13.5266658392088
12420,"Austin-Round Rock, TX",2002,11072,6160,17232,1347822,12.7850710256992
12420,"Austin-Round Rock, TX",2003,12103,3214,15317,1376030,11.1312980094911
12420,"Austin-Round Rock, TX",2004,14309,3706,18015,1410058,12.7760702042044
12420,"Austin-Round Rock, TX",2005,17346,5895,23241,1453358,15.9912423504739
12420,"Austin-Round Rock, TX",2006,17615,8481,26096,1515485,17.219569972649
12420,"Austin-Round Rock, TX",2007,12120,7783,19903,1577856,12.6139520970228
12420,"Austin-Round Rock, TX",2008,7710,4082,11792,1633870,7.21722046429643
12420,"Austin-Round Rock, TX",2009,6678,2080,8758,1682338,5.20585042958074
12420,"Austin-Round Rock, TX",2010,6200,2586,8786,1727528,5.0858799394279
12420,"Austin-Round Rock, TX",2011,6231,4008,10239,1780605,5.75029273758077
12420,"Austin-Round Rock, TX",2012,8229,11334,19563,1834926,10.6614653669957
12420,"Austin-Round Rock, TX",2013,8941,11911,20852,1883901,11.0685221781824
12420,"Austin-Round Rock, TX",2014,11515,8434,19949,1943409,10.2649519478401
12420,"Austin-Round Rock, TX",2015,11857,10513,22370,2002591,11.1705285802243
12420,"Austin-Round Rock, TX",2016,13327,8534,21861,2062211,10.6007581183497
12420,"Austin-Round Rock, TX",2017,16119,10581,26700,2115230,12.6227407894177
12420,"Austin-Round Rock, TX",2018,17030,13005,30035,2168316,13.8517633038727
12460,"Bainbridge, GA",1990,118,0,118,25549,4.61857606951348
12460,"Bainbridge, GA",1991,85,0,85,25785,3.29649020748497
12460,"Bainbridge, GA",1992,123,0,123,25878,4.75307210758173
12460,"Bainbridge, GA",1993,79,13,92,26053,3.53126319425786
12460,"Bainbridge, GA",1994,120,0,120,26181,4.58347656697605
12460,"Bainbridge, GA",1995,101,14,115,26298,4.372956118336
12460,"Bainbridge, GA",1996,121,8,129,26435,4.87989407981842
12460,"Bainbridge, GA",1997,100,36,136,26677,5.09802451550024
12460,"Bainbridge, GA",1998,106,4,110,27011,4.07241494206064
12460,"Bainbridge, GA",1999,85,0,85,27113,3.13502747759377
12460,"Bainbridge, GA",2000,84,10,94,28223,3.33061687276335
12460,"Bainbridge, GA",2001,79,0,79,27870,2.8345891639756
12460,"Bainbridge, GA",2002,78,95,173,27892,6.20249533916535
12460,"Bainbridge, GA",2003,99,2,101,27795,3.63374707681238
12460,"Bainbridge, GA",2004,243,4,247,27763,8.89673306198898
12460,"Bainbridge, GA",2005,294,26,320,27511,11.6317109519828
12460,"Bainbridge, GA",2006,126,6,132,27835,4.74223100413149
12460,"Bainbridge, GA",2007,137,0,137,27883,4.9133880859305
12460,"Bainbridge, GA",2008,89,6,95,28010,3.39164584077115
12460,"Bainbridge, GA",2009,35,0,35,28058,1.24741606671894
12460,"Bainbridge, GA",2010,86,3,89,27814,3.19982742503775
12460,"Bainbridge, GA",2011,27,0,27,27649,0.97652718000651
12460,"Bainbridge, GA",2012,21,0,21,27446,0.765138818042702
12460,"Bainbridge, GA",2013,24,0,24,27398,0.875976348638587
12460,"Bainbridge, GA",2014,32,0,32,27178,1.17742291559349
12460,"Bainbridge, GA",2015,24,0,24,27055,0.887081870264276
12460,"Bainbridge, GA",2016,13,0,13,26683,0.487201589026721
12460,"Bainbridge, GA",2017,33,18,51,26674,1.91197420709305
12460,"Bainbridge, GA",2018,22,5,27,26575,1.01599247412982
12540,"Bakersfield, CA",1990,4557,397,4954,549229,9.01991701093715
12540,"Bakersfield, CA",1991,3109,291,3400,567759,5.98845636969207
12540,"Bakersfield, CA",1992,3851,515,4366,586935,7.43864312061813
12540,"Bakersfield, CA",1993,3082,314,3396,595503,5.70274205167732
12540,"Bakersfield, CA",1994,2739,385,3124,608904,5.13052960729442
12540,"Bakersfield, CA",1995,2830,666,3496,612984,5.70324837189878
12540,"Bakersfield, CA",1996,2390,377,2767,618052,4.47696957537553
12540,"Bakersfield, CA",1997,2397,262,2659,624538,4.25754717887462
12540,"Bakersfield, CA",1998,2841,584,3425,631335,5.42501207758163
12540,"Bakersfield, CA",1999,2887,231,3118,642107,4.85588850456388
12540,"Bakersfield, CA",2000,2862,208,3070,663803,4.62486611238575
12540,"Bakersfield, CA",2001,3408,86,3494,676574,5.16425402099401
12540,"Bakersfield, CA",2002,4496,13,4509,694059,6.49656585391156
12540,"Bakersfield, CA",2003,5546,267,5813,714272,8.13835625644012
12540,"Bakersfield, CA",2004,6174,620,6794,736296,9.22726729467497
12540,"Bakersfield, CA",2005,7666,1191,8857,760726,11.6428254062567
12540,"Bakersfield, CA",2006,5731,1260,6991,784511,8.91128358939518
12540,"Bakersfield, CA",2007,3318,884,4202,803281,5.23104617188755
12540,"Bakersfield, CA",2008,1610,983,2593,818327,3.16865996111579
12540,"Bakersfield, CA",2009,1585,192,1777,830137,2.1406105257325
12540,"Bakersfield, CA",2010,1211,445,1656,841072,1.96891585975993
12540,"Bakersfield, CA",2011,712,257,969,848140,1.14250005895253
12540,"Bakersfield, CA",2012,1428,577,2005,853963,2.34787689864783
12540,"Bakersfield, CA",2013,1795,523,2318,862557,2.68735863253095
12540,"Bakersfield, CA",2014,1885,412,2297,869957,2.64036038562826
12540,"Bakersfield, CA",2015,2098,102,2200,877197,2.50798851341261
12540,"Bakersfield, CA",2016,2141,115,2256,882361,2.55677664810661
12540,"Bakersfield, CA",2017,2378,262,2640,888988,2.96966888191967
12540,"Bakersfield, CA",2018,2073,379,2452,896764,2.73427568457253
12580,"Baltimore-Columbia-Towson, MD",1990,9530,4031,13561,2389188,5.67598698804782
12580,"Baltimore-Columbia-Towson, MD",1991,9423,1759,11182,2411328,4.63727871115004
12580,"Baltimore-Columbia-Towson, MD",1992,13338,2146,15484,2427820,6.37773805306818
12580,"Baltimore-Columbia-Towson, MD",1993,10547,2357,12904,2440422,5.28761009366413
12580,"Baltimore-Columbia-Towson, MD",1994,10776,1820,12596,2452509,5.13596484253473
12580,"Baltimore-Columbia-Towson, MD",1995,9802,1547,11349,2462364,4.60898551148409
12580,"Baltimore-Columbia-Towson, MD",1996,9322,1419,10741,2468410,4.35138408935307
12580,"Baltimore-Columbia-Towson, MD",1997,8581,2057,10638,2475501,4.29731193806829
12580,"Baltimore-Columbia-Towson, MD",1998,8213,2980,11193,2482406,4.50893206026734
12580,"Baltimore-Columbia-Towson, MD",1999,10486,3120,13606,2492673,5.45839747130891
12580,"Baltimore-Columbia-Towson, MD",2000,9700,2104,11804,2557958,4.61461837919153
12580,"Baltimore-Columbia-Towson, MD",2001,8935,1973,10908,2575471,4.23534180738203
12580,"Baltimore-Columbia-Towson, MD",2002,9351,1640,10991,2596501,4.23300433930124
12580,"Baltimore-Columbia-Towson, MD",2003,8314,2819,11133,2614232,4.25861208951616
12580,"Baltimore-Columbia-Towson, MD",2004,7501,2781,10282,2630946,3.90809997620628
12580,"Baltimore-Columbia-Towson, MD",2005,8386,2941,11327,2644231,4.28366508069832
12580,"Baltimore-Columbia-Towson, MD",2006,6339,1794,8133,2658162,3.05963293433583
12580,"Baltimore-Columbia-Towson, MD",2007,4775,1432,6207,2667619,2.32679404367715
12580,"Baltimore-Columbia-Towson, MD",2008,3131,2413,5544,2679819,2.06879643737133
12580,"Baltimore-Columbia-Towson, MD",2009,3099,2016,5115,2696018,1.89724252582883
12580,"Baltimore-Columbia-Towson, MD",2010,3554,2040,5594,2715726,2.05985434465775
12580,"Baltimore-Columbia-Towson, MD",2011,3277,2876,6153,2733547,2.25092160478675
12580,"Baltimore-Columbia-Towson, MD",2012,3895,2061,5956,2754611,2.16219277422475
12580,"Baltimore-Columbia-Towson, MD",2013,4617,3452,8069,2768374,2.91470733361894
12580,"Baltimore-Columbia-Towson, MD",2014,4662,2438,7100,2780300,2.55368125741826
12580,"Baltimore-Columbia-Towson, MD",2015,4587,3677,8264,2790285,2.96170462873864
12580,"Baltimore-Columbia-Towson, MD",2016,4731,3339,8070,2794294,2.88802824613301
12580,"Baltimore-Columbia-Towson, MD",2017,5000,1840,6840,2798587,2.44409053568819
12580,"Baltimore-Columbia-Towson, MD",2018,5361,3926,9287,2802789,3.31348524630288
12620,"Bangor, ME",1990,375,184,559,146985,3.80310916079872
12620,"Bangor, ME",1991,328,45,373,147008,2.53727688289073
12620,"Bangor, ME",1992,384,24,408,145885,2.79672344655037
12620,"Bangor, ME",1993,352,32,384,145957,2.63091184389923
12620,"Bangor, ME",1994,329,42,371,145962,2.54175744371823
12620,"Bangor, ME",1995,323,2,325,144455,2.24983558893773
12620,"Bangor, ME",1996,294,10,304,143852,2.11328309651586
12620,"Bangor, ME",1997,263,9,272,143175,1.89977300506373
12620,"Bangor, ME",1998,309,6,315,142609,2.20883674943377
12620,"Bangor, ME",1999,317,36,353,142699,2.47373842844028
12620,"Bangor, ME",2000,356,126,482,144937,3.32558283944058
12620,"Bangor, ME",2001,381,52,433,146110,2.96352063513791
12620,"Bangor, ME",2002,498,61,559,147298,3.79502776684001
12620,"Bangor, ME",2003,570,68,638,148759,4.28881613885546
12620,"Bangor, ME",2004,658,83,741,148814,4.97937022054377
12620,"Bangor, ME",2005,737,259,996,149726,6.6521512629737
12620,"Bangor, ME",2006,610,99,709,151446,4.68153665332858
12620,"Bangor, ME",2007,433,65,498,152232,3.2713227179568
12620,"Bangor, ME",2008,281,107,388,153372,2.5297968338419
12620,"Bangor, ME",2009,279,87,366,153770,2.38017818820316
12620,"Bangor, ME",2010,249,23,272,153860,1.76784089431951
12620,"Bangor, ME",2011,213,156,369,153749,2.40001560985763
12620,"Bangor, ME",2012,197,116,313,153347,2.0411224216972
12620,"Bangor, ME",2013,240,11,251,153235,1.63800698273893
12620,"Bangor, ME",2014,213,18,231,153224,1.50759672114029
12620,"Bangor, ME",2015,197,358,555,151949,3.65254131320377
12620,"Bangor, ME",2016,194,77,271,151282,1.79135653944289
12620,"Bangor, ME",2017,250,54,304,151190,2.01071499437794
12620,"Bangor, ME",2018,228,33,261,151096,1.72737862021496
12660,"Baraboo, WI",1990,165,109,274,47153,5.81087099442241
12660,"Baraboo, WI",1991,226,137,363,47679,7.613414710879
12660,"Baraboo, WI",1992,334,108,442,48634,9.08829214130033
12660,"Baraboo, WI",1993,552,204,756,49514,15.2684089348467
12660,"Baraboo, WI",1994,542,183,725,50228,14.4341801385681
12660,"Baraboo, WI",1995,431,258,689,51121,13.477827116058
12660,"Baraboo, WI",1996,349,156,505,51987,9.71396695327678
12660,"Baraboo, WI",1997,288,201,489,52895,9.24473012572077
12660,"Baraboo, WI",1998,406,119,525,53291,9.85156968343623
12660,"Baraboo, WI",1999,384,114,498,54145,9.19752516391172
12660,"Baraboo, WI",2000,401,174,575,55348,10.3888126038881
12660,"Baraboo, WI",2001,376,187,563,55660,10.1149838303989
12660,"Baraboo, WI",2002,357,518,875,56316,15.5373250941118
12660,"Baraboo, WI",2003,375,291,666,57096,11.6645649432535
12660,"Baraboo, WI",2004,240,120,360,58020,6.2047569803516
12660,"Baraboo, WI",2005,384,260,644,58856,10.941960038059
12660,"Baraboo, WI",2006,300,187,487,59580,8.17388385364216
12660,"Baraboo, WI",2007,246,80,326,60389,5.39833413369985
12660,"Baraboo, WI",2008,186,73,259,61231,4.22988355571524
12660,"Baraboo, WI",2009,129,14,143,61562,2.32286150547416
12660,"Baraboo, WI",2010,116,3,119,62061,1.91746829732038
12660,"Baraboo, WI",2011,68,50,118,62241,1.89585642904195
12660,"Baraboo, WI",2012,101,6,107,62385,1.71515588683177
12660,"Baraboo, WI",2013,111,0,111,62797,1.76760036307467
12660,"Baraboo, WI",2014,107,6,113,62975,1.79436284239778
12660,"Baraboo, WI",2015,164,4,168,63264,2.65553869499241
12660,"Baraboo, WI",2016,194,31,225,63572,3.53929402881772
12660,"Baraboo, WI",2017,179,24,203,63918,3.17594417847868
12660,"Baraboo, WI",2018,192,18,210,64249,3.26853336238696
12680,"Bardstown, KY",1990,244,24,268,29774,9.00114193591724
12680,"Bardstown, KY",1991,252,16,268,30356,8.82856766372381
12680,"Bardstown, KY",1992,363,44,407,31100,13.0868167202572
12680,"Bardstown, KY",1993,337,58,395,31849,12.4022732267889
12680,"Bardstown, KY",1994,398,46,444,32469,13.6745819088977
12680,"Bardstown, KY",1995,409,48,457,33441,13.6658592745432
12680,"Bardstown, KY",1996,422,48,470,34206,13.7402794831316
12680,"Bardstown, KY",1997,395,68,463,35168,13.1653776160146
12680,"Bardstown, KY",1998,513,12,525,35945,14.6056475170399
12680,"Bardstown, KY",1999,468,18,486,36961,13.148994886502
12680,"Bardstown, KY",2000,439,29,468,37662,12.4263183049227
12680,"Bardstown, KY",2001,436,21,457,38128,11.9859420898028
12680,"Bardstown, KY",2002,423,70,493,38681,12.7452754582353
12680,"Bardstown, KY",2003,478,4,482,39307,12.262446892411
12680,"Bardstown, KY",2004,406,30,436,39947,10.9144616617018
12680,"Bardstown, KY",2005,476,13,489,40582,12.0496771967868
12680,"Bardstown, KY",2006,325,10,335,41424,8.08709926612592
12680,"Bardstown, KY",2007,227,31,258,42020,6.13993336506425
12680,"Bardstown, KY",2008,180,30,210,42588,4.93096646942801
12680,"Bardstown, KY",2009,148,31,179,42974,4.1653092567599
12680,"Bardstown, KY",2010,146,0,146,43631,3.34624464257065
12680,"Bardstown, KY",2011,125,24,149,44066,3.38129169881541
12680,"Bardstown, KY",2012,112,0,112,44414,2.52172738325753
12680,"Bardstown, KY",2013,137,0,137,44552,3.07505835877177
12680,"Bardstown, KY",2014,168,25,193,44866,4.30169839076361
12680,"Bardstown, KY",2015,153,8,161,45115,3.56865787432118
12680,"Bardstown, KY",2016,156,3,159,45495,3.49488954830201
12680,"Bardstown, KY",2017,173,38,211,45612,4.62597562045076
12680,"Bardstown, KY",2018,185,18,203,45851,4.42738435366731
12700,"Barnstable Town, MA",1990,1260,43,1303,187171,6.96154853048816
12700,"Barnstable Town, MA",1991,1003,15,1018,188336,5.40523320023787
12700,"Barnstable Town, MA",1992,1294,9,1303,190085,6.85482810321698
12700,"Barnstable Town, MA",1993,1564,46,1610,192617,8.35855609837138
12700,"Barnstable Town, MA",1994,1567,99,1666,195592,8.51773078653524
12700,"Barnstable Town, MA",1995,1534,100,1634,199170,8.20404679419591
12700,"Barnstable Town, MA",1996,1498,66,1564,202365,7.72860919625429
12700,"Barnstable Town, MA",1997,1793,98,1891,205100,9.2198927352511
12700,"Barnstable Town, MA",1998,1929,191,2120,208387,10.1733793374827
12700,"Barnstable Town, MA",1999,2079,145,2224,211984,10.4913578383274
12700,"Barnstable Town, MA",2000,1782,100,1882,223031,8.43828884773865
12700,"Barnstable Town, MA",2001,1500,119,1619,224087,7.22487248256258
12700,"Barnstable Town, MA",2002,1325,68,1393,225421,6.17954848927119
12700,"Barnstable Town, MA",2003,1095,133,1228,226011,5.43336386282084
12700,"Barnstable Town, MA",2004,1265,210,1475,224264,6.57706988192487
12700,"Barnstable Town, MA",2005,1152,236,1388,221995,6.25239307191603
12700,"Barnstable Town, MA",2006,788,98,886,220037,4.02659552711589
12700,"Barnstable Town, MA",2007,679,139,818,218380,3.74576426412675
12700,"Barnstable Town, MA",2008,447,112,559,217066,2.57525360950126
12700,"Barnstable Town, MA",2009,337,40,377,215994,1.74541885422743
12700,"Barnstable Town, MA",2010,381,37,418,215893,1.93614429370105
12700,"Barnstable Town, MA",2011,342,62,404,215333,1.87616389499055
12700,"Barnstable Town, MA",2012,410,182,592,214783,2.75627028209868
12700,"Barnstable Town, MA",2013,425,171,596,214520,2.77829573000186
12700,"Barnstable Town, MA",2014,530,110,640,214299,2.98648150481337
12700,"Barnstable Town, MA",2015,550,22,572,213811,2.67525992582234
12700,"Barnstable Town, MA",2016,495,10,505,213446,2.36593798899956
12700,"Barnstable Town, MA",2017,489,382,871,213482,4.07996927141398
12700,"Barnstable Town, MA",2018,518,487,1005,213413,4.70917891599856
12740,"Barre, VT",1990,156,20,176,55076,3.19558428353548
12740,"Barre, VT",1991,158,2,160,55069,2.90544589514972
12740,"Barre, VT",1992,188,2,190,55306,3.43543196036596
12740,"Barre, VT",1993,179,17,196,55418,3.53675701035765
12740,"Barre, VT",1994,219,7,226,55849,4.04662572293148
12740,"Barre, VT",1995,203,4,207,56183,3.68438851609918
12740,"Barre, VT",1996,205,0,205,56199,3.64775173935479
12740,"Barre, VT",1997,164,0,164,56253,2.91540006755195
12740,"Barre, VT",1998,182,0,182,56211,3.23780043052072
12740,"Barre, VT",1999,226,0,226,56436,4.00453611170175
12740,"Barre, VT",2000,211,0,211,58072,3.63342058134729
12740,"Barre, VT",2001,250,4,254,58526,4.33995147455832
12740,"Barre, VT",2002,299,12,311,58889,5.28112211109036
12740,"Barre, VT",2003,248,66,314,58958,5.32582516367584
12740,"Barre, VT",2004,259,20,279,59081,4.72233036001422
12740,"Barre, VT",2005,231,24,255,59366,4.29538793248661
12740,"Barre, VT",2006,219,76,295,59414,4.96515972666375
12740,"Barre, VT",2007,180,25,205,59275,3.45845634753269
12740,"Barre, VT",2008,128,14,142,59278,2.39549242552043
12740,"Barre, VT",2009,119,16,135,59353,2.27452698262935
12740,"Barre, VT",2010,100,5,105,59569,1.76266178717118
12740,"Barre, VT",2011,91,20,111,59584,1.86291621911923
12740,"Barre, VT",2012,89,11,100,59405,1.68335998653312
12740,"Barre, VT",2013,113,16,129,59217,2.17842849181823
12740,"Barre, VT",2014,121,6,127,58960,2.15400271370421
12740,"Barre, VT",2015,100,52,152,58645,2.59186631426379
12740,"Barre, VT",2016,118,9,127,58356,2.17629721022688
12740,"Barre, VT",2017,116,13,129,58283,2.21333836624745
12740,"Barre, VT",2018,133,10,143,58140,2.45958032335741
12780,"Bartlesville, OK",1990,84,0,84,48297,1.73923846201627
12780,"Bartlesville, OK",1991,70,0,70,48642,1.43908556391596
12780,"Bartlesville, OK",1992,18,0,18,48295,0.372709390206025
12780,"Bartlesville, OK",1993,38,2,40,47564,0.840972163821378
12780,"Bartlesville, OK",1994,35,35,70,47469,1.47464661147275
12780,"Bartlesville, OK",1995,41,22,63,47456,1.32754551584626
12780,"Bartlesville, OK",1996,32,20,52,47406,1.09690756444332
12780,"Bartlesville, OK",1997,56,0,56,47478,1.17949366022158
12780,"Bartlesville, OK",1998,66,0,66,47497,1.38956144598606
12780,"Bartlesville, OK",1999,46,29,75,47498,1.57901385321487
12780,"Bartlesville, OK",2000,37,0,37,48987,0.755302427174557
12780,"Bartlesville, OK",2001,32,30,62,48897,1.26797145019122
12780,"Bartlesville, OK",2002,66,0,66,49032,1.34605971610377
12780,"Bartlesville, OK",2003,96,0,96,49004,1.95902375316301
12780,"Bartlesville, OK",2004,85,8,93,48997,1.89807539237096
12780,"Bartlesville, OK",2005,190,4,194,48885,3.96849749411885
12780,"Bartlesville, OK",2006,213,4,217,49216,4.40913524057217
12780,"Bartlesville, OK",2007,239,0,239,50038,4.77636995883129
12780,"Bartlesville, OK",2008,141,7,148,50641,2.92253312533323
12780,"Bartlesville, OK",2009,60,0,60,50754,1.18217283366828
12780,"Bartlesville, OK",2010,64,0,64,51065,1.25330461176931
12780,"Bartlesville, OK",2011,112,16,128,51359,2.49226036332483
12780,"Bartlesville, OK",2012,58,2,60,51631,1.16209254130271
12780,"Bartlesville, OK",2013,62,0,62,51653,1.20031750333959
12780,"Bartlesville, OK",2014,85,6,91,52006,1.74979810021921
12780,"Bartlesville, OK",2015,39,8,47,52106,0.902007446359344
12780,"Bartlesville, OK",2016,27,2,29,52036,0.557306480129141
12780,"Bartlesville, OK",2017,34,215,249,52016,4.7869886188865
12780,"Bartlesville, OK",2018,23,0,23,51843,0.443647165480393
12820,"Bastrop, LA",1990,9,0,9,31918,0.281972554671345
12820,"Bastrop, LA",1991,2,0,2,31694,0.0631034265160598
12820,"Bastrop, LA",1992,5,0,5,31896,0.156759468271884
12820,"Bastrop, LA",1993,11,4,15,32024,0.468398700974269
12820,"Bastrop, LA",1994,44,10,54,31922,1.69162333187144
12820,"Bastrop, LA",1995,16,0,16,31955,0.500704115161946
12820,"Bastrop, LA",1996,9,8,17,31835,0.534003455316476
12820,"Bastrop, LA",1997,6,30,36,31701,1.1356108640106
12820,"Bastrop, LA",1998,7,2,9,31455,0.286123032904149
12820,"Bastrop, LA",1999,4,6,10,31253,0.319969282948837
12820,"Bastrop, LA",2000,7,38,45,30961,1.45344142631052
12820,"Bastrop, LA",2001,11,8,19,30605,0.620813592550237
12820,"Bastrop, LA",2002,57,12,69,30319,2.27580065305584
12820,"Bastrop, LA",2003,20,0,20,30224,0.661725780836421
12820,"Bastrop, LA",2004,36,2,38,29891,1.27128567127229
12820,"Bastrop, LA",2005,59,0,59,29355,2.00987906659854
12820,"Bastrop, LA",2006,38,2,40,29079,1.37556312115272
12820,"Bastrop, LA",2007,29,13,42,28478,1.47482267013133
12820,"Bastrop, LA",2008,17,20,37,28311,1.30691250750592
12820,"Bastrop, LA",2009,22,0,22,28147,0.781610828862756
12820,"Bastrop, LA",2010,19,2,21,27872,0.753444316877153
12820,"Bastrop, LA",2011,16,4,20,27478,0.727855011281753
12820,"Bastrop, LA",2012,20,4,24,27378,0.876616261231646
12820,"Bastrop, LA",2013,81,0,81,26940,3.00668151447661
12820,"Bastrop, LA",2014,16,0,16,26655,0.600262614894016
12820,"Bastrop, LA",2015,0,0,0,26309,0
12820,"Bastrop, LA",2016,1,40,41,25910,1.58240061752219
12820,"Bastrop, LA",2017,0,0,0,25687,0
12820,"Bastrop, LA",2018,39,0,39,25398,1.5355539806284
12860,"Batavia, NY",1990,155,4,159,60164,2.64277641114288
12860,"Batavia, NY",1991,150,4,154,60513,2.54490770578223
12860,"Batavia, NY",1992,146,57,203,60826,3.33738861670996
12860,"Batavia, NY",1993,139,4,143,61121,2.33962140671782
12860,"Batavia, NY",1994,133,15,148,61226,2.41727370724855
12860,"Batavia, NY",1995,121,42,163,61037,2.67051132919377
12860,"Batavia, NY",1996,111,10,121,61207,1.97689806721453
12860,"Batavia, NY",1997,102,2,104,61123,1.70148716522422
12860,"Batavia, NY",1998,136,8,144,60774,2.36943429756146
12860,"Batavia, NY",1999,139,38,177,60440,2.92852415618795
12860,"Batavia, NY",2000,104,2,106,60539,1.75093741224665
12860,"Batavia, NY",2001,92,2,94,60321,1.55832960328907
12860,"Batavia, NY",2002,96,4,100,60289,1.65867737066463
12860,"Batavia, NY",2003,116,2,118,60412,1.95325432033371
12860,"Batavia, NY",2004,108,2,110,60224,1.82651434643996
12860,"Batavia, NY",2005,84,8,92,60068,1.53159752280748
12860,"Batavia, NY",2006,71,14,85,59919,1.41858175203191
12860,"Batavia, NY",2007,58,79,137,59930,2.28600033372268
12860,"Batavia, NY",2008,46,0,46,59895,0.768010685366057
12860,"Batavia, NY",2009,35,42,77,59932,1.28478942801842
12860,"Batavia, NY",2010,33,14,47,59940,0.784117450784117
12860,"Batavia, NY",2011,19,0,19,59886,0.317269478676151
12860,"Batavia, NY",2012,23,8,31,59682,0.519419590496297
12860,"Batavia, NY",2013,30,18,48,59124,0.811853054597118
12860,"Batavia, NY",2014,31,10,41,58740,0.69799114742935
12860,"Batavia, NY",2015,27,68,95,58470,1.62476483666838
12860,"Batavia, NY",2016,35,4,39,58022,0.672158836303471
12860,"Batavia, NY",2017,34,2,36,57816,0.62266500622665
12860,"Batavia, NY",2018,31,62,93,57511,1.61708194954009
12900,"Batesville, AR",1990,20,4,24,31159,0.770242947463012
12900,"Batesville, AR",1991,17,9,26,31435,0.82710354700175
12900,"Batesville, AR",1992,21,9,30,31594,0.949547382414382
12900,"Batesville, AR",1993,24,9,33,31973,1.03212085196885
12900,"Batesville, AR",1994,24,15,39,32357,1.20530333467256
12900,"Batesville, AR",1995,22,24,46,32751,1.40453726603768
12900,"Batesville, AR",1996,24,27,51,32866,1.55175561370413
12900,"Batesville, AR",1997,24,25,49,32779,1.49485951371305
12900,"Batesville, AR",1998,25,6,31,33026,0.938654393508145
12900,"Batesville, AR",1999,14,4,18,33270,0.541027953110911
12900,"Batesville, AR",2000,10,24,34,34333,0.990300876707541
12900,"Batesville, AR",2001,13,18,31,34374,0.901844417292139
12900,"Batesville, AR",2002,18,14,32,34512,0.927213722763097
12900,"Batesville, AR",2003,21,0,21,34652,0.60602562622648
12900,"Batesville, AR",2004,24,0,24,34989,0.68592986367144
12900,"Batesville, AR",2005,27,0,27,35155,0.768027307637605
12900,"Batesville, AR",2006,26,0,26,35426,0.733924236436515
12900,"Batesville, AR",2007,20,4,24,35690,0.672457270944242
12900,"Batesville, AR",2008,12,2,14,35859,0.390418026158008
12900,"Batesville, AR",2009,12,6,18,36259,0.496428472930859
12900,"Batesville, AR",2010,11,6,17,36810,0.461831024178212
12900,"Batesville, AR",2011,7,11,18,36881,0.488056180689244
12900,"Batesville, AR",2012,23,16,39,36951,1.05545181456523
12900,"Batesville, AR",2013,19,28,47,36883,1.27429981292194
12900,"Batesville, AR",2014,24,24,48,37079,1.29453329377815
12900,"Batesville, AR",2015,28,10,38,37034,1.02608413889939
12900,"Batesville, AR",2016,32,0,32,37118,0.862115415701277
12900,"Batesville, AR",2017,22,54,76,37409,2.03159667459702
12900,"Batesville, AR",2018,10,22,32,37678,0.849301979935241
12940,"Baton Rouge, LA",1990,1072,53,1125,624731,1.80077505358306
12940,"Baton Rouge, LA",1991,1213,78,1291,632290,2.04178462414398
12940,"Baton Rouge, LA",1992,1704,222,1926,641856,3.00067304816034
12940,"Baton Rouge, LA",1993,2479,240,2719,649469,4.18649696906242
12940,"Baton Rouge, LA",1994,2510,643,3153,654297,4.81891251220776
12940,"Baton Rouge, LA",1995,2797,721,3518,658675,5.34102554370517
12940,"Baton Rouge, LA",1996,3479,1152,4631,663497,6.97968491191369
12940,"Baton Rouge, LA",1997,2994,374,3368,668632,5.03715048038383
12940,"Baton Rouge, LA",1998,3362,828,4190,673254,6.22350554174205
12940,"Baton Rouge, LA",1999,3949,547,4496,678523,6.62615710889682
12940,"Baton Rouge, LA",2000,3051,422,3473,707589,4.90821649290761
12940,"Baton Rouge, LA",2001,3310,500,3810,710731,5.3606779498854
12940,"Baton Rouge, LA",2002,3563,710,4273,715379,5.97305763797931
12940,"Baton Rouge, LA",2003,4172,1179,5351,722274,7.40854578733278
12940,"Baton Rouge, LA",2004,4669,510,5179,729774,7.09671761394624
12940,"Baton Rouge, LA",2005,5426,788,6214,735507,8.44859396307581
12940,"Baton Rouge, LA",2006,6414,2647,9061,771940,11.7379589087235
12940,"Baton Rouge, LA",2007,4360,2007,6367,779796,8.16495596284156
12940,"Baton Rouge, LA",2008,2617,1138,3755,787767,4.76663785103971
12940,"Baton Rouge, LA",2009,2834,87,2921,795897,3.67007288631569
12940,"Baton Rouge, LA",2010,2831,131,2962,804298,3.68271461572701
12940,"Baton Rouge, LA",2011,2629,506,3135,808240,3.87879837671979
12940,"Baton Rouge, LA",2012,3244,143,3387,813112,4.1654778185539
12940,"Baton Rouge, LA",2013,3020,190,3210,818814,3.92030424492009
12940,"Baton Rouge, LA",2014,3294,274,3568,823839,4.3309433032425
12940,"Baton Rouge, LA",2015,3463,106,3569,828211,4.30928833352853
12940,"Baton Rouge, LA",2016,3402,24,3426,833663,4.10957425242574
12940,"Baton Rouge, LA",2017,3586,53,3639,831182,4.37810250943837
12940,"Baton Rouge, LA",2018,3509,413,3922,831310,4.71785495182303
12980,"Battle Creek, MI",1990,182,47,229,136317,1.67990786182208
12980,"Battle Creek, MI",1991,169,91,260,137269,1.89409116406472
12980,"Battle Creek, MI",1992,202,220,422,138119,3.05533634040212
12980,"Battle Creek, MI",1993,285,338,623,138969,4.48301419741093
12980,"Battle Creek, MI",1994,306,102,408,139476,2.92523444893745
12980,"Battle Creek, MI",1995,341,46,387,139324,2.77769802761907
12980,"Battle Creek, MI",1996,489,40,529,138920,3.80794701986755
12980,"Battle Creek, MI",1997,405,60,465,139502,3.33328554429327
12980,"Battle Creek, MI",1998,412,188,600,140847,4.25994163879955
12980,"Battle Creek, MI",1999,407,132,539,141470,3.80999505195448
12980,"Battle Creek, MI",2000,368,115,483,138014,3.49964496355442
12980,"Battle Creek, MI",2001,316,96,412,138158,2.98209296602441
12980,"Battle Creek, MI",2002,356,106,462,138580,3.33381440323279
12980,"Battle Creek, MI",2003,388,6,394,138962,2.83530749413509
12980,"Battle Creek, MI",2004,354,16,370,139443,2.65341393974599
12980,"Battle Creek, MI",2005,330,76,406,138946,2.9219984742274
12980,"Battle Creek, MI",2006,198,12,210,138291,1.51853699806929
12980,"Battle Creek, MI",2007,136,104,240,137582,1.74441424023491
12980,"Battle Creek, MI",2008,45,0,45,137313,0.327718424329816
12980,"Battle Creek, MI",2009,36,0,36,136301,0.264121319726194
12980,"Battle Creek, MI",2010,33,0,33,135952,0.242732729198541
12980,"Battle Creek, MI",2011,33,16,49,135096,0.362705039379404
12980,"Battle Creek, MI",2012,36,101,137,134733,1.01682587042521
12980,"Battle Creek, MI",2013,47,0,47,134755,0.348781121294201
12980,"Battle Creek, MI",2014,34,22,56,134812,0.415393288431297
12980,"Battle Creek, MI",2015,59,0,59,134339,0.439187428818139
12980,"Battle Creek, MI",2016,44,0,44,134370,0.327454044801667
12980,"Battle Creek, MI",2017,78,6,84,134358,0.625195373554236
12980,"Battle Creek, MI",2018,54,0,54,134487,0.401525798032524
13020,"Bay City, MI",1990,164,14,178,111782,1.59238517829346
13020,"Bay City, MI",1991,235,22,257,111694,2.3009293247623
13020,"Bay City, MI",1992,224,18,242,111984,2.16102300328618
13020,"Bay City, MI",1993,241,38,279,112112,2.4885828457257
13020,"Bay City, MI",1994,261,109,370,111655,3.3137790515427
13020,"Bay City, MI",1995,282,58,340,111225,3.05686671162059
13020,"Bay City, MI",1996,271,14,285,110693,2.57468855302503
13020,"Bay City, MI",1997,263,139,402,110420,3.6406448107227
13020,"Bay City, MI",1998,308,114,422,110003,3.83625901111788
13020,"Bay City, MI",1999,258,193,451,109515,4.11815733004611
13020,"Bay City, MI",2000,248,26,274,110192,2.48656889792362
13020,"Bay City, MI",2001,329,36,365,109836,3.32313631232019
13020,"Bay City, MI",2002,353,8,361,109861,3.28597045357315
13020,"Bay City, MI",2003,393,45,438,109559,3.99784590950994
13020,"Bay City, MI",2004,327,78,405,109453,3.70021835856486
13020,"Bay City, MI",2005,300,0,300,109165,2.74813355929098
13020,"Bay City, MI",2006,213,0,213,108711,1.95932334354389
13020,"Bay City, MI",2007,118,81,199,108132,1.84034328413421
13020,"Bay City, MI",2008,105,0,105,108320,0.969350073855244
13020,"Bay City, MI",2009,68,0,68,107913,0.630137240184222
13020,"Bay City, MI",2010,54,0,54,107681,0.501481226957402
13020,"Bay City, MI",2011,67,24,91,107409,0.847228816952024
13020,"Bay City, MI",2012,47,48,95,106966,0.888132677673279
13020,"Bay City, MI",2013,42,19,61,106801,0.571155700789318
13020,"Bay City, MI",2014,37,25,62,106066,0.584541700450663
13020,"Bay City, MI",2015,49,98,147,105281,1.39626333336499
13020,"Bay City, MI",2016,63,8,71,104469,0.679627449291177
13020,"Bay City, MI",2017,62,8,70,104189,0.671855954083445
13020,"Bay City, MI",2018,85,0,85,103923,0.817913262704117
13060,"Bay City, TX",1990,13,0,13,36802,0.35324167164828
13060,"Bay City, TX",1991,50,0,50,37646,1.32816235456622
13060,"Bay City, TX",1992,65,0,65,37822,1.71857648987362
13060,"Bay City, TX",1993,43,0,43,38390,1.12008335504038
13060,"Bay City, TX",1994,63,60,123,38524,3.19281486865331
13060,"Bay City, TX",1995,64,0,64,38196,1.67556812231647
13060,"Bay City, TX",1996,68,0,68,37864,1.79590111979717
13060,"Bay City, TX",1997,77,0,77,37857,2.03396993950921
13060,"Bay City, TX",1998,106,6,112,37944,2.9517183217373
13060,"Bay City, TX",1999,82,0,82,37829,2.16764915805335
13060,"Bay City, TX",2000,90,28,118,37873,3.11567607530431
13060,"Bay City, TX",2001,92,0,92,37804,2.43360490953338
13060,"Bay City, TX",2002,101,0,101,37662,2.68174818119059
13060,"Bay City, TX",2003,115,0,115,37695,3.05080249369943
13060,"Bay City, TX",2004,137,64,201,37388,5.37605648871296
13060,"Bay City, TX",2005,97,0,97,37132,2.61230205752451
13060,"Bay City, TX",2006,107,0,107,36743,2.91211931524372
13060,"Bay City, TX",2007,120,0,120,36452,3.29200043893339
13060,"Bay City, TX",2008,97,0,97,36708,2.6424757546039
13060,"Bay City, TX",2009,79,0,79,36579,2.15970912272069
13060,"Bay City, TX",2010,68,0,68,36708,1.8524572300316
13060,"Bay City, TX",2011,63,0,63,36684,1.71736997055937
13060,"Bay City, TX",2012,71,0,71,36553,1.9423850299565
13060,"Bay City, TX",2013,110,0,110,36518,3.01221315515636
13060,"Bay City, TX",2014,222,0,222,36501,6.08202514999589
13060,"Bay City, TX",2015,85,0,85,36775,2.31135282121006
13060,"Bay City, TX",2016,82,0,82,37076,2.21167331966771
13060,"Bay City, TX",2017,141,12,153,36811,4.15636630355057
13060,"Bay City, TX",2018,168,0,168,36552,4.59619172685489
13100,"Beatrice, NE",1990,29,6,35,22808,1.53454928095405
13100,"Beatrice, NE",1991,30,4,34,22720,1.49647887323944
13100,"Beatrice, NE",1992,30,29,59,22746,2.59386265717049
13100,"Beatrice, NE",1993,54,11,65,22816,2.84887798036466
13100,"Beatrice, NE",1994,30,13,43,22801,1.8858821981492
13100,"Beatrice, NE",1995,30,14,44,22768,1.93253689388616
13100,"Beatrice, NE",1996,19,16,35,22781,1.53636802598657
13100,"Beatrice, NE",1997,29,28,57,22837,2.49594955554582
13100,"Beatrice, NE",1998,28,54,82,22789,3.59822721488437
13100,"Beatrice, NE",1999,38,19,57,22738,2.50681678247867
13100,"Beatrice, NE",2000,27,121,148,22955,6.44739708124592
13100,"Beatrice, NE",2001,47,81,128,23039,5.55579669256478
13100,"Beatrice, NE",2002,29,21,50,23031,2.17098693065868
13100,"Beatrice, NE",2003,18,23,41,23056,1.77827897293546
13100,"Beatrice, NE",2004,23,21,44,23052,1.90872809300711
13100,"Beatrice, NE",2005,35,7,42,22866,1.83678824455523
13100,"Beatrice, NE",2006,30,2,32,22875,1.39890710382514
13100,"Beatrice, NE",2007,21,4,25,22843,1.09442717681565
13100,"Beatrice, NE",2008,24,12,36,22574,1.59475502790821
13100,"Beatrice, NE",2009,6,2,8,22364,0.357717760686818
13100,"Beatrice, NE",2010,7,10,17,22269,0.763393057613723
13100,"Beatrice, NE",2011,6,2,8,21906,0.365196749748927
13100,"Beatrice, NE",2012,12,0,12,21651,0.554246917001524
13100,"Beatrice, NE",2013,14,0,14,21766,0.643204998621704
13100,"Beatrice, NE",2014,9,2,11,21555,0.510322430990489
13100,"Beatrice, NE",2015,15,0,15,21706,0.691053165023496
13100,"Beatrice, NE",2016,15,2,17,21608,0.786745649759348
13100,"Beatrice, NE",2017,47,37,84,21615,3.88619014573213
13100,"Beatrice, NE",2018,43,15,58,21493,2.69855301726143
13140,"Beaumont-Port Arthur, TX",1990,493,2,495,374810,1.32066913903044
13140,"Beaumont-Port Arthur, TX",1991,713,6,719,378830,1.89794894807697
13140,"Beaumont-Port Arthur, TX",1992,893,9,902,382549,2.35786788097734
13140,"Beaumont-Port Arthur, TX",1993,1212,76,1288,386660,3.33109191537785
13140,"Beaumont-Port Arthur, TX",1994,692,142,834,387565,2.15189710113142
13140,"Beaumont-Port Arthur, TX",1995,531,61,592,390385,1.51645170792935
13140,"Beaumont-Port Arthur, TX",1996,640,40,680,388888,1.74857542531526
13140,"Beaumont-Port Arthur, TX",1997,603,12,615,389397,1.57936501822048
13140,"Beaumont-Port Arthur, TX",1998,857,323,1180,389479,3.02968837857754
13140,"Beaumont-Port Arthur, TX",1999,832,59,891,390826,2.27978691284613
13140,"Beaumont-Port Arthur, TX",2000,791,19,810,399797,2.02602820931623
13140,"Beaumont-Port Arthur, TX",2001,810,295,1105,397731,2.77825967802359
13140,"Beaumont-Port Arthur, TX",2002,867,94,961,397949,2.4148823090396
13140,"Beaumont-Port Arthur, TX",2003,955,429,1384,398146,3.47611177809145
13140,"Beaumont-Port Arthur, TX",2004,1077,48,1125,398998,2.81956300532835
13140,"Beaumont-Port Arthur, TX",2005,808,392,1200,400115,2.99913774789748
13140,"Beaumont-Port Arthur, TX",2006,945,1048,1993,393468,5.06521496030173
13140,"Beaumont-Port Arthur, TX",2007,1081,1207,2288,396665,5.76809146256917
13140,"Beaumont-Port Arthur, TX",2008,946,1302,2248,399641,5.62504848101171
13140,"Beaumont-Port Arthur, TX",2009,1650,479,2129,401592,5.30140042630331
13140,"Beaumont-Port Arthur, TX",2010,1256,168,1424,403707,3.52731064856443
13140,"Beaumont-Port Arthur, TX",2011,855,324,1179,405409,2.90817421418863
13140,"Beaumont-Port Arthur, TX",2012,817,456,1273,404035,3.15071714084176
13140,"Beaumont-Port Arthur, TX",2013,600,4,604,405564,1.48928405874289
13140,"Beaumont-Port Arthur, TX",2014,1068,538,1606,405964,3.95601580435704
13140,"Beaumont-Port Arthur, TX",2015,953,179,1132,394939,2.8662654232679
13140,"Beaumont-Port Arthur, TX",2016,882,212,1094,397104,2.75494580764737
13140,"Beaumont-Port Arthur, TX",2017,1140,162,1302,398686,3.26572791620473
13140,"Beaumont-Port Arthur, TX",2018,1200,204,1404,395780,3.54742533730861
13180,"Beaver Dam, WI",1990,154,214,368,76705,4.7976011994003
13180,"Beaver Dam, WI",1991,190,216,406,77480,5.24006195147135
13180,"Beaver Dam, WI",1992,266,60,326,78108,4.17370819890408
13180,"Beaver Dam, WI",1993,259,68,327,78809,4.14927229123577
13180,"Beaver Dam, WI",1994,404,164,568,79060,7.18441689855806
13180,"Beaver Dam, WI",1995,338,264,602,79607,7.56214905724371
13180,"Beaver Dam, WI",1996,353,344,697,81284,8.57487328379509
13180,"Beaver Dam, WI",1997,339,181,520,82714,6.28672292477694
13180,"Beaver Dam, WI",1998,350,174,524,83505,6.27507334890126
13180,"Beaver Dam, WI",1999,294,63,357,84364,4.23166279455692
13180,"Beaver Dam, WI",2000,320,64,384,85971,4.46662246571518
13180,"Beaver Dam, WI",2001,308,40,348,86385,4.02847716617468
13180,"Beaver Dam, WI",2002,331,105,436,86908,5.01679937405072
13180,"Beaver Dam, WI",2003,344,102,446,87415,5.10209918206257
13180,"Beaver Dam, WI",2004,411,231,642,88070,7.28965595548995
13180,"Beaver Dam, WI",2005,304,58,362,88168,4.10579802195808
13180,"Beaver Dam, WI",2006,260,62,322,89003,3.61785557790187
13180,"Beaver Dam, WI",2007,199,152,351,89007,3.94351006100644
13180,"Beaver Dam, WI",2008,140,18,158,89239,1.77052633938076
13180,"Beaver Dam, WI",2009,89,2,91,88677,1.02619619518026
13180,"Beaver Dam, WI",2010,80,64,144,88738,1.6227546259776
13180,"Beaver Dam, WI",2011,79,34,113,88389,1.2784396248402
13180,"Beaver Dam, WI",2012,85,74,159,88181,1.80310951338724
13180,"Beaver Dam, WI",2013,87,216,303,87941,3.44549186386327
13180,"Beaver Dam, WI",2014,91,38,129,88090,1.46441139743444
13180,"Beaver Dam, WI",2015,101,36,137,87827,1.55988477347513
13180,"Beaver Dam, WI",2016,91,22,113,87364,1.29343894510325
13180,"Beaver Dam, WI",2017,190,36,226,87750,2.57549857549858
13180,"Beaver Dam, WI",2018,122,102,224,87847,2.54988787323415
13220,"Beckley, WV",1990,90,82,172,124663,1.37971972437692
13220,"Beckley, WV",1991,121,40,161,124847,1.28957844401547
13220,"Beckley, WV",1992,151,75,226,125019,1.80772522576568
13220,"Beckley, WV",1993,208,40,248,126050,1.96747322491075
13220,"Beckley, WV",1994,246,27,273,126192,2.1633701027006502
13220,"Beckley, WV",1995,332,43,375,127093,2.95059523341175
13220,"Beckley, WV",1996,268,55,323,127854,2.52631908270371
13220,"Beckley, WV",1997,213,42,255,127613,1.99822902055433
13220,"Beckley, WV",1998,202,0,202,127140,1.58879974830895
13220,"Beckley, WV",1999,193,17,210,126594,1.65884639082421
13220,"Beckley, WV",2000,170,8,178,126525,1.40683659355859
13220,"Beckley, WV",2001,236,4,240,125318,1.9151279145853
13220,"Beckley, WV",2002,338,34,372,125672,2.96008657457508
13220,"Beckley, WV",2003,306,53,359,125519,2.86012476198822
13220,"Beckley, WV",2004,388,8,396,125145,3.16432937792161
13220,"Beckley, WV",2005,410,100,510,124570,4.09408364774825
13220,"Beckley, WV",2006,282,37,319,124378,2.56476225699079
13220,"Beckley, WV",2007,304,0,304,124566,2.44047332337877
13220,"Beckley, WV",2008,256,0,256,124550,2.05539943797672
13220,"Beckley, WV",2009,258,14,272,124816,2.17920779387258
13220,"Beckley, WV",2010,141,8,149,124949,1.19248653450608
13220,"Beckley, WV",2011,153,3,156,125253,1.2454791502
13220,"Beckley, WV",2012,128,0,128,125110,1.02309967228839
13220,"Beckley, WV",2013,142,0,142,124360,1.14184625281441
13220,"Beckley, WV",2014,120,5,125,123346,1.01340943362574
13220,"Beckley, WV",2015,100,0,100,122077,0.819155123405719
13220,"Beckley, WV",2016,72,0,72,120457,0.597723669027122
13220,"Beckley, WV",2017,83,0,83,118639,0.699601311541736
13220,"Beckley, WV",2018,86,0,86,117272,0.733337881165155
13260,"Bedford, IN",1990,23,24,47,42931,1.09477999580723
13260,"Bedford, IN",1991,22,20,42,43043,0.975768417628883
13260,"Bedford, IN",1992,37,18,55,43332,1.26926982368688
13260,"Bedford, IN",1993,38,25,63,43868,1.43612656150269
13260,"Bedford, IN",1994,63,46,109,44390,2.45550799729669
13260,"Bedford, IN",1995,37,40,77,44970,1.71225261285301
13260,"Bedford, IN",1996,34,24,58,45262,1.2814281295568
13260,"Bedford, IN",1997,43,41,84,45471,1.84733126608168
13260,"Bedford, IN",1998,24,19,43,45711,0.940692612281508
13260,"Bedford, IN",1999,32,70,102,45709,2.23150801811459
13260,"Bedford, IN",2000,41,0,41,45915,0.892954372209518
13260,"Bedford, IN",2001,34,2,36,45965,0.783204612204939
13260,"Bedford, IN",2002,30,5,35,46039,0.760225026607876
13260,"Bedford, IN",2003,21,22,43,46178,0.931179349473775
13260,"Bedford, IN",2004,26,10,36,46106,0.780809439118553
13260,"Bedford, IN",2005,32,4,36,46233,0.778664590227759
13260,"Bedford, IN",2006,21,0,21,46165,0.45489006823351
13260,"Bedford, IN",2007,14,4,18,46300,0.388768898488121
13260,"Bedford, IN",2008,14,0,14,46233,0.302814007310795
13260,"Bedford, IN",2009,9,0,9,46138,0.195066972994061
13260,"Bedford, IN",2010,8,0,8,46102,0.173528263415904
13260,"Bedford, IN",2011,8,4,12,46135,0.260106210035765
13260,"Bedford, IN",2012,7,4,11,46112,0.238549618320611
13260,"Bedford, IN",2013,7,20,27,45893,0.588325016887107
13260,"Bedford, IN",2014,8,34,42,45648,0.920084121976866
13260,"Bedford, IN",2015,8,0,8,45567,0.175565650580464
13260,"Bedford, IN",2016,14,4,18,45588,0.394840747565149
13260,"Bedford, IN",2017,10,6,16,45625,0.350684931506849
13260,"Bedford, IN",2018,17,2,19,45668,0.41604624682491
13300,"Beeville, TX",1990,0,0,0,24964,0
13300,"Beeville, TX",1991,1,0,1,25192,0.0396951413147031
13300,"Beeville, TX",1992,0,0,0,24586,0
13300,"Beeville, TX",1993,0,0,0,25601,0
13300,"Beeville, TX",1994,5,0,5,26116,0.191453515086537
13300,"Beeville, TX",1995,16,200,216,27611,7.82296910651552
13300,"Beeville, TX",1996,21,144,165,27709,5.95474394601032
13300,"Beeville, TX",1997,16,0,16,27923,0.573004333345271
13300,"Beeville, TX",1998,8,0,8,27727,0.288527428138637
13300,"Beeville, TX",1999,1,0,1,27664,0.0361480624638519
13300,"Beeville, TX",2000,4,0,4,32200,0.124223602484472
13300,"Beeville, TX",2001,5,16,21,31695,0.662565073355419
13300,"Beeville, TX",2002,9,0,9,31804,0.282983272544334
13300,"Beeville, TX",2003,4,0,4,32620,0.122624156958921
13300,"Beeville, TX",2004,16,0,16,32352,0.494559841740851
13300,"Beeville, TX",2005,11,0,11,32101,0.342668452696178
13300,"Beeville, TX",2006,16,2,18,31977,0.562904587672389
13300,"Beeville, TX",2007,4,0,4,31936,0.125250501002004
13300,"Beeville, TX",2008,6,0,6,31814,0.188596215502609
13300,"Beeville, TX",2009,4,0,4,31864,0.125533517449159
13300,"Beeville, TX",2010,9,0,9,31863,0.282459278787308
13300,"Beeville, TX",2011,9,0,9,32311,0.278542911082913
13300,"Beeville, TX",2012,9,0,9,32483,0.277068004802512
13300,"Beeville, TX",2013,2,0,2,32812,0.0609533097647202
13300,"Beeville, TX",2014,11,0,11,32846,0.334896182183523
13300,"Beeville, TX",2015,7,0,7,32612,0.214644915981847
13300,"Beeville, TX",2016,7,0,7,32809,0.213356091316407
13300,"Beeville, TX",2017,8,0,8,32599,0.245406300806773
13300,"Beeville, TX",2018,5,4,9,32587,0.276183754257833
13340,"Bellefontaine, OH",1990,165,64,229,42435,5.39648874749617
13340,"Bellefontaine, OH",1991,122,16,138,43112,3.20096492855817
13340,"Bellefontaine, OH",1992,127,4,131,43698,2.99784887180191
13340,"Bellefontaine, OH",1993,186,2,188,44301,4.24369653055236
13340,"Bellefontaine, OH",1994,215,0,215,44526,4.82863944661546
13340,"Bellefontaine, OH",1995,203,100,303,45089,6.72004258244805
13340,"Bellefontaine, OH",1996,186,73,259,45392,5.70585125132182
13340,"Bellefontaine, OH",1997,181,59,240,45848,5.23468853603211
13340,"Bellefontaine, OH",1998,212,4,216,46327,4.66250782481059
13340,"Bellefontaine, OH",1999,205,32,237,46775,5.06680919294495
13340,"Bellefontaine, OH",2000,246,14,260,45984,5.65414057063326
13340,"Bellefontaine, OH",2001,250,0,250,45865,5.45077946146299
13340,"Bellefontaine, OH",2002,213,0,213,46089,4.62149319794311
13340,"Bellefontaine, OH",2003,191,0,191,46257,4.12910478414078
13340,"Bellefontaine, OH",2004,208,77,285,46247,6.16256189590676
13340,"Bellefontaine, OH",2005,173,18,191,46066,4.14622498154821
13340,"Bellefontaine, OH",2006,156,61,217,45902,4.72746285564899
13340,"Bellefontaine, OH",2007,100,53,153,46154,3.31498895003683
13340,"Bellefontaine, OH",2008,67,11,78,46115,1.69142361487585
13340,"Bellefontaine, OH",2009,59,4,63,46055,1.36792964933232
13340,"Bellefontaine, OH",2010,57,8,65,45746,1.42088925807721
13340,"Bellefontaine, OH",2011,50,11,61,45622,1.33707421857876
13340,"Bellefontaine, OH",2012,54,5,59,45409,1.29930190050431
13340,"Bellefontaine, OH",2013,55,15,70,45395,1.5420200462606
13340,"Bellefontaine, OH",2014,56,0,56,45475,1.23144584936778
13340,"Bellefontaine, OH",2015,82,0,82,45266,1.81151416073874
13340,"Bellefontaine, OH",2016,91,0,91,45156,2.01523607051112
13340,"Bellefontaine, OH",2017,65,0,65,45282,1.43544896426836
13340,"Bellefontaine, OH",2018,55,0,55,45358,1.21257551038406
13380,"Bellingham, WA",1990,1109,865,1974,129017,15.3003092615702
13380,"Bellingham, WA",1991,929,610,1539,133337,11.5421825899788
13380,"Bellingham, WA",1992,1049,535,1584,138048,11.4742698191933
13380,"Bellingham, WA",1993,1099,560,1659,142315,11.6572392228507
13380,"Bellingham, WA",1994,1188,1032,2220,145779,15.2285308583541
13380,"Bellingham, WA",1995,854,494,1348,149075,9.04242830789871
13380,"Bellingham, WA",1996,949,339,1288,152341,8.4547167210403
13380,"Bellingham, WA",1997,907,613,1520,154839,9.81664826045118
13380,"Bellingham, WA",1998,921,136,1057,157181,6.72473136066064
13380,"Bellingham, WA",1999,936,550,1486,160212,9.27521034629116
13380,"Bellingham, WA",2000,1069,556,1625,167696,9.69015361129663
13380,"Bellingham, WA",2001,981,463,1444,171172,8.43595915219779
13380,"Bellingham, WA",2002,1107,430,1537,174904,8.7876778118282
13380,"Bellingham, WA",2003,1493,827,2320,177851,13.0446272441538
13380,"Bellingham, WA",2004,1647,841,2488,181756,13.6886815290829
13380,"Bellingham, WA",2005,1698,858,2556,185450,13.7826907522243
13380,"Bellingham, WA",2006,1181,301,1482,188926,7.84434117061707
13380,"Bellingham, WA",2007,858,374,1232,192837,6.38881542442581
13380,"Bellingham, WA",2008,536,133,669,196708,3.400980132989
13380,"Bellingham, WA",2009,426,34,460,199865,2.30155354864534
13380,"Bellingham, WA",2010,401,57,458,201547,2.27242280956799
13380,"Bellingham, WA",2011,419,186,605,203480,2.97326518576764
13380,"Bellingham, WA",2012,488,149,637,204880,3.10913705583756
13380,"Bellingham, WA",2013,568,431,999,206107,4.84699694818711
13380,"Bellingham, WA",2014,542,465,1007,208215,4.83634704512163
13380,"Bellingham, WA",2015,599,545,1144,211940,5.39775408134378
13380,"Bellingham, WA",2016,718,465,1183,216569,5.46246230993355
13380,"Bellingham, WA",2017,793,463,1256,221650,5.66659147304309
13380,"Bellingham, WA",2018,767,697,1464,225685,6.4869176063983
13420,"Bemidji, MN",1990,20,48,68,34504,1.97078599582657
13420,"Bemidji, MN",1991,22,0,22,35223,0.62459188598359
13420,"Bemidji, MN",1992,35,2,37,35815,1.03308669551864
13420,"Bemidji, MN",1993,39,28,67,36334,1.8440028623328
13420,"Bemidji, MN",1994,75,4,79,37356,2.1147874504765
13420,"Bemidji, MN",1995,72,8,80,37790,2.1169621593014
13420,"Bemidji, MN",1996,50,56,106,38159,2.7778505726041
13420,"Bemidji, MN",1997,45,110,155,38696,4.00558197229688
13420,"Bemidji, MN",1998,66,8,74,38695,1.91239178188396
13420,"Bemidji, MN",1999,57,63,120,39266,3.05607905057811
13420,"Bemidji, MN",2000,77,8,85,39789,2.13626881801503
13420,"Bemidji, MN",2001,75,47,122,40406,3.01935356135227
13420,"Bemidji, MN",2002,53,50,103,41049,2.50919632634169
13420,"Bemidji, MN",2003,122,20,142,41659,3.40862718740248
13420,"Bemidji, MN",2004,220,34,254,42100,6.0332541567696
13420,"Bemidji, MN",2005,168,16,184,42700,4.30913348946136
13420,"Bemidji, MN",2006,132,25,157,43066,3.64556726884317
13420,"Bemidji, MN",2007,113,66,179,43281,4.13576396109147
13420,"Bemidji, MN",2008,52,18,70,43815,1.59762638365856
13420,"Bemidji, MN",2009,76,32,108,44226,2.44200244200244
13420,"Bemidji, MN",2010,43,22,65,44572,1.45831463699183
13420,"Bemidji, MN",2011,34,48,82,45045,1.82040182040182
13420,"Bemidji, MN",2012,62,65,127,45140,2.81346920691183
13420,"Bemidji, MN",2013,83,62,145,45484,3.18793421862633
13420,"Bemidji, MN",2014,102,97,199,45635,4.36068806836858
13420,"Bemidji, MN",2015,100,93,193,45604,4.23208490483291
13420,"Bemidji, MN",2016,89,312,401,46016,8.71436022253129
13420,"Bemidji, MN",2017,83,121,204,46484,4.38860683245848
13420,"Bemidji, MN",2018,61,80,141,46847,3.00979785258394
13460,"Bend-Redmond, OR",1990,1352,368,1720,76029,22.6229465072538
13460,"Bend-Redmond, OR",1991,1057,350,1407,80328,17.5156856886764
13460,"Bend-Redmond, OR",1992,1250,178,1428,83958,17.0085042521261
13460,"Bend-Redmond, OR",1993,1373,460,1833,87698,20.9012748295286
13460,"Bend-Redmond, OR",1994,1353,410,1763,90902,19.3945127719962
13460,"Bend-Redmond, OR",1995,1160,228,1388,94858,14.632397900019
13460,"Bend-Redmond, OR",1996,1375,162,1537,98580,15.5913978494624
13460,"Bend-Redmond, OR",1997,1483,313,1796,101647,17.6689917065924
13460,"Bend-Redmond, OR",1998,1657,355,2012,105717,19.0319437744166
13460,"Bend-Redmond, OR",1999,1845,210,2055,110640,18.5737527114967
13460,"Bend-Redmond, OR",2000,1897,202,2099,116566,18.0069660106721
13460,"Bend-Redmond, OR",2001,2063,265,2328,120526,19.315334450658
13460,"Bend-Redmond, OR",2002,2206,327,2533,125247,20.2240373022907
13460,"Bend-Redmond, OR",2003,2317,828,3145,129094,24.3620927386246
13460,"Bend-Redmond, OR",2004,3196,696,3892,133756,29.0977601004815
13460,"Bend-Redmond, OR",2005,3893,567,4460,140567,31.7286418576195
13460,"Bend-Redmond, OR",2006,3073,211,3284,148149,22.1668725404829
13460,"Bend-Redmond, OR",2007,1574,211,1785,152633,11.6947187043431
13460,"Bend-Redmond, OR",2008,668,87,755,156820,4.81443693406453
13460,"Bend-Redmond, OR",2009,348,28,376,157345,2.38965330960628
13460,"Bend-Redmond, OR",2010,365,12,377,157743,2.38996342151474
13460,"Bend-Redmond, OR",2011,457,2,459,159639,2.87523725405446
13460,"Bend-Redmond, OR",2012,741,60,801,161345,4.96451702872726
13460,"Bend-Redmond, OR",2013,1204,113,1317,165294,7.96762132926785
13460,"Bend-Redmond, OR",2014,1274,56,1330,169506,7.84632992342454
13460,"Bend-Redmond, OR",2015,1550,677,2227,174244,12.7809278942173
13460,"Bend-Redmond, OR",2016,1817,457,2274,180649,12.587946791845
13460,"Bend-Redmond, OR",2017,1777,278,2055,186807,11.0006584335705
13460,"Bend-Redmond, OR",2018,1818,165,1983,191996,10.3283401737536
13500,"Bennettsville, SC",1990,38,0,38,29752,1.27722506050013
13500,"Bennettsville, SC",1991,56,0,56,30135,1.85830429732869
13500,"Bennettsville, SC",1992,67,32,99,30186,3.27966607036374
13500,"Bennettsville, SC",1993,51,56,107,30180,3.5453943008615
13500,"Bennettsville, SC",1994,61,0,61,30089,2.02731895377048
13500,"Bennettsville, SC",1995,51,0,51,30068,1.69615538113609
13500,"Bennettsville, SC",1996,56,0,56,29872,1.87466523835029
13500,"Bennettsville, SC",1997,58,0,58,29673,1.95463889731406
13500,"Bennettsville, SC",1998,28,2,30,29622,1.01276078590237
13500,"Bennettsville, SC",1999,36,0,36,29560,1.21786197564276
13500,"Bennettsville, SC",2000,21,0,21,28800,0.729166666666667
13500,"Bennettsville, SC",2001,25,0,25,28606,0.873942529539257
13500,"Bennettsville, SC",2002,38,4,42,28599,1.46858281758103
13500,"Bennettsville, SC",2003,19,0,19,28485,0.667017728629103
13500,"Bennettsville, SC",2004,24,0,24,28351,0.846530986561321
13500,"Bennettsville, SC",2005,24,0,24,27918,0.859660434128519
13500,"Bennettsville, SC",2006,23,0,23,29199,0.787698208842769
13500,"Bennettsville, SC",2007,24,30,54,29221,1.84798603743883
13500,"Bennettsville, SC",2008,16,2,18,29079,0.619003404518725
13500,"Bennettsville, SC",2009,6,40,46,29189,1.57593614032684
13500,"Bennettsville, SC",2010,6,0,6,28917,0.207490403568835
13500,"Bennettsville, SC",2011,11,0,11,28549,0.38530246243301
13500,"Bennettsville, SC",2012,9,0,9,28231,0.318798483936099
13500,"Bennettsville, SC",2013,10,0,10,28054,0.356455407428531
13500,"Bennettsville, SC",2014,9,0,9,28018,0.321222071525448
13500,"Bennettsville, SC",2015,11,0,11,27574,0.398926524987307
13500,"Bennettsville, SC",2016,15,0,15,26962,0.55633855055263
13500,"Bennettsville, SC",2017,15,0,15,26702,0.561755673732305
13500,"Bennettsville, SC",2018,13,0,13,26398,0.492461550117433
13540,"Bennington, VT",1990,163,10,173,35830,4.82835612615127
13540,"Bennington, VT",1991,156,3,159,35688,4.45527908540686
13540,"Bennington, VT",1992,149,4,153,35722,4.28307485583114
13540,"Bennington, VT",1993,163,5,168,35738,4.70087861659858
13540,"Bennington, VT",1994,136,6,142,35902,3.95521140883516
13540,"Bennington, VT",1995,135,14,149,36164,4.12011945581241
13540,"Bennington, VT",1996,123,8,131,36194,3.61938442835829
13540,"Bennington, VT",1997,124,17,141,36071,3.90895733414654
13540,"Bennington, VT",1998,125,12,137,35963,3.80947084503517
13540,"Bennington, VT",1999,146,40,186,36020,5.16379789006108
13540,"Bennington, VT",2000,195,18,213,36965,5.762207493575
13540,"Bennington, VT",2001,153,22,175,36974,4.73305566073457
13540,"Bennington, VT",2002,173,22,195,37105,5.25535642096752
13540,"Bennington, VT",2003,157,34,191,37083,5.15060809535367
13540,"Bennington, VT",2004,185,111,296,37062,7.98661702012843
13540,"Bennington, VT",2005,149,70,219,36960,5.92532467532468
13540,"Bennington, VT",2006,134,76,210,37127,5.65626094217146
13540,"Bennington, VT",2007,112,36,148,37077,3.99169296329261
13540,"Bennington, VT",2008,88,10,98,37168,2.63667671114938
13540,"Bennington, VT",2009,59,16,75,37151,2.01878818874324
13540,"Bennington, VT",2010,47,2,49,37083,1.32136019200173
13540,"Bennington, VT",2011,48,4,52,36814,1.41250611180529
13540,"Bennington, VT",2012,41,0,41,36614,1.1197902441689
13540,"Bennington, VT",2013,47,8,55,36543,1.50507621158635
13540,"Bennington, VT",2014,35,0,35,36173,0.96757249882509
13540,"Bennington, VT",2015,34,6,40,36161,1.10616409944415
13540,"Bennington, VT",2016,33,0,33,35921,0.918682664736505
13540,"Bennington, VT",2017,29,0,29,35713,0.81202923305239
13540,"Bennington, VT",2018,42,10,52,35631,1.45940332856221
13620,"Berlin, NH-VT",1990,98,10,108,41299,2.6150754255551
13620,"Berlin, NH-VT",1991,59,30,89,41133,2.16371283397758
13620,"Berlin, NH-VT",1992,58,30,88,40852,2.15411730147851
13620,"Berlin, NH-VT",1993,62,6,68,40479,1.67988339632896
13620,"Berlin, NH-VT",1994,56,29,85,40324,2.1079258010118
13620,"Berlin, NH-VT",1995,50,8,58,40092,1.44667265289833
13620,"Berlin, NH-VT",1996,51,10,61,39794,1.53289440619189
13620,"Berlin, NH-VT",1997,47,10,57,39662,1.43714386566487
13620,"Berlin, NH-VT",1998,62,10,72,39369,1.82885011049303
13620,"Berlin, NH-VT",1999,81,20,101,39324,2.5684060624555
13620,"Berlin, NH-VT",2000,89,4,93,39603,2.34830694644345
13620,"Berlin, NH-VT",2001,81,6,87,39580,2.19807983830217
13620,"Berlin, NH-VT",2002,121,0,121,39737,3.04502101316154
13620,"Berlin, NH-VT",2003,111,0,111,39942,2.77902959290972
13620,"Berlin, NH-VT",2004,165,4,169,40067,4.21793495894377
13620,"Berlin, NH-VT",2005,162,2,164,40295,4.06998386896637
13620,"Berlin, NH-VT",2006,149,10,159,40155,3.95965633171461
13620,"Berlin, NH-VT",2007,104,0,104,40172,2.58886786816688
13620,"Berlin, NH-VT",2008,69,0,69,39892,1.7296701092951
13620,"Berlin, NH-VT",2009,50,0,50,39555,1.2640626975098
13620,"Berlin, NH-VT",2010,49,0,49,39287,1.24723190877389
13620,"Berlin, NH-VT",2011,34,8,42,38830,1.08163790883338
13620,"Berlin, NH-VT",2012,42,33,75,38207,1.96299107493391
13620,"Berlin, NH-VT",2013,43,0,43,38150,1.12712975098296
13620,"Berlin, NH-VT",2014,59,6,65,38937,1.66936333050826
13620,"Berlin, NH-VT",2015,39,0,39,38528,1.01225083056478
13620,"Berlin, NH-VT",2016,71,8,79,38130,2.0718594282717
13620,"Berlin, NH-VT",2017,50,8,58,37797,1.53451332116306
13620,"Berlin, NH-VT",2018,82,4,86,37839,2.27278733581754
13660,"Big Rapids, MI",1990,206,0,206,37435,5.50287164418325
13660,"Big Rapids, MI",1991,187,0,187,37785,4.9490538573508
13660,"Big Rapids, MI",1992,215,0,215,37698,5.70322032999098
13660,"Big Rapids, MI",1993,218,8,226,37506,6.02570255425799
13660,"Big Rapids, MI",1994,229,6,235,37366,6.28913985976556
13660,"Big Rapids, MI",1995,225,12,237,37504,6.31932593856655
13660,"Big Rapids, MI",1996,241,20,261,38524,6.77499740421555
13660,"Big Rapids, MI",1997,289,21,310,39399,7.8682200055839
13660,"Big Rapids, MI",1998,329,0,329,40221,8.17980656870789
13660,"Big Rapids, MI",1999,307,0,307,40889,7.50813177138106
13660,"Big Rapids, MI",2000,263,0,263,40657,6.46875076862533
13660,"Big Rapids, MI",2001,247,34,281,41003,6.85315708606687
13660,"Big Rapids, MI",2002,244,2,246,41639,5.90792286077956
13660,"Big Rapids, MI",2003,257,2,259,42054,6.15874827602606
13660,"Big Rapids, MI",2004,289,48,337,42553,7.91953563791037
13660,"Big Rapids, MI",2005,282,177,459,42908,10.6973058637084
13660,"Big Rapids, MI",2006,157,12,169,42876,3.94159902976024
13660,"Big Rapids, MI",2007,123,5,128,42640,3.00187617260788
13660,"Big Rapids, MI",2008,76,6,82,42683,1.92113956376075
13660,"Big Rapids, MI",2009,65,0,65,42621,1.52506980127167
13660,"Big Rapids, MI",2010,35,0,35,42852,0.816764678428078
13660,"Big Rapids, MI",2011,32,0,32,43445,0.736563471055357
13660,"Big Rapids, MI",2012,45,0,45,43492,1.03467304331831
13660,"Big Rapids, MI",2013,41,64,105,43258,2.42729668500624
13660,"Big Rapids, MI",2014,39,40,79,43197,1.82883070583605
13660,"Big Rapids, MI",2015,37,0,37,43026,0.859945149444522
13660,"Big Rapids, MI",2016,58,66,124,43195,2.87070262761894
13660,"Big Rapids, MI",2017,67,6,73,43358,1.68365699524886
13660,"Big Rapids, MI",2018,99,146,245,43545,5.62636353197841
13700,"Big Spring, TX",1990,6,0,6,32228,0.186173513714782
13700,"Big Spring, TX",1991,14,0,14,32164,0.435269245118766
13700,"Big Spring, TX",1992,4,54,58,32109,1.80634713008814
13700,"Big Spring, TX",1993,10,0,10,32068,0.311837345640514
13700,"Big Spring, TX",1994,26,0,26,32144,0.808860129417621
13700,"Big Spring, TX",1995,20,12,32,32257,0.992032737080324
13700,"Big Spring, TX",1996,10,0,10,32315,0.309453814018258
13700,"Big Spring, TX",1997,22,0,22,32104,0.685272863194618
13700,"Big Spring, TX",1998,22,0,22,32108,0.685187492213779
13700,"Big Spring, TX",1999,13,4,17,31736,0.535669271489791
13700,"Big Spring, TX",2000,15,0,15,33489,0.447908268386634
13700,"Big Spring, TX",2001,3,0,3,33279,0.0901469395114036
13700,"Big Spring, TX",2002,0,76,76,33479,2.27007975148601
13700,"Big Spring, TX",2003,3,0,3,33396,0.0898311174991017
13700,"Big Spring, TX",2004,0,0,0,33403,0
13700,"Big Spring, TX",2005,2,64,66,33277,1.98335186465126
13700,"Big Spring, TX",2006,2,0,2,33328,0.0600096015362458
13700,"Big Spring, TX",2007,16,63,79,33817,2.33610314338942
13700,"Big Spring, TX",2008,10,0,10,34393,0.290756840054662
13700,"Big Spring, TX",2009,2,0,2,34882,0.0573361619173213
13700,"Big Spring, TX",2010,2,0,2,34992,0.0571559213534522
13700,"Big Spring, TX",2011,5,0,5,35016,0.14279186657528
13700,"Big Spring, TX",2012,15,0,15,35531,0.422166558779657
13700,"Big Spring, TX",2013,39,0,39,36218,1.07681263460158
13700,"Big Spring, TX",2014,29,4,33,36602,0.90159007704497
13700,"Big Spring, TX",2015,100,0,100,37282,2.68225953543265
13700,"Big Spring, TX",2016,23,0,23,36792,0.625135899108502
13700,"Big Spring, TX",2017,28,0,28,36198,0.773523399082822
13700,"Big Spring, TX",2018,38,0,38,36459,1.04226665569544
13720,"Big Stone Gap, VA",1990,133,96,229,61352,3.73255965575694
13720,"Big Stone Gap, VA",1991,96,2,98,61775,1.58640226628895
13720,"Big Stone Gap, VA",1992,127,0,127,61813,2.05458398718716
13720,"Big Stone Gap, VA",1993,100,4,104,61592,1.6885309780491
13720,"Big Stone Gap, VA",1994,125,6,131,61423,2.13275157514286
13720,"Big Stone Gap, VA",1995,98,7,105,61523,1.70667880304927
13720,"Big Stone Gap, VA",1996,70,0,70,60957,1.14835047656545
13720,"Big Stone Gap, VA",1997,72,0,72,60457,1.19092909009709
13720,"Big Stone Gap, VA",1998,85,0,85,60086,1.41463901740838
13720,"Big Stone Gap, VA",1999,85,12,97,60863,1.59374332517293
13720,"Big Stone Gap, VA",2000,76,0,76,62315,1.21961004573538
13720,"Big Stone Gap, VA",2001,75,3,78,61943,1.25922218814071
13720,"Big Stone Gap, VA",2002,92,4,96,61670,1.55667261229123
13720,"Big Stone Gap, VA",2003,105,3,108,61602,1.75318983149898
13720,"Big Stone Gap, VA",2004,86,3,89,61441,1.44854413176869
13720,"Big Stone Gap, VA",2005,82,0,82,61463,1.33413598425069
13720,"Big Stone Gap, VA",2006,92,0,92,61314,1.50047297517696
13720,"Big Stone Gap, VA",2007,80,2,82,61383,1.33587475359627
13720,"Big Stone Gap, VA",2008,97,7,104,61428,1.693039005014
13720,"Big Stone Gap, VA",2009,60,5,65,61282,1.06067034365719
13720,"Big Stone Gap, VA",2010,44,0,44,61445,0.71608755797868
13720,"Big Stone Gap, VA",2011,53,8,61,61325,0.994700366897676
13720,"Big Stone Gap, VA",2012,42,0,42,60749,0.6913694052577
13720,"Big Stone Gap, VA",2013,22,72,94,60300,1.55887230514096
13720,"Big Stone Gap, VA",2014,22,0,22,59388,0.370445207786085
13720,"Big Stone Gap, VA",2015,13,0,13,58774,0.221186238813081
13720,"Big Stone Gap, VA",2016,12,2,14,57981,0.241458408789086
13720,"Big Stone Gap, VA",2017,20,0,20,57224,0.34950370473927
13720,"Big Stone Gap, VA",2018,10,0,10,56503,0.176981753181247
13740,"Billings, MT",1990,153,8,161,122507,1.3142106165362
13740,"Billings, MT",1991,206,29,235,124105,1.89355787438056
13740,"Billings, MT",1992,435,16,451,127216,3.54515155326374
13740,"Billings, MT",1993,441,244,685,130225,5.26012670378192
13740,"Billings, MT",1994,484,65,549,132550,4.14183327046398
13740,"Billings, MT",1995,362,162,524,134455,3.89721468149195
13740,"Billings, MT",1996,352,213,565,135783,4.16105108886974
13740,"Billings, MT",1997,357,135,492,136471,3.60516153615054
13740,"Billings, MT",1998,373,56,429,136693,3.1384196703562
13740,"Billings, MT",1999,395,202,597,137774,4.33318332922032
13740,"Billings, MT",2000,435,56,491,140150,3.50338922582947
13740,"Billings, MT",2001,555,6,561,141458,3.96584145117279
13740,"Billings, MT",2002,590,122,712,142891,4.98281907187997
13740,"Billings, MT",2003,671,240,911,144443,6.30698614678454
13740,"Billings, MT",2004,646,293,939,146238,6.42103967505026
13740,"Billings, MT",2005,595,74,669,148558,4.50329164366779
13740,"Billings, MT",2006,676,49,725,150471,4.81820417223252
13740,"Billings, MT",2007,638,25,663,152455,4.34882424321931
13740,"Billings, MT",2008,557,14,571,155110,3.68125846173683
13740,"Billings, MT",2009,459,70,529,157395,3.36097080593411
13740,"Billings, MT",2010,321,136,457,159330,2.86826084227704
13740,"Billings, MT",2011,256,16,272,160666,1.69295308279287
13740,"Billings, MT",2012,419,202,621,162590,3.81942308875085
13740,"Billings, MT",2013,974,1128,2102,164953,12.7430237704073
13740,"Billings, MT",2014,517,134,651,166554,3.9086422421557
13740,"Billings, MT",2015,1274,490,1764,166937,10.5668605521844
13740,"Billings, MT",2016,1054,152,1206,168388,7.16203054849514
13740,"Billings, MT",2017,992,233,1225,169920,7.20927495291902
13740,"Billings, MT",2018,1158,318,1476,170851,8.63910658995265
13780,"Binghamton, NY",1990,512,84,596,264594,2.25250761544102
13780,"Binghamton, NY",1991,485,30,515,264946,1.94379231994444
13780,"Binghamton, NY",1992,443,12,455,265332,1.71483273785295
13780,"Binghamton, NY",1993,288,59,347,264214,1.31332934666596
13780,"Binghamton, NY",1994,248,14,262,261784,1.0008251077224
13780,"Binghamton, NY",1995,177,57,234,257294,0.909465436426811
13780,"Binghamton, NY",1996,155,54,209,253443,0.824643016378436
13780,"Binghamton, NY",1997,164,34,198,250489,0.790453872225926
13780,"Binghamton, NY",1998,215,12,227,249031,0.911533102304532
13780,"Binghamton, NY",1999,310,62,372,248075,1.49954650811247
13780,"Binghamton, NY",2000,233,20,253,252189,1.00321584208669
13780,"Binghamton, NY",2001,286,24,310,252580,1.22733391400744
13780,"Binghamton, NY",2002,331,59,390,253430,1.53888647752831
13780,"Binghamton, NY",2003,284,94,378,252932,1.49447282273496
13780,"Binghamton, NY",2004,274,15,289,252605,1.14407869994656
13780,"Binghamton, NY",2005,267,16,283,252088,1.1226238456412
13780,"Binghamton, NY",2006,303,0,303,252441,1.2002804615732
13780,"Binghamton, NY",2007,264,42,306,252442,1.2121596247851
13780,"Binghamton, NY",2008,286,0,286,252527,1.13255216273903
13780,"Binghamton, NY",2009,155,50,205,252171,0.812940425346293
13780,"Binghamton, NY",2010,102,6,108,251489,0.429442242006609
13780,"Binghamton, NY",2011,113,4,117,250218,0.467592259549673
13780,"Binghamton, NY",2012,104,12,116,248939,0.465977608972479
13780,"Binghamton, NY",2013,109,2,111,248021,0.447542748396305
13780,"Binghamton, NY",2014,85,0,85,247084,0.344012562529342
13780,"Binghamton, NY",2015,71,178,249,245154,1.01568809809344
13780,"Binghamton, NY",2016,133,205,338,243167,1.38999124058774
13780,"Binghamton, NY",2017,128,276,404,241609,1.67212314110815
13780,"Binghamton, NY",2018,93,222,315,240219,1.311303435615
13820,"Birmingham-Hoover, AL",1990,2696,1356,4052,941907,4.30191091052514
13820,"Birmingham-Hoover, AL",1991,2938,619,3557,968846,3.67137811375595
13820,"Birmingham-Hoover, AL",1992,3594,350,3944,978888,4.02906154738846
13820,"Birmingham-Hoover, AL",1993,4307,768,5075,990285,5.12478730870406
13820,"Birmingham-Hoover, AL",1994,4217,773,4990,1001182,4.984108783418
13820,"Birmingham-Hoover, AL",1995,4368,1797,6165,1011217,6.09661427764763
13820,"Birmingham-Hoover, AL",1996,4897,1925,6822,1019620,6.6907279182440504
13820,"Birmingham-Hoover, AL",1997,4425,725,5150,1027263,5.01332180756048
13820,"Birmingham-Hoover, AL",1998,5166,1341,6507,1036003,6.280869843041
13820,"Birmingham-Hoover, AL",1999,5063,985,6048,1043611,5.79526279427871
13820,"Birmingham-Hoover, AL",2000,4433,781,5214,1053306,4.95012845270035
13820,"Birmingham-Hoover, AL",2001,4720,476,5196,1059082,4.90613569109852
13820,"Birmingham-Hoover, AL",2002,5018,299,5317,1062966,5.0020414575819
13820,"Birmingham-Hoover, AL",2003,5970,703,6673,1070886,6.23128885801103
13820,"Birmingham-Hoover, AL",2004,6358,1442,7800,1078204,7.23425251622142
13820,"Birmingham-Hoover, AL",2005,6873,795,7668,1086318,7.05870656658548
13820,"Birmingham-Hoover, AL",2006,6437,1370,7807,1098818,7.10490727308799
13820,"Birmingham-Hoover, AL",2007,4930,503,5433,1107256,4.9067243708772
13820,"Birmingham-Hoover, AL",2008,2325,1034,3359,1117101,3.00689015585878
13820,"Birmingham-Hoover, AL",2009,1683,124,1807,1125271,1.60583539431835
13820,"Birmingham-Hoover, AL",2010,1563,361,1924,1128714,1.70459478663328
13820,"Birmingham-Hoover, AL",2011,1795,567,2362,1130493,2.0893539367338
13820,"Birmingham-Hoover, AL",2012,1847,1454,3301,1133591,2.91198501046674
13820,"Birmingham-Hoover, AL",2013,2016,760,2776,1138638,2.43800048830269
13820,"Birmingham-Hoover, AL",2014,2318,1046,3364,1141436,2.94716479942809
13820,"Birmingham-Hoover, AL",2015,2414,1319,3733,1144734,3.26101959057737
13820,"Birmingham-Hoover, AL",2016,2730,582,3312,1147616,2.88598276775507
13820,"Birmingham-Hoover, AL",2017,2677,12,2689,1149685,2.33890152520038
13820,"Birmingham-Hoover, AL",2018,2698,327,3025,1151801,2.62632173439683
13900,"Bismarck, ND",1990,275,119,394,90054,4.37515268616608
13900,"Bismarck, ND",1991,375,195,570,90647,6.28812867496994
13900,"Bismarck, ND",1992,541,183,724,91992,7.8702495869206
13900,"Bismarck, ND",1993,487,183,670,93315,7.17998178213578
13900,"Bismarck, ND",1994,527,362,889,94084,9.44900301857914
13900,"Bismarck, ND",1995,341,177,518,95218,5.44014787120082
13900,"Bismarck, ND",1996,385,116,501,96384,5.19795816733068
13900,"Bismarck, ND",1997,324,459,783,97063,8.06692560501942
13900,"Bismarck, ND",1998,421,305,726,97926,7.41376141167821
13900,"Bismarck, ND",1999,400,169,569,98225,5.79282260117078
13900,"Bismarck, ND",2000,387,116,503,101020,4.97921203722035
13900,"Bismarck, ND",2001,479,291,770,101289,7.60201008994066
13900,"Bismarck, ND",2002,588,277,865,102340,8.45221809654094
13900,"Bismarck, ND",2003,683,271,954,103201,9.24409647193341
13900,"Bismarck, ND",2004,661,192,853,104211,8.18531632937022
13900,"Bismarck, ND",2005,641,101,742,105942,7.00383228559023
13900,"Bismarck, ND",2006,699,294,993,107861,9.2062932848759
13900,"Bismarck, ND",2007,710,238,948,109742,8.63844289333163
13900,"Bismarck, ND",2008,556,255,811,111282,7.28779137686239
13900,"Bismarck, ND",2009,432,84,516,113143,4.56060030227235
13900,"Bismarck, ND",2010,565,86,651,115259,5.64814895149186
13900,"Bismarck, ND",2011,637,208,845,117084,7.2170407570633
13900,"Bismarck, ND",2012,1164,792,1956,120002,16.299728337861
13900,"Bismarck, ND",2013,1164,933,2097,123671,16.9562791600294
13900,"Bismarck, ND",2014,883,888,1771,126613,13.9875052324801
13900,"Bismarck, ND",2015,664,418,1082,129661,8.34483769213565
13900,"Bismarck, ND",2016,629,227,856,131621,6.50352147453674
13900,"Bismarck, ND",2017,514,118,632,132418,4.7727650319443
13900,"Bismarck, ND",2018,383,150,533,132678,4.0172447579855
13940,"Blackfoot, ID",1990,68,3,71,37615,1.88754486242191
13940,"Blackfoot, ID",1991,85,3,88,38421,2.29041409645767
13940,"Blackfoot, ID",1992,102,6,108,39619,2.72596481486156
13940,"Blackfoot, ID",1993,107,6,113,40351,2.80042625957225
13940,"Blackfoot, ID",1994,104,47,151,40843,3.69708395563499
13940,"Blackfoot, ID",1995,98,52,150,40923,3.6654204237226
13940,"Blackfoot, ID",1996,98,10,108,41182,2.62250497790297
13940,"Blackfoot, ID",1997,111,12,123,41458,2.96685802498915
13940,"Blackfoot, ID",1998,142,40,182,41857,4.34813770695463
13940,"Blackfoot, ID",1999,163,22,185,42050,4.39952437574316
13940,"Blackfoot, ID",2000,104,8,112,41753,2.68244198021699
13940,"Blackfoot, ID",2001,104,14,118,42073,2.80464906234402
13940,"Blackfoot, ID",2002,135,22,157,42101,3.72912757416688
13940,"Blackfoot, ID",2003,162,22,184,42555,4.32381623780989
13940,"Blackfoot, ID",2004,188,52,240,42702,5.62034565125755
13940,"Blackfoot, ID",2005,206,59,265,43173,6.13809556898988
13940,"Blackfoot, ID",2006,213,16,229,43396,5.27698405382985
13940,"Blackfoot, ID",2007,172,89,261,43816,5.95672813584079
13940,"Blackfoot, ID",2008,113,50,163,44414,3.6700139595623
13940,"Blackfoot, ID",2009,80,16,96,45087,2.12921684742831
13940,"Blackfoot, ID",2010,55,6,61,45767,1.33283807109926
13940,"Blackfoot, ID",2011,51,14,65,45894,1.41630714254587
13940,"Blackfoot, ID",2012,57,10,67,45514,1.47207452651931
13940,"Blackfoot, ID",2013,74,6,80,45431,1.76091215249499
13940,"Blackfoot, ID",2014,70,18,88,45229,1.9456543368193
13940,"Blackfoot, ID",2015,73,26,99,45066,2.19677805884702
13940,"Blackfoot, ID",2016,98,32,130,45318,2.86861732644865
13940,"Blackfoot, ID",2017,111,2,113,45904,2.4616591146741
13940,"Blackfoot, ID",2018,139,2,141,46236,3.04957176226317
13980,"Blacksburg-Christiansburg-Radford, VA",1990,471,240,711,152987,4.64745370521678
13980,"Blacksburg-Christiansburg-Radford, VA",1991,372,205,577,153034,3.77040396251813
13980,"Blacksburg-Christiansburg-Radford, VA",1992,463,121,584,153562,3.80302418567093
13980,"Blacksburg-Christiansburg-Radford, VA",1993,500,120,620,153732,4.03299248042047
13980,"Blacksburg-Christiansburg-Radford, VA",1994,600,128,728,154483,4.71249263673026
13980,"Blacksburg-Christiansburg-Radford, VA",1995,579,103,682,154489,4.41455378700102
13980,"Blacksburg-Christiansburg-Radford, VA",1996,613,84,697,154510,4.5110348844735
13980,"Blacksburg-Christiansburg-Radford, VA",1997,587,190,777,154814,5.01892593693077
13980,"Blacksburg-Christiansburg-Radford, VA",1998,674,421,1095,156186,7.01087165302908
13980,"Blacksburg-Christiansburg-Radford, VA",1999,650,71,721,157296,4.58371477977825
13980,"Blacksburg-Christiansburg-Radford, VA",2000,572,68,640,165462,3.86795759751484
13980,"Blacksburg-Christiansburg-Radford, VA",2001,665,61,726,167434,4.33603688617605
13980,"Blacksburg-Christiansburg-Radford, VA",2002,911,109,1020,167498,6.08962495074568
13980,"Blacksburg-Christiansburg-Radford, VA",2003,761,102,863,168270,5.12866226897248
13980,"Blacksburg-Christiansburg-Radford, VA",2004,946,52,998,169018,5.9046965411968
13980,"Blacksburg-Christiansburg-Radford, VA",2005,687,101,788,170990,4.60845663489093
13980,"Blacksburg-Christiansburg-Radford, VA",2006,940,114,1054,173039,6.09111240818544
13980,"Blacksburg-Christiansburg-Radford, VA",2007,653,284,937,174908,5.35710201934731
13980,"Blacksburg-Christiansburg-Radford, VA",2008,550,582,1132,176348,6.41912581940254
13980,"Blacksburg-Christiansburg-Radford, VA",2009,438,61,499,177535,2.81071338046019
13980,"Blacksburg-Christiansburg-Radford, VA",2010,247,70,317,178501,1.77590041512372
13980,"Blacksburg-Christiansburg-Radford, VA",2011,329,43,372,178821,2.08029258308588
13980,"Blacksburg-Christiansburg-Radford, VA",2012,274,121,395,179544,2.2000178229292
13980,"Blacksburg-Christiansburg-Radford, VA",2013,349,203,552,180727,3.05433056488516
13980,"Blacksburg-Christiansburg-Radford, VA",2014,297,56,353,181225,1.94785487653469
13980,"Blacksburg-Christiansburg-Radford, VA",2015,474,2,476,181345,2.6248311229976
13980,"Blacksburg-Christiansburg-Radford, VA",2016,455,88,543,182412,2.97677784356292
13980,"Blacksburg-Christiansburg-Radford, VA",2017,416,321,737,182692,4.03411205745189
13980,"Blacksburg-Christiansburg-Radford, VA",2018,435,131,566,184029,3.07560221486831
14010,"Bloomington, IL",1990,597,186,783,146169,5.35681300412536
14010,"Bloomington, IL",1991,802,333,1135,148305,7.65314723036985
14010,"Bloomington, IL",1992,1044,181,1225,149946,8.16960772544783
14010,"Bloomington, IL",1993,929,279,1208,152192,7.93734230445753
14010,"Bloomington, IL",1994,935,620,1555,153663,10.1195473210858
14010,"Bloomington, IL",1995,790,555,1345,155508,8.64907271651619
14010,"Bloomington, IL",1996,796,477,1273,156387,8.14006279294315
14010,"Bloomington, IL",1997,828,269,1097,157917,6.94668718377375
14010,"Bloomington, IL",1998,933,530,1463,159641,9.16431242600585
14010,"Bloomington, IL",1999,1010,385,1395,161725,8.625753594064
14010,"Bloomington, IL",2000,703,259,962,167644,5.73835031376011
14010,"Bloomington, IL",2001,1032,575,1607,169505,9.48054629656942
14010,"Bloomington, IL",2002,999,762,1761,172555,10.2054417432123
14010,"Bloomington, IL",2003,1088,608,1696,174481,9.72025607372723
14010,"Bloomington, IL",2004,941,272,1213,175767,6.90118167801692
14010,"Bloomington, IL",2005,764,165,929,177015,5.24814281275598
14010,"Bloomington, IL",2006,715,127,842,179717,4.68514386507676
14010,"Bloomington, IL",2007,456,231,687,181965,3.77545132305663
14010,"Bloomington, IL",2008,321,167,488,183558,2.65856023709127
14010,"Bloomington, IL",2009,325,198,523,185265,2.8229832942002
14010,"Bloomington, IL",2010,340,111,451,186400,2.41952789699571
14010,"Bloomington, IL",2011,255,379,634,187439,3.38243375178058
14010,"Bloomington, IL",2012,297,251,548,189208,2.89628345524502
14010,"Bloomington, IL",2013,413,281,694,191418,3.62557335255828
14010,"Bloomington, IL",2014,257,14,271,190337,1.42379043486027
14010,"Bloomington, IL",2015,245,151,396,189341,2.09146460618672
14010,"Bloomington, IL",2016,214,128,342,189273,1.80691382289075
14010,"Bloomington, IL",2017,214,172,386,188754,2.04498977505112
14010,"Bloomington, IL",2018,114,106,220,188597,1.16650848104689
14020,"Bloomington, IN",1990,428,147,575,126678,4.53906755711331
14020,"Bloomington, IN",1991,615,145,760,127500,5.96078431372549
14020,"Bloomington, IN",1992,663,448,1111,129247,8.59594419986537
14020,"Bloomington, IN",1993,821,224,1045,131097,7.97119690000534
14020,"Bloomington, IN",1994,849,371,1220,132954,9.17610602163154
14020,"Bloomington, IN",1995,655,339,994,134123,7.41110771456052
14020,"Bloomington, IN",1996,649,260,909,135203,6.72322359710953
14020,"Bloomington, IN",1997,449,67,516,136241,3.7874061405891
14020,"Bloomington, IN",1998,478,225,703,137056,5.12929021713752
14020,"Bloomington, IN",1999,581,440,1021,137852,7.40649392101674
14020,"Bloomington, IN",2000,481,144,625,142709,4.37954158462325
14020,"Bloomington, IN",2001,497,384,881,143650,6.13296206056387
14020,"Bloomington, IN",2002,590,453,1043,144707,7.20766790825599
14020,"Bloomington, IN",2003,663,513,1176,146835,8.00898968229646
14020,"Bloomington, IN",2004,659,479,1138,148549,7.66077186652216
14020,"Bloomington, IN",2005,843,185,1028,150096,6.84895000532992
14020,"Bloomington, IN",2006,651,86,737,152548,4.8312662244015
14020,"Bloomington, IN",2007,558,317,875,154352,5.6688607857365
14020,"Bloomington, IN",2008,327,249,576,156164,3.68843011193361
14020,"Bloomington, IN",2009,236,70,306,157840,1.9386720729853
14020,"Bloomington, IN",2010,196,67,263,160130,1.64241553737588
14020,"Bloomington, IN",2011,169,67,236,161699,1.45950191405018
14020,"Bloomington, IN",2012,172,249,421,162842,2.58532810945579
14020,"Bloomington, IN",2013,172,344,516,163223,3.1613191768317
14020,"Bloomington, IN",2014,233,306,539,164433,3.27793082896985
14020,"Bloomington, IN",2015,269,126,395,165050,2.39321417752196
14020,"Bloomington, IN",2016,292,209,501,166649,3.006318669779
14020,"Bloomington, IN",2017,313,291,604,167513,3.60569030463307
14020,"Bloomington, IN",2018,255,162,417,167762,2.48566421478046
14100,"Bloomsburg-Berwick, PA",1990,199,7,206,81080,2.5407005426739
14100,"Bloomsburg-Berwick, PA",1991,206,23,229,81504,2.80967805261091
14100,"Bloomsburg-Berwick, PA",1992,270,8,278,82082,3.38685704539363
14100,"Bloomsburg-Berwick, PA",1993,326,17,343,82368,4.16423853923854
14100,"Bloomsburg-Berwick, PA",1994,355,8,363,82235,4.41417887760686
14100,"Bloomsburg-Berwick, PA",1995,278,8,286,82312,3.4745845077267
14100,"Bloomsburg-Berwick, PA",1996,261,0,261,82185,3.17576200036503
14100,"Bloomsburg-Berwick, PA",1997,223,7,230,81957,2.80634967116903
14100,"Bloomsburg-Berwick, PA",1998,224,22,246,81542,3.0168502121606
14100,"Bloomsburg-Berwick, PA",1999,250,14,264,81240,3.24963072378139
14100,"Bloomsburg-Berwick, PA",2000,268,53,321,82211,3.90458697741178
14100,"Bloomsburg-Berwick, PA",2001,230,10,240,82592,2.90585044556373
14100,"Bloomsburg-Berwick, PA",2002,257,20,277,82838,3.34387599893769
14100,"Bloomsburg-Berwick, PA",2003,268,13,281,83240,3.37578087457953
14100,"Bloomsburg-Berwick, PA",2004,305,117,422,83511,5.05322652105711
14100,"Bloomsburg-Berwick, PA",2005,273,2,275,83718,3.28483719152393
14100,"Bloomsburg-Berwick, PA",2006,233,7,240,83996,2.85727891804372
14100,"Bloomsburg-Berwick, PA",2007,231,10,241,84303,2.85873575080365
14100,"Bloomsburg-Berwick, PA",2008,173,4,177,84735,2.08886528589131
14100,"Bloomsburg-Berwick, PA",2009,179,17,196,85385,2.29548515547227
14100,"Bloomsburg-Berwick, PA",2010,188,0,188,85662,2.19467208330415
14100,"Bloomsburg-Berwick, PA",2011,95,18,113,85446,1.32247267279919
14100,"Bloomsburg-Berwick, PA",2012,127,0,127,85474,1.48583194889674
14100,"Bloomsburg-Berwick, PA",2013,131,0,131,85597,1.53042746825239
14100,"Bloomsburg-Berwick, PA",2014,107,6,113,85544,1.32095763583653
14100,"Bloomsburg-Berwick, PA",2015,135,55,190,84994,2.23545191425277
14100,"Bloomsburg-Berwick, PA",2016,111,39,150,84410,1.77704063499585
14100,"Bloomsburg-Berwick, PA",2017,105,64,169,83924,2.01372670511415
14100,"Bloomsburg-Berwick, PA",2018,83,111,194,83696,2.31791244503919
14140,"Bluefield, WV-VA",1990,255,7,262,110898,2.36253133510072
14140,"Bluefield, WV-VA",1991,137,0,137,111343,1.23043208823186
14140,"Bluefield, WV-VA",1992,160,22,182,111735,1.62885398487493
14140,"Bluefield, WV-VA",1993,132,55,187,112139,1.66757327959051
14140,"Bluefield, WV-VA",1994,140,46,186,111798,1.66371491439918
14140,"Bluefield, WV-VA",1995,118,24,142,111709,1.27115988863923
14140,"Bluefield, WV-VA",1996,121,21,142,111418,1.27447988655334
14140,"Bluefield, WV-VA",1997,96,96,192,111047,1.72899763163345
14140,"Bluefield, WV-VA",1998,88,68,156,110550,1.41112618724559
14140,"Bluefield, WV-VA",1999,88,0,88,110033,0.799760071978406
14140,"Bluefield, WV-VA",2000,105,22,127,107329,1.18327758574104
14140,"Bluefield, WV-VA",2001,88,2,90,105843,0.850316034126017
14140,"Bluefield, WV-VA",2002,89,6,95,106011,0.89613342011678
14140,"Bluefield, WV-VA",2003,94,23,117,105952,1.1042736333434
14140,"Bluefield, WV-VA",2004,94,5,99,105796,0.935763166849408
14140,"Bluefield, WV-VA",2005,97,12,109,105328,1.03486252468479
14140,"Bluefield, WV-VA",2006,144,0,144,105492,1.36503241951996
14140,"Bluefield, WV-VA",2007,88,14,102,105784,0.964228994933071
14140,"Bluefield, WV-VA",2008,67,2,69,106868,0.645656323689037
14140,"Bluefield, WV-VA",2009,57,14,71,107246,0.662029353076105
14140,"Bluefield, WV-VA",2010,25,8,33,107464,0.307079580138465
14140,"Bluefield, WV-VA",2011,41,6,47,107291,0.438060974359452
14140,"Bluefield, WV-VA",2012,43,6,49,106690,0.459274533695754
14140,"Bluefield, WV-VA",2013,69,9,78,105934,0.736307512224593
14140,"Bluefield, WV-VA",2014,18,13,31,105148,0.294822535854225
14140,"Bluefield, WV-VA",2015,33,2,35,104028,0.33644787941708
14140,"Bluefield, WV-VA",2016,14,6,20,102721,0.194702154379338
14140,"Bluefield, WV-VA",2017,17,0,17,100947,0.168405202730146
14140,"Bluefield, WV-VA",2018,19,0,19,99986,0.190026603724521
14180,"Blytheville, AR",1990,58,6,64,57501,1.11302412131963
14180,"Blytheville, AR",1991,70,8,78,57154,1.36473387689401
14180,"Blytheville, AR",1992,83,14,97,54969,1.76463097382161
14180,"Blytheville, AR",1993,75,18,93,51084,1.82053089029833
14180,"Blytheville, AR",1994,85,4,89,50827,1.75103783422197
14180,"Blytheville, AR",1995,71,14,85,50765,1.6743819560721
14180,"Blytheville, AR",1996,65,4,69,50471,1.36712171345921
14180,"Blytheville, AR",1997,85,12,97,50502,1.92071601124708
14180,"Blytheville, AR",1998,65,23,88,50612,1.73871809057141
14180,"Blytheville, AR",1999,49,50,99,50053,1.97790342237229
14180,"Blytheville, AR",2000,40,0,40,51849,0.7714710023337
14180,"Blytheville, AR",2001,26,4,30,51017,0.588039281023972
14180,"Blytheville, AR",2002,55,0,55,49957,1.10094681426026
14180,"Blytheville, AR",2003,23,0,23,48554,0.47369938625036
14180,"Blytheville, AR",2004,24,4,28,47777,0.586056052075266
14180,"Blytheville, AR",2005,23,6,29,47399,0.61182725373953
14180,"Blytheville, AR",2006,28,25,53,46983,1.12806759891876
14180,"Blytheville, AR",2007,20,22,42,46850,0.896478121664888
14180,"Blytheville, AR",2008,46,4,50,47037,1.06299296298659
14180,"Blytheville, AR",2009,23,18,41,46857,0.87500266769106
14180,"Blytheville, AR",2010,14,21,35,46394,0.754407897572962
14180,"Blytheville, AR",2011,29,0,29,46024,0.630106031635668
14180,"Blytheville, AR",2012,30,44,74,45550,1.62458836443469
14180,"Blytheville, AR",2013,27,4,31,44697,0.693558851824507
14180,"Blytheville, AR",2014,27,3,30,44250,0.677966101694915
14180,"Blytheville, AR",2015,21,29,50,43715,1.14377216058561
14180,"Blytheville, AR",2016,24,24,48,42879,1.11942909116351
14180,"Blytheville, AR",2017,35,0,35,42073,0.831887433746108
14180,"Blytheville, AR",2018,33,0,33,41239,0.800213390237397
14220,"Bogalusa, LA",1990,12,2,14,43142,0.324509758472023
14220,"Bogalusa, LA",1991,19,2,21,42652,0.492356747631998
14220,"Bogalusa, LA",1992,62,0,62,42783,1.44917373723208
14220,"Bogalusa, LA",1993,113,49,162,42852,3.78045365443853
14220,"Bogalusa, LA",1994,136,2,138,42874,3.21873396464057
14220,"Bogalusa, LA",1995,120,2,122,43048,2.83404571640959
14220,"Bogalusa, LA",1996,132,0,132,43074,3.06449366206993
14220,"Bogalusa, LA",1997,138,22,160,43162,3.70696445947824
14220,"Bogalusa, LA",1998,115,40,155,43095,3.59670495417102
14220,"Bogalusa, LA",1999,146,4,150,43297,3.46444326396748
14220,"Bogalusa, LA",2000,114,2,116,43936,2.64020393299344
14220,"Bogalusa, LA",2001,115,10,125,43992,2.84142571376614
14220,"Bogalusa, LA",2002,164,0,164,44156,3.71410453845457
14220,"Bogalusa, LA",2003,137,0,137,44277,3.09415723739187
14220,"Bogalusa, LA",2004,157,0,157,44521,3.52642573167719
14220,"Bogalusa, LA",2005,141,6,147,44880,3.27540106951872
14220,"Bogalusa, LA",2006,578,23,601,45157,13.3091215094005
14220,"Bogalusa, LA",2007,345,31,376,46376,8.10764188373297
14220,"Bogalusa, LA",2008,105,0,105,47000,2.23404255319149
14220,"Bogalusa, LA",2009,105,0,105,47262,2.22165799162118
14220,"Bogalusa, LA",2010,68,0,68,47088,1.44410465511383
14220,"Bogalusa, LA",2011,86,0,86,47123,1.82501114105638
14220,"Bogalusa, LA",2012,66,0,66,46678,1.4139423282917
14220,"Bogalusa, LA",2013,74,0,74,46413,1.59438088466593
14220,"Bogalusa, LA",2014,68,0,68,46324,1.46792159571712
14220,"Bogalusa, LA",2015,62,0,62,46368,1.33712905452036
14220,"Bogalusa, LA",2016,84,0,84,46403,1.81022778699653
14220,"Bogalusa, LA",2017,89,0,89,46609,1.90950245660709
14220,"Bogalusa, LA",2018,0,6,6,46582,0.128805117856683
14260,"Boise City, ID",1990,2243,768,3011,322066,9.34901541919979
14260,"Boise City, ID",1991,2635,591,3226,334072,9.6566009722455
14260,"Boise City, ID",1992,3957,937,4894,345200,14.1772885283893
14260,"Boise City, ID",1993,4707,1594,6301,360417,17.4825271837899
14260,"Boise City, ID",1994,4525,2316,6841,375105,18.2375601498247
14260,"Boise City, ID",1995,4005,947,4952,388894,12.7335469305261
14260,"Boise City, ID",1996,4459,311,4770,401470,11.8813360898697
14260,"Boise City, ID",1997,4775,636,5411,413240,13.0940857613009
14260,"Boise City, ID",1998,5773,697,6470,427170,15.1461947234122
14260,"Boise City, ID",1999,6051,811,6862,439820,15.6018371151835
14260,"Boise City, ID",2000,5727,562,6289,469017,13.4088956263845
14260,"Boise City, ID",2001,5570,1188,6758,486078,13.9031184295525
14260,"Boise City, ID",2002,6089,953,7042,499994,14.0841690100281
14260,"Boise City, ID",2003,6708,1016,7724,512491,15.0714841821612
14260,"Boise City, ID",2004,7843,1052,8895,525975,16.9114501639812
14260,"Boise City, ID",2005,10948,601,11549,546980,21.114117518008
14260,"Boise City, ID",2006,7440,912,8352,570583,14.6376600774997
14260,"Boise City, ID",2007,3762,1102,4864,590330,8.23945928548439
14260,"Boise City, ID",2008,2377,420,2797,603218,4.63679797353527
14260,"Boise City, ID",2009,1769,135,1904,611341,3.1144647586208
14260,"Boise City, ID",2010,1630,63,1693,617869,2.740063023068
14260,"Boise City, ID",2011,1578,262,1840,627640,2.93161685042381
14260,"Boise City, ID",2012,2887,669,3556,637514,5.57791672026026
14260,"Boise City, ID",2013,3522,843,4365,649411,6.72147530608505
14260,"Boise City, ID",2014,3481,1702,5183,662777,7.82012652822895
14260,"Boise City, ID",2015,4295,1204,5499,674874,8.14818766169685
14260,"Boise City, ID",2016,5383,1375,6758,691605,9.77147360126084
14260,"Boise City, ID",2017,6275,1634,7909,710080,11.1381816133393
14260,"Boise City, ID",2018,6923,1994,8917,730426,12.2079444050458
14340,"Boone, IA",1990,21,6,27,25205,1.07121602856576
14340,"Boone, IA",1991,23,6,29,25361,1.14348803280628
14340,"Boone, IA",1992,22,6,28,25305,1.10650069156293
14340,"Boone, IA",1993,23,40,63,25199,2.50009921028612
14340,"Boone, IA",1994,46,30,76,25248,3.01013941698352
14340,"Boone, IA",1995,49,64,113,25565,4.42010561314297
14340,"Boone, IA",1996,79,64,143,25873,5.52699725582654
14340,"Boone, IA",1997,85,22,107,26178,4.08740163496065
14340,"Boone, IA",1998,90,61,151,26106,5.78411093235272
14340,"Boone, IA",1999,94,9,103,26364,3.90684266423911
14340,"Boone, IA",2000,96,6,102,26251,3.88556626414232
14340,"Boone, IA",2001,65,138,203,26249,7.73362794773134
14340,"Boone, IA",2002,84,22,106,26086,4.06348232768535
14340,"Boone, IA",2003,60,25,85,26232,3.24031716986886
14340,"Boone, IA",2004,110,10,120,26372,4.55028060063704
14340,"Boone, IA",2005,106,5,111,26500,4.18867924528302
14340,"Boone, IA",2006,83,7,90,26471,3.39994711193381
14340,"Boone, IA",2007,105,4,109,26553,4.10499755206568
14340,"Boone, IA",2008,49,36,85,26454,3.21312466923717
14340,"Boone, IA",2009,31,4,35,26360,1.32776934749621
14340,"Boone, IA",2010,32,0,32,26274,1.21793407931796
14340,"Boone, IA",2011,36,6,42,26289,1.59762638365856
14340,"Boone, IA",2012,29,8,37,26141,1.41540109406679
14340,"Boone, IA",2013,32,6,38,26291,1.44536153056179
14340,"Boone, IA",2014,42,2,44,26296,1.67325829023426
14340,"Boone, IA",2015,57,4,61,26453,2.30597663781046
14340,"Boone, IA",2016,66,2,68,26426,2.57322334064936
14340,"Boone, IA",2017,60,52,112,26476,4.23024626076447
14340,"Boone, IA",2018,59,2,61,26346,2.31534198739847
14380,"Boone, NC",1990,288,60,348,37018,9.40083202766222
14380,"Boone, NC",1991,317,47,364,37313,9.75531316163267
14380,"Boone, NC",1992,338,56,394,38143,10.3295493275306
14380,"Boone, NC",1993,351,57,408,38531,10.5888764890608
14380,"Boone, NC",1994,348,24,372,39265,9.47408633643194
14380,"Boone, NC",1995,356,166,522,39915,13.0777903043968
14380,"Boone, NC",1996,385,119,504,40342,12.4931832829309
14380,"Boone, NC",1997,417,116,533,40710,13.0926062392533
14380,"Boone, NC",1998,449,57,506,40865,12.3822341857335
14380,"Boone, NC",1999,506,348,854,41218,20.7191033043816
14380,"Boone, NC",2000,497,76,573,42905,13.355086819718
14380,"Boone, NC",2001,408,63,471,43853,10.7404282489225
14380,"Boone, NC",2002,473,68,541,44570,12.1382095579987
14380,"Boone, NC",2003,440,383,823,45095,18.2503603503714
14380,"Boone, NC",2004,494,42,536,45478,11.7859184660715
14380,"Boone, NC",2005,508,142,650,46390,14.0116404397499
14380,"Boone, NC",2006,568,54,622,47748,13.0267236324035
14380,"Boone, NC",2007,455,36,491,48765,10.0686968112376
14380,"Boone, NC",2008,332,54,386,50266,7.67914693828831
14380,"Boone, NC",2009,160,70,230,50706,4.53595235277876
14380,"Boone, NC",2010,169,102,271,50967,5.31716600937862
14380,"Boone, NC",2011,106,77,183,51617,3.54534358835267
14380,"Boone, NC",2012,190,130,320,52059,6.14687181851361
14380,"Boone, NC",2013,225,72,297,52297,5.67910205174293
14380,"Boone, NC",2014,126,117,243,52397,4.63767009561616
14380,"Boone, NC",2015,124,273,397,53062,7.48181372733783
14380,"Boone, NC",2016,132,66,198,54095,3.66022737776135
14380,"Boone, NC",2017,152,173,325,55088,5.89965146674412
14380,"Boone, NC",2018,197,134,331,55945,5.91652515863795
14420,"Borger, TX",1990,13,0,13,25570,0.508408290965976
14420,"Borger, TX",1991,16,0,16,25606,0.624853549949231
14420,"Borger, TX",1992,26,0,26,25333,1.0263292938065
14420,"Borger, TX",1993,13,0,13,25187,0.516139278199071
14420,"Borger, TX",1994,12,0,12,24874,0.482431454530835
14420,"Borger, TX",1995,3,0,3,24515,0.12237405669998
14420,"Borger, TX",1996,4,0,4,24210,0.165220983064849
14420,"Borger, TX",1997,4,0,4,23943,0.167063442342229
14420,"Borger, TX",1998,4,0,4,24043,0.166368589610282
14420,"Borger, TX",1999,6,0,6,23790,0.252206809583859
14420,"Borger, TX",2000,1,0,1,23778,0.0420556817226007
14420,"Borger, TX",2001,1,0,1,23247,0.0430163031789048
14420,"Borger, TX",2002,0,0,0,23116,0
14420,"Borger, TX",2003,0,0,0,22773,0
14420,"Borger, TX",2004,3,0,3,22478,0.133463831301717
14420,"Borger, TX",2005,1,0,1,22209,0.0450267909406097
14420,"Borger, TX",2006,4,0,4,22176,0.18037518037518
14420,"Borger, TX",2007,7,0,7,22138,0.316198391905321
14420,"Borger, TX",2008,10,0,10,21851,0.457644959040776
14420,"Borger, TX",2009,3,0,3,22184,0.135232600072124
14420,"Borger, TX",2010,0,0,0,22212,0
14420,"Borger, TX",2011,1,0,1,22021,0.0454111984015258
14420,"Borger, TX",2012,0,0,0,22021,0
14420,"Borger, TX",2013,2,0,2,21924,0.0912242291552636
14420,"Borger, TX",2014,0,0,0,21921,0
14420,"Borger, TX",2015,0,48,48,21810,2.20082530949106
14420,"Borger, TX",2016,1,48,49,21562,2.27251646414989
14420,"Borger, TX",2017,0,0,0,21362,0
14420,"Borger, TX",2018,0,0,0,21198,0
14460,"Boston-Cambridge-Newton, MA-NH",1990,5907,1748,7655,4134904,1.85131263023277
14460,"Boston-Cambridge-Newton, MA-NH",1991,6663,760,7423,4116230,1.8033491811682
14460,"Boston-Cambridge-Newton, MA-NH",1992,9108,835,9943,4116297,2.41552055160257
14460,"Boston-Cambridge-Newton, MA-NH",1993,9287,1308,10595,4132756,2.56366453765961
14460,"Boston-Cambridge-Newton, MA-NH",1994,9590,1146,10736,4148671,2.58781667671406
14460,"Boston-Cambridge-Newton, MA-NH",1995,8615,1256,9871,4180236,2.36134993335305
14460,"Boston-Cambridge-Newton, MA-NH",1996,8864,1257,10121,4205204,2.40677978999354
14460,"Boston-Cambridge-Newton, MA-NH",1997,9239,1534,10773,4232413,2.5453565141209
14460,"Boston-Cambridge-Newton, MA-NH",1998,9610,2289,11899,4257489,2.79483986922808
14460,"Boston-Cambridge-Newton, MA-NH",1999,8945,2989,11934,4279377,2.78872368571407
14460,"Boston-Cambridge-Newton, MA-NH",2000,8517,3373,11890,4401256,2.70150157136963
14460,"Boston-Cambridge-Newton, MA-NH",2001,7486,3514,11000,4432132,2.48187553980793
14460,"Boston-Cambridge-Newton, MA-NH",2002,7403,3627,11030,4440034,2.4842152109646
14460,"Boston-Cambridge-Newton, MA-NH",2003,7035,7006,14041,4434723,3.16615039992351
14460,"Boston-Cambridge-Newton, MA-NH",2004,8204,7219,15423,4424956,3.48545838647887
14460,"Boston-Cambridge-Newton, MA-NH",2005,8318,9124,17442,4418046,3.94789913912168
14460,"Boston-Cambridge-Newton, MA-NH",2006,6167,7749,13916,4427356,3.14318523290199
14460,"Boston-Cambridge-Newton, MA-NH",2007,5305,5943,11248,4447838,2.52886908201243
14460,"Boston-Cambridge-Newton, MA-NH",2008,3382,4252,7634,4483141,1.70282397988375
14460,"Boston-Cambridge-Newton, MA-NH",2009,3073,2403,5476,4527220,1.2095723203202
14460,"Boston-Cambridge-Newton, MA-NH",2010,3748,2924,6672,4566449,1.46109153961864
14460,"Boston-Cambridge-Newton, MA-NH",2011,3394,2745,6139,4609467,1.33182426514823
14460,"Boston-Cambridge-Newton, MA-NH",2012,4126,4725,8851,4656698,1.90070303034468
14460,"Boston-Cambridge-Newton, MA-NH",2013,4953,7068,12021,4703321,2.55585361917675
14460,"Boston-Cambridge-Newton, MA-NH",2014,4991,7033,12024,4747822,2.53252965254384
14460,"Boston-Cambridge-Newton, MA-NH",2015,4844,10192,15036,4779753,3.14576924790884
14460,"Boston-Cambridge-Newton, MA-NH",2016,5243,8004,13247,4811098,2.75342551741827
14460,"Boston-Cambridge-Newton, MA-NH",2017,4949,9808,14757,4844597,3.04607380139153
14460,"Boston-Cambridge-Newton, MA-NH",2018,4930,9253,14183,4875390,2.90910060528491
14500,"Boulder, CO",1990,1014,446,1460,226108,6.45709130150194
14500,"Boulder, CO",1991,1531,19,1550,231481,6.69601392770897
14500,"Boulder, CO",1992,2406,393,2799,237897,11.765596035259
14500,"Boulder, CO",1993,2852,215,3067,243651,12.5876766358439
14500,"Boulder, CO",1994,2211,412,2623,249292,10.5217977311747
14500,"Boulder, CO",1995,2116,978,3094,253194,12.2198788280923
14500,"Boulder, CO",1996,1752,992,2744,256971,10.6782477400174
14500,"Boulder, CO",1997,2373,886,3259,261681,12.4540948712364
14500,"Boulder, CO",1998,2941,2195,5136,267021,19.2344422348804
14500,"Boulder, CO",1999,2339,653,2992,273761,10.9292411994404
14500,"Boulder, CO",2000,2474,306,2780,271574,10.2366205895999
14500,"Boulder, CO",2001,1916,1405,3321,277597,11.9633857714601
14500,"Boulder, CO",2002,1352,365,1717,279468,6.14381610774758
14500,"Boulder, CO",2003,1157,271,1428,278768,5.12253917235838
14500,"Boulder, CO",2004,1125,247,1372,279728,4.90476462849625
14500,"Boulder, CO",2005,816,325,1141,280241,4.07149560556806
14500,"Boulder, CO",2006,453,293,746,284243,2.62451493968189
14500,"Boulder, CO",2007,397,238,635,287428,2.20924892494816
14500,"Boulder, CO",2008,305,717,1022,290859,3.51373002038789
14500,"Boulder, CO",2009,136,209,345,293190,1.1767113475903
14500,"Boulder, CO",2010,276,381,657,295774,2.22129057996984
14500,"Boulder, CO",2011,390,271,661,300897,2.1967650059655
14500,"Boulder, CO",2012,471,824,1295,305565,4.23805082388363
14500,"Boulder, CO",2013,591,1034,1625,310247,5.23776217014185
14500,"Boulder, CO",2014,560,811,1371,313298,4.37602538158558
14500,"Boulder, CO",2015,768,481,1249,319175,3.91321375421007
14500,"Boulder, CO",2016,716,1133,1849,322527,5.73285337351602
14500,"Boulder, CO",2017,808,859,1667,324073,5.14390276264916
14500,"Boulder, CO",2018,899,2055,2954,326078,9.05918215886996
14540,"Bowling Green, KY",1990,379,114,493,103788,4.75006744517671
14540,"Bowling Green, KY",1991,385,69,454,104540,4.34283527836235
14540,"Bowling Green, KY",1992,480,242,722,106016,6.81029278599457
14540,"Bowling Green, KY",1993,572,538,1110,108118,10.2665606097042
14540,"Bowling Green, KY",1994,653,408,1061,109710,9.67095068817792
14540,"Bowling Green, KY",1995,479,267,746,95786,7.78819451694402
14540,"Bowling Green, KY",1996,541,319,860,97134,8.85374843000391
14540,"Bowling Green, KY",1997,605,374,979,98321,9.95718107016812
14540,"Bowling Green, KY",1998,547,176,723,99265,7.28353397471415
14540,"Bowling Green, KY",1999,686,312,998,99591,10.0209858320531
14540,"Bowling Green, KY",2000,628,174,802,105908,7.57261018997621
14540,"Bowling Green, KY",2001,623,18,641,107226,5.97802771715815
14540,"Bowling Green, KY",2002,637,102,739,108528,6.8093026684358
14540,"Bowling Green, KY",2003,753,293,1046,110678,9.45083937187156
14540,"Bowling Green, KY",2004,809,515,1324,112541,11.7646013452875
14540,"Bowling Green, KY",2005,1250,135,1385,115021,12.041279418541
14540,"Bowling Green, KY",2006,763,198,961,118095,8.13751640628308
14540,"Bowling Green, KY",2007,647,180,827,120115,6.88506847604379
14540,"Bowling Green, KY",2008,370,190,560,122548,4.56963801938832
14540,"Bowling Green, KY",2009,284,69,353,125045,2.82298372585869
14540,"Bowling Green, KY",2010,362,211,573,127059,4.50971595872783
14540,"Bowling Green, KY",2011,291,552,843,128564,6.5570455181855
14540,"Bowling Green, KY",2012,386,531,917,130146,7.04593302905967
14540,"Bowling Green, KY",2013,378,151,529,132302,3.99842783933727
14540,"Bowling Green, KY",2014,417,186,603,134040,4.49865711727842
14540,"Bowling Green, KY",2015,546,601,1147,157493,7.28286336535592
14540,"Bowling Green, KY",2016,580,765,1345,159914,8.41077078929925
14540,"Bowling Green, KY",2017,737,533,1270,162714,7.80510589131851
14540,"Bowling Green, KY",2018,783,1416,2199,165158,13.3145230627641
14580,"Bozeman, MT",1990,88,26,114,50758,2.24595137712282
14580,"Bozeman, MT",1991,170,80,250,52313,4.77892684418787
14580,"Bozeman, MT",1992,264,96,360,54114,6.6526222419337
14580,"Bozeman, MT",1993,327,166,493,55970,8.80829015544041
14580,"Bozeman, MT",1994,285,251,536,57838,9.26726373664373
14580,"Bozeman, MT",1995,269,364,633,59323,10.6703976535239
14580,"Bozeman, MT",1996,234,253,487,60191,8.09091060125268
14580,"Bozeman, MT",1997,275,209,484,61253,7.90165379654874
14580,"Bozeman, MT",1998,256,338,594,62605,9.48806005910071
14580,"Bozeman, MT",1999,344,409,753,63914,11.7814563319461
14580,"Bozeman, MT",2000,317,406,723,68375,10.5740402193784
14580,"Bozeman, MT",2001,344,272,616,70120,8.78494010268112
14580,"Bozeman, MT",2002,386,297,683,71824,9.50935620405436
14580,"Bozeman, MT",2003,384,377,761,74504,10.2142166863524
14580,"Bozeman, MT",2004,1321,609,1930,77124,25.0246356516778
14580,"Bozeman, MT",2005,1054,627,1681,80310,20.9313908604159
14580,"Bozeman, MT",2006,1064,686,1750,83984,20.8373023433035
14580,"Bozeman, MT",2007,854,557,1411,86620,16.2895405218194
14580,"Bozeman, MT",2008,336,170,506,88932,5.6897404758692
14580,"Bozeman, MT",2009,259,132,391,89187,4.38404700236582
14580,"Bozeman, MT",2010,322,76,398,89651,4.43943737381624
14580,"Bozeman, MT",2011,346,41,387,91364,4.23580403660085
14580,"Bozeman, MT",2012,524,215,739,92565,7.98357910657376
14580,"Bozeman, MT",2013,777,572,1349,94793,14.2310086187799
14580,"Bozeman, MT",2014,701,490,1191,97508,12.2143824096484
14580,"Bozeman, MT",2015,872,624,1496,100866,14.8315587016438
14580,"Bozeman, MT",2016,1072,478,1550,104738,14.7988313697034
14580,"Bozeman, MT",2017,1045,567,1612,108656,14.8358121042556
14580,"Bozeman, MT",2018,919,701,1620,111876,14.4803174943688
14620,"Bradford, PA",1990,55,0,55,47311,1.16252034410602
14620,"Bradford, PA",1991,73,0,73,47310,1.5430141619108
14620,"Bradford, PA",1992,66,0,66,47603,1.3864672394597
14620,"Bradford, PA",1993,94,9,103,47325,2.17643951399894
14620,"Bradford, PA",1994,85,8,93,47395,1.96223230298555
14620,"Bradford, PA",1995,106,0,106,47332,2.23949970421702
14620,"Bradford, PA",1996,96,56,152,47187,3.22122618517812
14620,"Bradford, PA",1997,88,4,92,46681,1.97082324714552
14620,"Bradford, PA",1998,90,0,90,46299,1.94388647702974
14620,"Bradford, PA",1999,67,0,67,45989,1.45687012111592
14620,"Bradford, PA",2000,88,0,88,45748,1.92358135874792
14620,"Bradford, PA",2001,72,4,76,45263,1.67907562468241
14620,"Bradford, PA",2002,69,0,69,45419,1.51918800501993
14620,"Bradford, PA",2003,63,0,63,44980,1.40062249888839
14620,"Bradford, PA",2004,59,0,59,44582,1.32340406442062
14620,"Bradford, PA",2005,39,0,39,44187,0.88261253309797
14620,"Bradford, PA",2006,51,0,51,44309,1.15100769595342
14620,"Bradford, PA",2007,30,0,30,44045,0.681121580202066
14620,"Bradford, PA",2008,26,0,26,43856,0.592849325063845
14620,"Bradford, PA",2009,21,0,21,43701,0.480538202787122
14620,"Bradford, PA",2010,35,0,35,43343,0.807512170361996
14620,"Bradford, PA",2011,21,0,21,43128,0.48692264885921
14620,"Bradford, PA",2012,19,0,19,43141,0.440416309311328
14620,"Bradford, PA",2013,15,2,17,42806,0.39714058776807
14620,"Bradford, PA",2014,26,2,28,42644,0.656598818122127
14620,"Bradford, PA",2015,30,0,30,42406,0.70744705937839
14620,"Bradford, PA",2016,24,0,24,41683,0.575774296475781
14620,"Bradford, PA",2017,21,0,21,41329,0.508117786542137
14620,"Bradford, PA",2018,15,0,15,40968,0.36613942589338
14660,"Brainerd, MN",1990,915,24,939,66315,14.1596923772902
14660,"Brainerd, MN",1991,447,72,519,67570,7.68092348675448
14660,"Brainerd, MN",1992,507,67,574,69420,8.26851051570153
14660,"Brainerd, MN",1993,497,130,627,71224,8.8032124003145
14660,"Brainerd, MN",1994,552,53,605,72585,8.33505545222842
14660,"Brainerd, MN",1995,793,23,816,74222,10.99404489235
14660,"Brainerd, MN",1996,935,120,1055,75756,13.9262896668251
14660,"Brainerd, MN",1997,700,69,769,76961,9.99207390756357
14660,"Brainerd, MN",1998,980,73,1053,78051,13.4911788446016
14660,"Brainerd, MN",1999,1198,30,1228,79611,15.4250040823504
14660,"Brainerd, MN",2000,1176,33,1209,82476,14.6588098355885
14660,"Brainerd, MN",2001,1252,67,1319,83560,15.7850646242221
14660,"Brainerd, MN",2002,1471,180,1651,84866,19.4541983833337
14660,"Brainerd, MN",2003,1412,191,1603,86027,18.6336847733851
14660,"Brainerd, MN",2004,1388,115,1503,87152,17.2457315953736
14660,"Brainerd, MN",2005,2272,150,2422,88289,27.43263600222
14660,"Brainerd, MN",2006,1126,42,1168,89408,13.0637079455977
14660,"Brainerd, MN",2007,751,175,926,90165,10.2700604447402
14660,"Brainerd, MN",2008,491,34,525,90911,5.77487872754672
14660,"Brainerd, MN",2009,384,43,427,90790,4.70316114109483
14660,"Brainerd, MN",2010,349,16,365,91262,3.99947404176985
14660,"Brainerd, MN",2011,353,15,368,91048,4.04182409278622
14660,"Brainerd, MN",2012,427,40,467,91208,5.12016489781598
14660,"Brainerd, MN",2013,442,12,454,91476,4.96305041759587
14660,"Brainerd, MN",2014,451,31,482,91651,5.25908064287351
14660,"Brainerd, MN",2015,529,142,671,91918,7.29998476903327
14660,"Brainerd, MN",2016,313,6,319,92754,3.43920477823059
14660,"Brainerd, MN",2017,547,38,585,93651,6.24659640580453
14660,"Brainerd, MN",2018,618,121,739,94408,7.82772646385899
14700,"Branson, MO",1990,41,17,58,44899,1.29178823581817
14700,"Branson, MO",1991,46,54,100,46178,2.16553337086925
14700,"Branson, MO",1992,127,234,361,48430,7.45405740243651
14700,"Branson, MO",1993,127,382,509,51731,9.83936131139935
14700,"Branson, MO",1994,127,329,456,55029,8.2865398244562
14700,"Branson, MO",1995,328,614,942,57545,16.3697975497437
14700,"Branson, MO",1996,262,231,493,59354,8.30609562961216
14700,"Branson, MO",1997,211,186,397,60447,6.56773702582428
14700,"Branson, MO",1998,298,0,298,61312,4.86038622129436
14700,"Branson, MO",1999,239,330,569,63134,9.01257642474736
14700,"Branson, MO",2000,251,248,499,68659,7.26780174485501
14700,"Branson, MO",2001,335,102,437,69450,6.2922966162707
14700,"Branson, MO",2002,394,50,444,70901,6.2622530006629
14700,"Branson, MO",2003,438,136,574,72491,7.9182243312963
14700,"Branson, MO",2004,813,297,1110,73923,15.0156243658942
14700,"Branson, MO",2005,838,531,1369,75435,18.1480745012262
14700,"Branson, MO",2006,883,872,1755,77746,22.5735086049443
14700,"Branson, MO",2007,964,674,1638,79986,20.4785837521566
14700,"Branson, MO",2008,444,743,1187,81830,14.505682512526
14700,"Branson, MO",2009,333,728,1061,83008,12.781900539707
14700,"Branson, MO",2010,324,237,561,84148,6.66682511764986
14700,"Branson, MO",2011,180,108,288,84772,3.39734818100316
14700,"Branson, MO",2012,172,19,191,84801,2.25233193004799
14700,"Branson, MO",2013,203,182,385,84923,4.53351859920163
14700,"Branson, MO",2014,219,19,238,85267,2.79123224694196
14700,"Branson, MO",2015,252,6,258,85518,3.01690872097102
14700,"Branson, MO",2016,275,2,277,86065,3.21849764712717
14700,"Branson, MO",2017,336,36,372,86783,4.28655381814411
14700,"Branson, MO",2018,346,68,414,87601,4.72597344779169
14720,"Breckenridge, CO",1990,154,94,248,13066,18.9805602326649
14720,"Breckenridge, CO",1991,142,56,198,13658,14.4969980963538
14720,"Breckenridge, CO",1992,275,23,298,14442,20.6342611826617
14720,"Breckenridge, CO",1993,327,117,444,15270,29.0766208251473
14720,"Breckenridge, CO",1994,506,356,862,16230,53.1115218730746
14720,"Breckenridge, CO",1995,466,481,947,17208,55.0325430032543
14720,"Breckenridge, CO",1996,465,805,1270,17828,71.2362575723581
14720,"Breckenridge, CO",1997,521,406,927,18465,50.2030869212023
14720,"Breckenridge, CO",1998,492,670,1162,18772,61.9007031749414
14720,"Breckenridge, CO",1999,281,207,488,19607,24.8890702300199
14720,"Breckenridge, CO",2000,384,415,799,23700,33.7130801687764
14720,"Breckenridge, CO",2001,309,168,477,24716,19.2992393591196
14720,"Breckenridge, CO",2002,309,87,396,25006,15.8361993121651
14720,"Breckenridge, CO",2003,259,148,407,25408,16.0185768261965
14720,"Breckenridge, CO",2004,302,28,330,25313,13.0367795204045
14720,"Breckenridge, CO",2005,374,100,474,25487,18.5977164829129
14720,"Breckenridge, CO",2006,361,84,445,26019,17.102886352281
14720,"Breckenridge, CO",2007,323,137,460,26603,17.2912829380145
14720,"Breckenridge, CO",2008,196,159,355,27144,13.0783966990864
14720,"Breckenridge, CO",2009,65,13,78,27678,2.81812269672664
14720,"Breckenridge, CO",2010,92,25,117,28077,4.16711187092638
14720,"Breckenridge, CO",2011,116,38,154,28046,5.49097910575483
14720,"Breckenridge, CO",2012,115,24,139,28307,4.91044617939026
14720,"Breckenridge, CO",2013,179,100,279,28738,9.70840002783771
14720,"Breckenridge, CO",2014,171,36,207,29330,7.05762018411183
14720,"Breckenridge, CO",2015,154,41,195,30126,6.47281418044214
14720,"Breckenridge, CO",2016,241,65,306,30676,9.97522493154258
14720,"Breckenridge, CO",2017,393,82,475,31004,15.320603793059
14720,"Breckenridge, CO",2018,305,338,643,31007,20.7372528783823
14740,"Bremerton-Silverdale, WA",1990,1914,668,2582,191977,13.4495278080187
14740,"Bremerton-Silverdale, WA",1991,1735,839,2574,200144,12.8607402670078
14740,"Bremerton-Silverdale, WA",1992,1911,431,2342,210521,11.1247809007177
14740,"Bremerton-Silverdale, WA",1993,1571,667,2238,212662,10.5237419002925
14740,"Bremerton-Silverdale, WA",1994,1585,415,2000,216285,9.24705827958481
14740,"Bremerton-Silverdale, WA",1995,1280,274,1554,225793,6.88240999499542
14740,"Bremerton-Silverdale, WA",1996,1537,232,1769,229490,7.70839688003835
14740,"Bremerton-Silverdale, WA",1997,975,39,1014,232824,4.35522111122565
14740,"Bremerton-Silverdale, WA",1998,976,36,1012,232772,4.34760194525115
14740,"Bremerton-Silverdale, WA",1999,1128,20,1148,233778,4.91064171992232
14740,"Bremerton-Silverdale, WA",2000,1105,6,1111,232720,4.77397731179099
14740,"Bremerton-Silverdale, WA",2001,1126,12,1138,234513,4.85260945022238
14740,"Bremerton-Silverdale, WA",2002,1135,94,1229,238129,5.16106816053484
14740,"Bremerton-Silverdale, WA",2003,1376,84,1460,239758,6.08947355249877
14740,"Bremerton-Silverdale, WA",2004,1308,58,1366,241960,5.64556124979335
14740,"Bremerton-Silverdale, WA",2005,1300,311,1611,239806,6.71793032701434
14740,"Bremerton-Silverdale, WA",2006,1184,52,1236,245054,5.04378626751655
14740,"Bremerton-Silverdale, WA",2007,1239,131,1370,244105,5.61233895249995
14740,"Bremerton-Silverdale, WA",2008,682,101,783,246912,3.17117029548989
14740,"Bremerton-Silverdale, WA",2009,552,10,562,248800,2.2588424437299
14740,"Bremerton-Silverdale, WA",2010,468,155,623,251676,2.47540488564663
14740,"Bremerton-Silverdale, WA",2011,451,89,540,254281,2.12363487637692
14740,"Bremerton-Silverdale, WA",2012,634,170,804,254323,3.16133420886039
14740,"Bremerton-Silverdale, WA",2013,674,239,913,252403,3.61723117395594
14740,"Bremerton-Silverdale, WA",2014,519,79,598,253415,2.35976560187834
14740,"Bremerton-Silverdale, WA",2015,796,122,918,259320,3.54002776492365
14740,"Bremerton-Silverdale, WA",2016,862,197,1059,263283,4.0222878043778
14740,"Bremerton-Silverdale, WA",2017,952,142,1094,266550,4.10429562933783
14740,"Bremerton-Silverdale, WA",2018,903,246,1149,269805,4.25863123366876
14780,"Brenham, TX",1990,11,12,23,26136,0.880012243648607
14780,"Brenham, TX",1991,10,12,22,26091,0.84320263692461
14780,"Brenham, TX",1992,26,28,54,26585,2.0312206131277
14780,"Brenham, TX",1993,50,25,75,27134,2.76405985110931
14780,"Brenham, TX",1994,63,8,71,27652,2.56762621148561
14780,"Brenham, TX",1995,47,82,129,28055,4.59811085368027
14780,"Brenham, TX",1996,29,17,46,28369,1.62148824421023
14780,"Brenham, TX",1997,34,36,70,28765,2.43351294976534
14780,"Brenham, TX",1998,32,8,40,29083,1.37537392978716
14780,"Brenham, TX",1999,33,28,61,29047,2.10004475505216
14780,"Brenham, TX",2000,26,0,26,30423,0.854616572987542
14780,"Brenham, TX",2001,38,0,38,30433,1.24864456346729
14780,"Brenham, TX",2002,31,148,179,30741,5.82284245795517
14780,"Brenham, TX",2003,38,0,38,30995,1.22600419422487
14780,"Brenham, TX",2004,39,0,39,31330,1.2448132780083
14780,"Brenham, TX",2005,64,76,140,31710,4.41501103752759
14780,"Brenham, TX",2006,80,40,120,32199,3.72682381440417
14780,"Brenham, TX",2007,75,24,99,32434,3.05235246963063
14780,"Brenham, TX",2008,88,0,88,32869,2.67729471538532
14780,"Brenham, TX",2009,82,4,86,33459,2.57030993155803
14780,"Brenham, TX",2010,54,0,54,33703,1.60223125537786
14780,"Brenham, TX",2011,56,0,56,33955,1.64924164335149
14780,"Brenham, TX",2012,35,0,35,33928,1.03159632162226
14780,"Brenham, TX",2013,46,0,46,34201,1.34498991257566
14780,"Brenham, TX",2014,83,2,85,34404,2.47064294849436
14780,"Brenham, TX",2015,51,80,131,34833,3.76080153877071
14780,"Brenham, TX",2016,72,12,84,34736,2.41824044219254
14780,"Brenham, TX",2017,83,149,232,34897,6.64813594291773
14780,"Brenham, TX",2018,59,80,139,35108,3.95921157570924
14820,"Brevard, NC",1990,180,6,186,25536,7.28383458646617
14820,"Brevard, NC",1991,157,39,196,25713,7.62260335238984
14820,"Brevard, NC",1992,188,0,188,26014,7.22687783501192
14820,"Brevard, NC",1993,206,0,206,26533,7.76391663211849
14820,"Brevard, NC",1994,186,0,186,26905,6.91321315740569
14820,"Brevard, NC",1995,191,0,191,27061,7.05812793318798
14820,"Brevard, NC",1996,210,2,212,27525,7.70208900999092
14820,"Brevard, NC",1997,245,0,245,27879,8.78797661322142
14820,"Brevard, NC",1998,321,0,321,28452,11.2821594264024
14820,"Brevard, NC",1999,286,0,286,28706,9.96307392182819
14820,"Brevard, NC",2000,238,0,238,29416,8.09083491977155
14820,"Brevard, NC",2001,255,0,255,29619,8.60933860022283
14820,"Brevard, NC",2002,256,0,256,30009,8.530774101103
14820,"Brevard, NC",2003,246,0,246,30073,8.18009510191867
14820,"Brevard, NC",2004,241,0,241,30417,7.92320084163461
14820,"Brevard, NC",2005,289,34,323,30910,10.4496926560983
14820,"Brevard, NC",2006,233,0,233,31469,7.40411198322158
14820,"Brevard, NC",2007,236,0,236,32061,7.36096815445557
14820,"Brevard, NC",2008,152,0,152,32543,4.67074332421719
14820,"Brevard, NC",2009,76,0,76,32852,2.31340557652502
14820,"Brevard, NC",2010,98,62,160,33087,4.8357360897029
14820,"Brevard, NC",2011,62,0,62,32804,1.89001341299841
14820,"Brevard, NC",2012,73,0,73,32833,2.22337282612006
14820,"Brevard, NC",2013,59,40,99,32828,3.01571828926526
14820,"Brevard, NC",2014,65,0,65,32954,1.97244644049281
14820,"Brevard, NC",2015,82,0,82,33167,2.47233696143757
14820,"Brevard, NC",2016,104,0,104,33406,3.11321319523439
14820,"Brevard, NC",2017,112,0,112,33825,3.31116038433112
14820,"Brevard, NC",2018,120,8,128,34215,3.74104924740611
14860,"Bridgeport-Stamford-Norwalk, CT",1990,746,715,1461,827965,1.76456734282246
14860,"Bridgeport-Stamford-Norwalk, CT",1991,928,438,1366,828598,1.64856782179054
14860,"Bridgeport-Stamford-Norwalk, CT",1992,1215,160,1375,826276,1.66409286969487
14860,"Bridgeport-Stamford-Norwalk, CT",1993,1448,693,2141,827220,2.58818693938735
14860,"Bridgeport-Stamford-Norwalk, CT",1994,1717,612,2329,827127,2.81577073411943
14860,"Bridgeport-Stamford-Norwalk, CT",1995,1719,625,2344,829014,2.82745526613543
14860,"Bridgeport-Stamford-Norwalk, CT",1996,1635,345,1980,831637,2.38084645103573
14860,"Bridgeport-Stamford-Norwalk, CT",1997,1661,364,2025,834462,2.42671325956125
14860,"Bridgeport-Stamford-Norwalk, CT",1998,1897,1081,2978,838247,3.55265214191044
14860,"Bridgeport-Stamford-Norwalk, CT",1999,1758,585,2343,842717,2.7802927910556
14860,"Bridgeport-Stamford-Norwalk, CT",2000,1602,676,2278,884364,2.57586242768815
14860,"Bridgeport-Stamford-Norwalk, CT",2001,1521,699,2220,889063,2.49701089799036
14860,"Bridgeport-Stamford-Norwalk, CT",2002,1598,281,1879,892900,2.10437898980849
14860,"Bridgeport-Stamford-Norwalk, CT",2003,1550,414,1964,896342,2.19112794000504
14860,"Bridgeport-Stamford-Norwalk, CT",2004,1840,655,2495,897472,2.78003102046638
14860,"Bridgeport-Stamford-Norwalk, CT",2005,2054,1065,3119,897653,3.47461658346822
14860,"Bridgeport-Stamford-Norwalk, CT",2006,1480,459,1939,896254,2.1634492007846
14860,"Bridgeport-Stamford-Norwalk, CT",2007,1438,852,2290,897498,2.55153771930411
14860,"Bridgeport-Stamford-Norwalk, CT",2008,713,1101,1814,903824,2.00702791693958
14860,"Bridgeport-Stamford-Norwalk, CT",2009,476,723,1199,910421,1.31697313660383
14860,"Bridgeport-Stamford-Norwalk, CT",2010,546,380,926,919330,1.00725528373924
14860,"Bridgeport-Stamford-Norwalk, CT",2011,583,354,937,927897,1.00981035610633
14860,"Bridgeport-Stamford-Norwalk, CT",2012,634,1504,2138,935097,2.28639381796755
14860,"Bridgeport-Stamford-Norwalk, CT",2013,870,1631,2501,939991,2.66066377231271
14860,"Bridgeport-Stamford-Norwalk, CT",2014,987,902,1889,944355,2.00030708790656
14860,"Bridgeport-Stamford-Norwalk, CT",2015,800,1798,2598,945301,2.7483309549022
14860,"Bridgeport-Stamford-Norwalk, CT",2016,712,1191,1903,944802,2.01417863213668
14860,"Bridgeport-Stamford-Norwalk, CT",2017,765,954,1719,943457,1.82202262530248
14860,"Bridgeport-Stamford-Norwalk, CT",2018,753,344,1097,943823,1.16229420134919
15020,"Brookhaven, MS",1990,16,48,64,30293,2.11269930346945
15020,"Brookhaven, MS",1991,24,0,24,30434,0.788591706643885
15020,"Brookhaven, MS",1992,23,0,23,30797,0.746825989544436
15020,"Brookhaven, MS",1993,12,0,12,30978,0.387371683129963
15020,"Brookhaven, MS",1994,19,0,19,31160,0.609756097560976
15020,"Brookhaven, MS",1995,9,2,11,31297,0.351471387033901
15020,"Brookhaven, MS",1996,17,0,17,31378,0.541780865574606
15020,"Brookhaven, MS",1997,9,0,9,31586,0.284936364211993
15020,"Brookhaven, MS",1998,7,0,7,31783,0.220243526413491
15020,"Brookhaven, MS",1999,17,0,17,32011,0.531067445565587
15020,"Brookhaven, MS",2000,8,0,8,33163,0.241232699092362
15020,"Brookhaven, MS",2001,15,0,15,33188,0.451970591780161
15020,"Brookhaven, MS",2002,14,0,14,33326,0.420092420332473
15020,"Brookhaven, MS",2003,17,0,17,33407,0.50887538539827
15020,"Brookhaven, MS",2004,18,0,18,33490,0.53747387279785
15020,"Brookhaven, MS",2005,5,0,5,33748,0.148156927817945
15020,"Brookhaven, MS",2006,11,0,11,34248,0.321186638635833
15020,"Brookhaven, MS",2007,24,0,24,34398,0.697714983429269
15020,"Brookhaven, MS",2008,27,0,27,34724,0.777560188918327
15020,"Brookhaven, MS",2009,9,0,9,34877,0.25804971757892
15020,"Brookhaven, MS",2010,11,0,11,34901,0.315177215552563
15020,"Brookhaven, MS",2011,11,0,11,34870,0.315457413249211
15020,"Brookhaven, MS",2012,11,0,11,34848,0.315656565656566
15020,"Brookhaven, MS",2013,13,0,13,34728,0.374337710205022
15020,"Brookhaven, MS",2014,8,0,8,34739,0.230288724488327
15020,"Brookhaven, MS",2015,9,0,9,34524,0.260688216892596
15020,"Brookhaven, MS",2016,12,0,12,34373,0.349111221016496
15020,"Brookhaven, MS",2017,6,0,6,34320,0.174825174825175
15020,"Brookhaven, MS",2018,4,0,4,34205,0.116941967548604
15060,"Brookings, OR",1990,141,50,191,19449,9.82055632680343
15060,"Brookings, OR",1991,209,27,236,19662,12.0028481334554
15060,"Brookings, OR",1992,114,2,116,19892,5.83149004624975
15060,"Brookings, OR",1993,126,27,153,20385,7.50551876379691
15060,"Brookings, OR",1994,106,19,125,20724,6.0316541208261
15060,"Brookings, OR",1995,116,23,139,21017,6.61369367654756
15060,"Brookings, OR",1996,82,62,144,21032,6.84670977558007
15060,"Brookings, OR",1997,96,8,104,21069,4.93616213394086
15060,"Brookings, OR",1998,92,42,134,21090,6.35372214319583
15060,"Brookings, OR",1999,98,22,120,21198,5.66091140673648
15060,"Brookings, OR",2000,83,39,122,21133,5.7729617186391
15060,"Brookings, OR",2001,92,47,139,21250,6.54117647058824
15060,"Brookings, OR",2002,99,8,107,21653,4.94157853415231
15060,"Brookings, OR",2003,158,22,180,21899,8.21955340426504
15060,"Brookings, OR",2004,133,20,153,22473,6.80816980376452
15060,"Brookings, OR",2005,157,28,185,22750,8.13186813186813
15060,"Brookings, OR",2006,135,8,143,22626,6.32016264474498
15060,"Brookings, OR",2007,56,8,64,22447,2.85116051142692
15060,"Brookings, OR",2008,37,4,41,22305,1.83815288052006
15060,"Brookings, OR",2009,36,129,165,22341,7.38552437223043
15060,"Brookings, OR",2010,27,0,27,22378,1.20654213960139
15060,"Brookings, OR",2011,21,0,21,22486,0.933914435648848
15060,"Brookings, OR",2012,19,0,19,22257,0.853664015815249
15060,"Brookings, OR",2013,24,40,64,22225,2.87964004499438
15060,"Brookings, OR",2014,29,13,42,22140,1.8970189701897
15060,"Brookings, OR",2015,40,0,40,22296,1.7940437746681
15060,"Brookings, OR",2016,54,0,54,22611,2.38821812392198
15060,"Brookings, OR",2017,43,0,43,22676,1.89627800317516
15060,"Brookings, OR",2018,45,0,45,22813,1.97255950554508
15100,"Brookings, SD",1990,28,26,54,25238,2.13963071558761
15100,"Brookings, SD",1991,32,32,64,25170,2.54270957489074
15100,"Brookings, SD",1992,78,75,153,25480,6.00470957613815
15100,"Brookings, SD",1993,57,97,154,25880,5.95054095826893
15100,"Brookings, SD",1994,82,211,293,26267,11.1546807781627
15100,"Brookings, SD",1995,63,94,157,26345,5.95938508255836
15100,"Brookings, SD",1996,60,44,104,26106,3.98375852294492
15100,"Brookings, SD",1997,73,20,93,26147,3.55681340115501
15100,"Brookings, SD",1998,88,45,133,25957,5.12385868937088
15100,"Brookings, SD",1999,94,58,152,25974,5.85200585200585
15100,"Brookings, SD",2000,71,30,101,28342,3.56361583515631
15100,"Brookings, SD",2001,86,34,120,28565,4.20094521267285
15100,"Brookings, SD",2002,297,48,345,28913,11.9323487704493
15100,"Brookings, SD",2003,94,51,145,29171,4.97069006890405
15100,"Brookings, SD",2004,163,29,192,29393,6.5321675228796
15100,"Brookings, SD",2005,166,73,239,29485,8.10581651687299
15100,"Brookings, SD",2006,192,29,221,30323,7.28819707812552
15100,"Brookings, SD",2007,178,95,273,30831,8.85472414128637
15100,"Brookings, SD",2008,140,133,273,31363,8.70452443962631
15100,"Brookings, SD",2009,162,201,363,31729,11.4406379022345
15100,"Brookings, SD",2010,111,6,117,31995,3.65682137834037
15100,"Brookings, SD",2011,92,42,134,32133,4.17016774032926
15100,"Brookings, SD",2012,123,169,292,32764,8.91222073006959
15100,"Brookings, SD",2013,110,77,187,33011,5.6647784071976
15100,"Brookings, SD",2014,122,83,205,33248,6.1657844080847
15100,"Brookings, SD",2015,150,114,264,33796,7.8115753343591
15100,"Brookings, SD",2016,144,109,253,34250,7.38686131386861
15100,"Brookings, SD",2017,148,34,182,34668,5.24979808468905
15100,"Brookings, SD",2018,131,113,244,35232,6.92552225249773
15180,"Brownsville-Harlingen, TX",1990,641,24,665,261714,2.54094163858257
15180,"Brownsville-Harlingen, TX",1991,1009,121,1130,269185,4.19785649274662
15180,"Brownsville-Harlingen, TX",1992,1308,105,1413,277179,5.09778879352332
15180,"Brownsville-Harlingen, TX",1993,1486,250,1736,288085,6.02599927104848
15180,"Brownsville-Harlingen, TX",1994,1700,535,2235,297033,7.52441647897708
15180,"Brownsville-Harlingen, TX",1995,1642,383,2025,304573,6.64865237562095
15180,"Brownsville-Harlingen, TX",1996,1729,803,2532,311656,8.12434222347717
15180,"Brownsville-Harlingen, TX",1997,1602,355,1957,317780,6.15834854301718
15180,"Brownsville-Harlingen, TX",1998,1926,424,2350,323982,7.25348939138594
15180,"Brownsville-Harlingen, TX",1999,2017,522,2539,329629,7.70259898249244
15180,"Brownsville-Harlingen, TX",2000,2706,405,3111,336123,9.25554038253854
15180,"Brownsville-Harlingen, TX",2001,2713,381,3094,342368,9.0370595382746
15180,"Brownsville-Harlingen, TX",2002,3178,739,3917,350194,11.1852287589165
15180,"Brownsville-Harlingen, TX",2003,3124,320,3444,358492,9.60690894078529
15180,"Brownsville-Harlingen, TX",2004,3070,522,3592,366299,9.80619657711323
15180,"Brownsville-Harlingen, TX",2005,3069,625,3694,373429,9.89210800446671
15180,"Brownsville-Harlingen, TX",2006,2852,550,3402,380169,8.94865178381194
15180,"Brownsville-Harlingen, TX",2007,1728,363,2091,386306,5.41280746351338
15180,"Brownsville-Harlingen, TX",2008,1086,220,1306,393000,3.3231552162849902
15180,"Brownsville-Harlingen, TX",2009,939,166,1105,400303,2.76040899018993
15180,"Brownsville-Harlingen, TX",2010,1062,196,1258,407654,3.08595034023952
15180,"Brownsville-Harlingen, TX",2011,1053,83,1136,413291,2.74866861364027
15180,"Brownsville-Harlingen, TX",2012,1012,142,1154,416098,2.77338511600633
15180,"Brownsville-Harlingen, TX",2013,1090,173,1263,417705,3.02366502675333
15180,"Brownsville-Harlingen, TX",2014,1179,238,1417,419467,3.37809648911595
15180,"Brownsville-Harlingen, TX",2015,1129,156,1285,420058,3.05910136219284
15180,"Brownsville-Harlingen, TX",2016,1217,352,1569,422137,3.7168028388888
15180,"Brownsville-Harlingen, TX",2017,1139,106,1245,423181,2.94200353985647
15180,"Brownsville-Harlingen, TX",2018,1392,95,1487,423908,3.50783660605603
15220,"Brownwood, TX",1990,8,44,52,34306,1.51576983618026
15220,"Brownwood, TX",1991,20,2,22,34509,0.637514851198238
15220,"Brownwood, TX",1992,26,2,28,34243,0.817685366352247
15220,"Brownwood, TX",1993,28,2,30,34383,0.872524212546898
15220,"Brownwood, TX",1994,23,8,31,35220,0.880181714934696
15220,"Brownwood, TX",1995,22,12,34,36337,0.935685389547844
15220,"Brownwood, TX",1996,24,4,28,36540,0.766283524904215
15220,"Brownwood, TX",1997,25,54,79,36758,2.1491920126231
15220,"Brownwood, TX",1998,37,0,37,36920,1.00216684723727
15220,"Brownwood, TX",1999,12,72,84,37051,2.26714528622709
15220,"Brownwood, TX",2000,31,2,33,37689,0.875587041311789
15220,"Brownwood, TX",2001,13,8,21,37599,0.558525492699274
15220,"Brownwood, TX",2002,14,8,22,37766,0.582534554890642
15220,"Brownwood, TX",2003,10,80,90,37654,2.39018430976789
15220,"Brownwood, TX",2004,20,0,20,37940,0.527148128624143
15220,"Brownwood, TX",2005,41,86,127,38172,3.32704600230536
15220,"Brownwood, TX",2006,40,60,100,38492,2.59794242959576
15220,"Brownwood, TX",2007,33,0,33,38221,0.863399701734649
15220,"Brownwood, TX",2008,20,82,102,38135,2.67470827323981
15220,"Brownwood, TX",2009,14,0,14,38001,0.368411357595853
15220,"Brownwood, TX",2010,17,4,21,38078,0.55149955354798
15220,"Brownwood, TX",2011,28,0,28,37998,0.736880888467814
15220,"Brownwood, TX",2012,20,0,20,37811,0.528946602840443
15220,"Brownwood, TX",2013,21,38,59,37673,1.56610835346269
15220,"Brownwood, TX",2014,25,6,31,37555,0.825455997869791
15220,"Brownwood, TX",2015,66,60,126,37749,3.33783676388778
15220,"Brownwood, TX",2016,85,3,88,38074,2.31128854336293
15220,"Brownwood, TX",2017,146,134,280,37870,7.39371534195933
15220,"Brownwood, TX",2018,150,7,157,37924,4.13985866469782
15260,"Brunswick, GA",1990,354,81,435,82428,5.27733294511574
15260,"Brunswick, GA",1991,297,6,303,83260,3.63920249819841
15260,"Brunswick, GA",1992,296,0,296,84176,3.51644174111386
15260,"Brunswick, GA",1993,477,35,512,85503,5.98809398500637
15260,"Brunswick, GA",1994,484,156,640,86319,7.41435836837776
15260,"Brunswick, GA",1995,479,63,542,87305,6.20812095527175
15260,"Brunswick, GA",1996,578,83,661,88274,7.48804857602465
15260,"Brunswick, GA",1997,491,234,725,89697,8.08276753960556
15260,"Brunswick, GA",1998,561,282,843,90777,9.28649327472818
15260,"Brunswick, GA",1999,827,202,1029,91976,11.1877011394277
15260,"Brunswick, GA",2000,626,81,707,93344,7.57413438464176
15260,"Brunswick, GA",2001,740,8,748,95052,7.86937676219333
15260,"Brunswick, GA",2002,655,308,963,96612,9.96770587504658
15260,"Brunswick, GA",2003,762,76,838,98180,8.53534324709717
15260,"Brunswick, GA",2004,975,129,1104,99879,11.0533745832457
15260,"Brunswick, GA",2005,1197,80,1277,101532,12.5773155261395
15260,"Brunswick, GA",2006,1212,14,1226,104715,11.7079692498687
15260,"Brunswick, GA",2007,829,6,835,107334,7.77945478599512
15260,"Brunswick, GA",2008,502,0,502,109579,4.58116974967831
15260,"Brunswick, GA",2009,394,0,394,111343,3.53861491068141
15260,"Brunswick, GA",2010,404,0,404,112516,3.59060044793629
15260,"Brunswick, GA",2011,396,0,396,112865,3.50861648872547
15260,"Brunswick, GA",2012,464,0,464,113253,4.09702171244912
15260,"Brunswick, GA",2013,444,0,444,113762,3.90288497037675
15260,"Brunswick, GA",2014,462,0,462,114591,4.03173024059481
15260,"Brunswick, GA",2015,535,0,535,115822,4.61915698226589
15260,"Brunswick, GA",2016,526,0,526,116675,4.50824941075637
15260,"Brunswick, GA",2017,604,14,618,117728,5.24938842076651
15260,"Brunswick, GA",2018,640,12,652,118456,5.5041534409401
15340,"Bucyrus, OH",1990,29,0,29,47812,0.606542290638334
15340,"Bucyrus, OH",1991,56,52,108,47711,2.26362893253128
15340,"Bucyrus, OH",1992,62,0,62,47586,1.30290421552557
15340,"Bucyrus, OH",1993,55,47,102,47494,2.14763970185708
15340,"Bucyrus, OH",1994,87,0,87,47334,1.838002281658
15340,"Bucyrus, OH",1995,71,0,71,47375,1.49868073878628
15340,"Bucyrus, OH",1996,99,4,103,47346,2.17547416888438
15340,"Bucyrus, OH",1997,204,4,208,47207,4.40612621009596
15340,"Bucyrus, OH",1998,213,4,217,47162,4.60116195241932
15340,"Bucyrus, OH",1999,79,8,87,46914,1.85445709169971
15340,"Bucyrus, OH",2000,93,0,93,46827,1.98603369850727
15340,"Bucyrus, OH",2001,82,122,204,46533,4.38398555863581
15340,"Bucyrus, OH",2002,71,11,82,46271,1.7721683127661
15340,"Bucyrus, OH",2003,45,0,45,45928,0.979794460895314
15340,"Bucyrus, OH",2004,68,80,148,45776,3.23313526738902
15340,"Bucyrus, OH",2005,56,4,60,45536,1.31763879128602
15340,"Bucyrus, OH",2006,39,0,39,44907,0.868461487073285
15340,"Bucyrus, OH",2007,40,64,104,44634,2.33006228435722
15340,"Bucyrus, OH",2008,67,28,95,44291,2.14490528549818
15340,"Bucyrus, OH",2009,12,0,12,43921,0.273217822909314
15340,"Bucyrus, OH",2010,12,0,12,43754,0.274260639027289
15340,"Bucyrus, OH",2011,11,0,11,43306,0.25400637325082
15340,"Bucyrus, OH",2012,11,0,11,42774,0.257165567868331
15340,"Bucyrus, OH",2013,12,0,12,42712,0.280951489042892
15340,"Bucyrus, OH",2014,11,0,11,42406,0.25939725510541
15340,"Bucyrus, OH",2015,6,0,6,42320,0.141776937618147
15340,"Bucyrus, OH",2016,7,0,7,42090,0.166310287479211
15340,"Bucyrus, OH",2017,3,0,3,41741,0.0718717807431542
15340,"Bucyrus, OH",2018,8,0,8,41550,0.192539109506619
15380,"Buffalo-Cheektowaga-Niagara Falls, NY",1990,2770,870,3640,1190154,3.05842773288163
15380,"Buffalo-Cheektowaga-Niagara Falls, NY",1991,2131,586,2717,1191029,2.2812206923593
15380,"Buffalo-Cheektowaga-Niagara Falls, NY",1992,2430,1037,3467,1191332,2.91018792410512
15380,"Buffalo-Cheektowaga-Niagara Falls, NY",1993,2421,329,2750,1190412,2.31012456191638
15380,"Buffalo-Cheektowaga-Niagara Falls, NY",1994,2309,738,3047,1187002,2.56697124351939
15380,"Buffalo-Cheektowaga-Niagara Falls, NY",1995,2020,367,2387,1181310,2.02063810515445
15380,"Buffalo-Cheektowaga-Niagara Falls, NY",1996,1961,1012,2973,1174534,2.53121663570403
15380,"Buffalo-Cheektowaga-Niagara Falls, NY",1997,1661,1080,2741,1163612,2.35559619529534
15380,"Buffalo-Cheektowaga-Niagara Falls, NY",1998,1823,1059,2882,1153016,2.49953166304717
15380,"Buffalo-Cheektowaga-Niagara Falls, NY",1999,2014,650,2664,1144763,2.3271192377811
15380,"Buffalo-Cheektowaga-Niagara Falls, NY",2000,1903,769,2672,1169060,2.28559697534772
15380,"Buffalo-Cheektowaga-Niagara Falls, NY",2001,2116,668,2784,1165067,2.38956214535301
15380,"Buffalo-Cheektowaga-Niagara Falls, NY",2002,2481,479,2960,1161678,2.54803826878016
15380,"Buffalo-Cheektowaga-Niagara Falls, NY",2003,2395,530,2925,1159918,2.52172998436096
15380,"Buffalo-Cheektowaga-Niagara Falls, NY",2004,1856,654,2510,1156070,2.17114880586816
15380,"Buffalo-Cheektowaga-Niagara Falls, NY",2005,1690,406,2096,1148563,1.82488901348903
15380,"Buffalo-Cheektowaga-Niagara Falls, NY",2006,1473,550,2023,1141712,1.77190044424513
15380,"Buffalo-Cheektowaga-Niagara Falls, NY",2007,1388,544,1932,1137678,1.69819579881126
15380,"Buffalo-Cheektowaga-Niagara Falls, NY",2008,1017,527,1544,1136364,1.35871956520974
15380,"Buffalo-Cheektowaga-Niagara Falls, NY",2009,993,374,1367,1135377,1.20400536561864
15380,"Buffalo-Cheektowaga-Niagara Falls, NY",2010,1037,461,1498,1135622,1.31910089801008
15380,"Buffalo-Cheektowaga-Niagara Falls, NY",2011,790,525,1315,1135456,1.15812501761407
15380,"Buffalo-Cheektowaga-Niagara Falls, NY",2012,915,337,1252,1134590,1.10348231519756
15380,"Buffalo-Cheektowaga-Niagara Falls, NY",2013,1016,918,1934,1134993,1.70397526680781
15380,"Buffalo-Cheektowaga-Niagara Falls, NY",2014,1057,821,1878,1135116,1.65445646083748
15380,"Buffalo-Cheektowaga-Niagara Falls, NY",2015,992,685,1677,1132909,1.48026010915263
15380,"Buffalo-Cheektowaga-Niagara Falls, NY",2016,931,1033,1964,1130013,1.73803310227404
15380,"Buffalo-Cheektowaga-Niagara Falls, NY",2017,979,678,1657,1129660,1.46681302338757
15380,"Buffalo-Cheektowaga-Niagara Falls, NY",2018,975,478,1453,1130152,1.28566776858334
15420,"Burley, ID",1990,41,5,46,38989,1.17981994921645
15420,"Burley, ID",1991,60,0,60,39463,1.52041152471936
15420,"Burley, ID",1992,59,6,65,40258,1.61458592081077
15420,"Burley, ID",1993,100,38,138,40760,3.38567222767419
15420,"Burley, ID",1994,142,16,158,41333,3.82261147267317
15420,"Burley, ID",1995,78,68,146,41865,3.4873999761137
15420,"Burley, ID",1996,84,12,96,41881,2.29220887753397
15420,"Burley, ID",1997,113,22,135,41933,3.21942145804021
15420,"Burley, ID",1998,76,8,84,41583,2.02005627299618
15420,"Burley, ID",1999,90,10,100,41976,2.38231370306842
15420,"Burley, ID",2000,60,4,64,41496,1.54231733179102
15420,"Burley, ID",2001,70,2,72,41160,1.74927113702624
15420,"Burley, ID",2002,67,0,67,41046,1.63231496369926
15420,"Burley, ID",2003,84,0,84,40855,2.05605189083344
15420,"Burley, ID",2004,78,0,78,40490,1.92640158063719
15420,"Burley, ID",2005,96,0,96,40385,2.37712021790269
15420,"Burley, ID",2006,93,0,93,40327,2.30614724626181
15420,"Burley, ID",2007,110,0,110,40752,2.69925402434236
15420,"Burley, ID",2008,67,0,67,41527,1.61340814409902
15420,"Burley, ID",2009,42,0,42,42360,0.991501416430595
15420,"Burley, ID",2010,69,8,77,43162,1.78397664612391
15420,"Burley, ID",2011,77,12,89,43316,2.05466802105458
15420,"Burley, ID",2012,92,6,98,43426,2.25671256850735
15420,"Burley, ID",2013,99,16,115,43760,2.62797074954296
15420,"Burley, ID",2014,73,2,75,43866,1.70975242784845
15420,"Burley, ID",2015,134,36,170,43951,3.86794384655639
15420,"Burley, ID",2016,260,54,314,44148,7.11243997463079
15420,"Burley, ID",2017,284,52,336,44493,7.5517497134380704
15420,"Burley, ID",2018,135,14,149,44689,3.33415381861308
15460,"Burlington, IA-IL",1990,39,10,49,50717,0.966145473904214
15460,"Burlington, IA-IL",1991,32,62,94,50913,1.84628680297763
15460,"Burlington, IA-IL",1992,45,23,68,51123,1.3301253838781
15460,"Burlington, IA-IL",1993,55,0,55,51196,1.07430267989687
15460,"Burlington, IA-IL",1994,72,122,194,51065,3.79907960442573
15460,"Burlington, IA-IL",1995,89,0,89,51010,1.74475593020976
15460,"Burlington, IA-IL",1996,69,44,113,50870,2.2213485354826
15460,"Burlington, IA-IL",1997,60,8,68,50732,1.34037688244106
15460,"Burlington, IA-IL",1998,47,86,133,50639,2.6264341712909
15460,"Burlington, IA-IL",1999,52,18,70,50426,1.3881727680165
15460,"Burlington, IA-IL",2000,53,14,67,50425,1.32870599900843
15460,"Burlington, IA-IL",2001,50,8,58,49970,1.16069641785071
15460,"Burlington, IA-IL",2002,52,54,106,49216,2.1537711313394
15460,"Burlington, IA-IL",2003,103,4,107,48982,2.18447592993344
15460,"Burlington, IA-IL",2004,111,6,117,48474,2.41366505755663
15460,"Burlington, IA-IL",2005,84,52,136,48118,2.82638513653934
15460,"Burlington, IA-IL",2006,51,8,59,47806,1.23415470861398
15460,"Burlington, IA-IL",2007,60,0,60,47771,1.25599212911599
15460,"Burlington, IA-IL",2008,34,0,34,47698,0.712818147511426
15460,"Burlington, IA-IL",2009,45,0,45,47719,0.943020599761101
15460,"Burlington, IA-IL",2010,50,0,50,47584,1.05077336919973
15460,"Burlington, IA-IL",2011,20,0,20,47276,0.423047635163719
15460,"Burlington, IA-IL",2012,41,2,43,47268,0.90970635525091
15460,"Burlington, IA-IL",2013,44,6,50,47352,1.05592160837979
15460,"Burlington, IA-IL",2014,47,0,47,47103,0.997813302762032
15460,"Burlington, IA-IL",2015,53,0,53,46857,1.1311010094543
15460,"Burlington, IA-IL",2016,31,14,45,46474,0.968283341223049
15460,"Burlington, IA-IL",2017,24,16,40,46139,0.866945534146817
15460,"Burlington, IA-IL",2018,28,12,40,45847,0.872467118895457
15500,"Burlington, NC",1990,343,27,370,108516,3.40963544546426
15500,"Burlington, NC",1991,370,78,448,109852,4.07821432472782
15500,"Burlington, NC",1992,463,188,651,111161,5.85637048965015
15500,"Burlington, NC",1993,471,76,547,112244,4.87331171376644
15500,"Burlington, NC",1994,555,130,685,113558,6.03215977738248
15500,"Burlington, NC",1995,577,99,676,114752,5.8909648633575
15500,"Burlington, NC",1996,614,453,1067,116366,9.16934499767973
15500,"Burlington, NC",1997,654,572,1226,118096,10.3813846362282
15500,"Burlington, NC",1998,736,897,1633,119553,13.6592139051299
15500,"Burlington, NC",1999,817,71,888,121133,7.33078517001973
15500,"Burlington, NC",2000,872,73,945,131423,7.19052220691964
15500,"Burlington, NC",2001,889,61,950,133346,7.12432318929702
15500,"Burlington, NC",2002,1042,369,1411,135239,10.4333809034376
15500,"Burlington, NC",2003,1143,20,1163,136009,8.55090471954062
15500,"Burlington, NC",2004,1222,144,1366,137619,9.92595499167993
15500,"Burlington, NC",2005,1480,4,1484,139311,10.6524251494857
15500,"Burlington, NC",2006,1688,300,1988,141462,14.0532439807157
15500,"Burlington, NC",2007,1441,0,1441,144712,9.95770910498093
15500,"Burlington, NC",2008,704,56,760,147704,5.14542598710935
15500,"Burlington, NC",2009,441,120,561,149954,3.74114728516745
15500,"Burlington, NC",2010,443,404,847,151440,5.59297411516112
15500,"Burlington, NC",2011,399,157,556,152696,3.64122177398229
15500,"Burlington, NC",2012,358,0,358,153282,2.33556451507679
15500,"Burlington, NC",2013,553,8,561,154199,3.63815588946751
15500,"Burlington, NC",2014,593,13,606,155425,3.89898664950941
15500,"Burlington, NC",2015,736,296,1032,157100,6.56906429026098
15500,"Burlington, NC",2016,938,415,1353,160392,8.43558282208589
15500,"Burlington, NC",2017,1030,193,1223,163529,7.47879580991751
15500,"Burlington, NC",2018,1084,335,1419,166436,8.5257997067942
15540,"Burlington-South Burlington, VT",1990,617,69,686,177701,3.86041721768589
15540,"Burlington-South Burlington, VT",1991,659,71,730,179168,4.07438828362208
15540,"Burlington-South Burlington, VT",1992,736,237,973,180670,5.38550949244479
15540,"Burlington-South Burlington, VT",1993,859,136,995,183164,5.43229018802822
15540,"Burlington-South Burlington, VT",1994,789,203,992,186199,5.32763333852491
15540,"Burlington-South Burlington, VT",1995,737,158,895,188067,4.7589422918428
15540,"Burlington-South Burlington, VT",1996,762,109,871,189561,4.59482699500425
15540,"Burlington-South Burlington, VT",1997,614,108,722,191304,3.77409777108686
15540,"Burlington-South Burlington, VT",1998,688,231,919,192702,4.76902159811522
15540,"Burlington-South Burlington, VT",1999,856,244,1100,194771,5.64765801890425
15540,"Burlington-South Burlington, VT",2000,803,121,924,199600,4.62925851703407
15540,"Burlington-South Burlington, VT",2001,759,269,1028,201361,5.10525871444818
15540,"Burlington-South Burlington, VT",2002,627,495,1122,203052,5.52567815140949
15540,"Burlington-South Burlington, VT",2003,719,237,956,204201,4.68166169607397
15540,"Burlington-South Burlington, VT",2004,710,517,1227,205652,5.96638982358547
15540,"Burlington-South Burlington, VT",2005,668,196,864,206637,4.18124537231957
15540,"Burlington-South Burlington, VT",2006,576,168,744,207426,3.58682132423129
15540,"Burlington-South Burlington, VT",2007,446,271,717,208232,3.44327480886703
15540,"Burlington-South Burlington, VT",2008,291,217,508,209332,2.42676704947165
15540,"Burlington-South Burlington, VT",2009,282,311,593,210435,2.81797229548317
15540,"Burlington-South Burlington, VT",2010,325,260,585,211534,2.76551287263513
15540,"Burlington-South Burlington, VT",2011,301,380,681,213210,3.1940340509357
15540,"Burlington-South Burlington, VT",2012,361,286,647,213955,3.0240003739104
15540,"Burlington-South Burlington, VT",2013,381,377,758,214826,3.52843696759238
15540,"Burlington-South Burlington, VT",2014,368,338,706,215677,3.27341348405254
15540,"Burlington-South Burlington, VT",2015,357,559,916,217137,4.21853484205824
15540,"Burlington-South Burlington, VT",2016,350,511,861,217435,3.95980407938004
15540,"Burlington-South Burlington, VT",2017,384,486,870,218881,3.9747625422033
15540,"Burlington-South Burlington, VT",2018,447,717,1164,221083,5.26499097623969
15580,"Butte-Silver Bow, MT",1990,43,8,51,33894,1.50469109576916
15580,"Butte-Silver Bow, MT",1991,44,4,48,34044,1.4099400775467
15580,"Butte-Silver Bow, MT",1992,61,0,61,34227,1.78221871621819
15580,"Butte-Silver Bow, MT",1993,53,20,73,34615,2.10891232124801
15580,"Butte-Silver Bow, MT",1994,67,12,79,34693,2.27711642118007
15580,"Butte-Silver Bow, MT",1995,64,34,98,34569,2.8349098903642
15580,"Butte-Silver Bow, MT",1996,48,38,86,34527,2.49080429808556
15580,"Butte-Silver Bow, MT",1997,84,155,239,34369,6.95394105152899
15580,"Butte-Silver Bow, MT",1998,89,106,195,34575,5.63991323210412
15580,"Butte-Silver Bow, MT",1999,57,22,79,34047,2.32032190795077
15580,"Butte-Silver Bow, MT",2000,29,2,31,34571,0.896705331057823
15580,"Butte-Silver Bow, MT",2001,30,34,64,33882,1.88890856501977
15580,"Butte-Silver Bow, MT",2002,21,0,21,33636,0.624331073849447
15580,"Butte-Silver Bow, MT",2003,35,2,37,33474,1.10533548425644
15580,"Butte-Silver Bow, MT",2004,66,8,74,33416,2.21450802011013
15580,"Butte-Silver Bow, MT",2005,62,5,67,33414,2.00514754294607
15580,"Butte-Silver Bow, MT",2006,60,0,60,33441,1.79420471875841
15580,"Butte-Silver Bow, MT",2007,66,24,90,33489,2.68744961031981
15580,"Butte-Silver Bow, MT",2008,71,0,71,33812,2.09984620844671
15580,"Butte-Silver Bow, MT",2009,49,8,57,34008,1.67607621736062
15580,"Butte-Silver Bow, MT",2010,53,69,122,34233,3.56381269535244
15580,"Butte-Silver Bow, MT",2011,43,8,51,34405,1.4823426827496
15580,"Butte-Silver Bow, MT",2012,55,24,79,34477,2.29138266090437
15580,"Butte-Silver Bow, MT",2013,56,0,56,34580,1.61943319838057
15580,"Butte-Silver Bow, MT",2014,32,26,58,34758,1.6686805915185
15580,"Butte-Silver Bow, MT",2015,29,43,72,34691,2.07546625926033
15580,"Butte-Silver Bow, MT",2016,43,43,86,34714,2.47738664515757
15580,"Butte-Silver Bow, MT",2017,70,0,70,34915,2.00486896749248
15580,"Butte-Silver Bow, MT",2018,55,130,185,34993,5.28677164004229
15620,"Cadillac, MI",1990,145,5,150,38650,3.88098318240621
15620,"Cadillac, MI",1991,163,14,177,39136,4.52269010629599
15620,"Cadillac, MI",1992,186,0,186,39814,4.67172351434169
15620,"Cadillac, MI",1993,206,13,219,40547,5.40113941845266
15620,"Cadillac, MI",1994,272,7,279,41397,6.73961881295746
15620,"Cadillac, MI",1995,294,6,300,42000,7.14285714285714
15620,"Cadillac, MI",1996,314,18,332,42317,7.84554670699719
15620,"Cadillac, MI",1997,230,8,238,42766,5.56516859187205
15620,"Cadillac, MI",1998,244,6,250,43014,5.8120611893802
15620,"Cadillac, MI",1999,258,4,262,43738,5.99021445882299
15620,"Cadillac, MI",2000,251,68,319,45073,7.07740776074368
15620,"Cadillac, MI",2001,251,42,293,45416,6.45147084727849
15620,"Cadillac, MI",2002,274,35,309,45857,6.73833874871884
15620,"Cadillac, MI",2003,296,14,310,46530,6.66236836449602
15620,"Cadillac, MI",2004,291,4,295,46905,6.28930817610063
15620,"Cadillac, MI",2005,311,72,383,47357,8.08750554300315
15620,"Cadillac, MI",2006,195,84,279,47504,5.87318962613675
15620,"Cadillac, MI",2007,140,4,144,47659,3.02146499087266
15620,"Cadillac, MI",2008,90,0,90,47793,1.88312095913628
15620,"Cadillac, MI",2009,46,3,49,47556,1.03036420220372
15620,"Cadillac, MI",2010,55,3,58,47557,1.21958912462939
15620,"Cadillac, MI",2011,41,8,49,47541,1.03068929976231
15620,"Cadillac, MI",2012,36,9,45,47527,0.946830222820712
15620,"Cadillac, MI",2013,35,11,46,47537,0.967667290741948
15620,"Cadillac, MI",2014,50,14,64,47830,1.33807233953586
15620,"Cadillac, MI",2015,53,18,71,47778,1.48603959981581
15620,"Cadillac, MI",2016,46,20,66,48111,1.3718276485627
15620,"Cadillac, MI",2017,22,23,45,48287,0.931927848075051
15620,"Cadillac, MI",2018,77,18,95,48579,1.9555775129171
15660,"Calhoun, GA",1990,275,175,450,35204,12.7826383365527
15660,"Calhoun, GA",1991,239,16,255,35670,7.1488645920942
15660,"Calhoun, GA",1992,241,38,279,36222,7.70250124233891
15660,"Calhoun, GA",1993,269,8,277,37092,7.46791761026637
15660,"Calhoun, GA",1994,290,43,333,37658,8.84274257793829
15660,"Calhoun, GA",1995,349,35,384,38374,10.0067754208579
15660,"Calhoun, GA",1996,346,90,436,39208,11.1201795551928
15660,"Calhoun, GA",1997,421,150,571,40252,14.1856305276756
15660,"Calhoun, GA",1998,361,62,423,41131,10.284213853298
15660,"Calhoun, GA",1999,356,78,434,42048,10.3215372907154
15660,"Calhoun, GA",2000,375,174,549,44401,12.3645863831896
15660,"Calhoun, GA",2001,362,216,578,45757,12.631947024499
15660,"Calhoun, GA",2002,404,165,569,46939,12.1221159377064
15660,"Calhoun, GA",2003,466,38,504,48145,10.4683767784817
15660,"Calhoun, GA",2004,436,115,551,49426,11.1479787965848
15660,"Calhoun, GA",2005,474,103,577,50602,11.4027113552824
15660,"Calhoun, GA",2006,402,135,537,52161,10.295048024386
15660,"Calhoun, GA",2007,282,97,379,53409,7.09618229137411
15660,"Calhoun, GA",2008,117,42,159,54567,2.91384902963329
15660,"Calhoun, GA",2009,52,0,52,54945,0.946400946400946
15660,"Calhoun, GA",2010,33,0,33,55222,0.597587917858824
15660,"Calhoun, GA",2011,29,0,29,55478,0.522729730704063
15660,"Calhoun, GA",2012,32,0,32,55651,0.575012129162099
15660,"Calhoun, GA",2013,49,60,109,55731,1.95582350935745
15660,"Calhoun, GA",2014,60,3,63,55815,1.12872883633432
15660,"Calhoun, GA",2015,81,6,87,56329,1.54449750572529
15660,"Calhoun, GA",2016,98,5,103,56933,1.80914408163982
15660,"Calhoun, GA",2017,152,69,221,57187,3.86451466242328
15660,"Calhoun, GA",2018,182,16,198,57685,3.43243477507151
15680,"California-Lexington Park, MD",1990,559,195,754,76432,9.86497801967762
15680,"California-Lexington Park, MD",1991,592,204,796,78316,10.1639511721743
15680,"California-Lexington Park, MD",1992,588,167,755,79478,9.49948413397418
15680,"California-Lexington Park, MD",1993,580,0,580,78944,7.34698013781921
15680,"California-Lexington Park, MD",1994,583,62,645,79994,8.06310473285496
15680,"California-Lexington Park, MD",1995,712,8,720,80788,8.91221468534931
15680,"California-Lexington Park, MD",1996,842,2,844,82535,10.2259647422306
15680,"California-Lexington Park, MD",1997,866,6,872,85447,10.2051564127471
15680,"California-Lexington Park, MD",1998,920,146,1066,87627,12.1652002236754
15680,"California-Lexington Park, MD",1999,701,6,707,88640,7.97608303249097
15680,"California-Lexington Park, MD",2000,1043,120,1163,86498,13.445397581447
15680,"California-Lexington Park, MD",2001,545,4,549,87455,6.27751415013435
15680,"California-Lexington Park, MD",2002,814,100,914,89819,10.1760206637794
15680,"California-Lexington Park, MD",2003,850,244,1094,92333,11.8484182253366
15680,"California-Lexington Park, MD",2004,1096,288,1384,94900,14.5837723919916
15680,"California-Lexington Park, MD",2005,963,30,993,96871,10.2507458372475
15680,"California-Lexington Park, MD",2006,685,74,759,98849,7.6783781323028
15680,"California-Lexington Park, MD",2007,854,85,939,100599,9.33408880803984
15680,"California-Lexington Park, MD",2008,481,74,555,101921,5.44539398161321
15680,"California-Lexington Park, MD",2009,465,4,469,103273,4.54136124640516
15680,"California-Lexington Park, MD",2010,399,14,413,105762,3.90499423233297
15680,"California-Lexington Park, MD",2011,516,268,784,107558,7.28909053719853
15680,"California-Lexington Park, MD",2012,605,0,605,108805,5.56040623133128
15680,"California-Lexington Park, MD",2013,403,2,405,109228,3.70784048046289
15680,"California-Lexington Park, MD",2014,902,12,914,219852,4.15734221203355
15680,"California-Lexington Park, MD",2015,1252,30,1282,221930,5.77659622403461
15680,"California-Lexington Park, MD",2016,689,9,698,111689,6.24949636938284
15680,"California-Lexington Park, MD",2017,1164,0,1164,112413,10.3546742814443
15680,"California-Lexington Park, MD",2018,871,60,931,112664,8.26350919548392
15700,"Cambridge, MD",1990,142,32,174,30250,5.75206611570248
15700,"Cambridge, MD",1991,111,62,173,30131,5.74159503501377
15700,"Cambridge, MD",1992,119,0,119,30232,3.93622651495105
15700,"Cambridge, MD",1993,116,32,148,30286,4.88674635144951
15700,"Cambridge, MD",1994,114,12,126,30169,4.17647253803573
15700,"Cambridge, MD",1995,131,0,131,29867,4.38611176214551
15700,"Cambridge, MD",1996,82,32,114,29932,3.80863290124282
15700,"Cambridge, MD",1997,100,0,100,29886,3.3460483169377
15700,"Cambridge, MD",1998,92,24,116,29559,3.92435468046957
15700,"Cambridge, MD",1999,94,0,94,29605,3.17513933457186
15700,"Cambridge, MD",2000,109,0,109,30581,3.56430463359602
15700,"Cambridge, MD",2001,117,0,117,30647,3.81766567690149
15700,"Cambridge, MD",2002,179,0,179,30526,5.86385376400446
15700,"Cambridge, MD",2003,285,2,287,30628,9.3705106438553
15700,"Cambridge, MD",2004,363,60,423,31086,13.6074116965837
15700,"Cambridge, MD",2005,338,152,490,31422,15.5941696900261
15700,"Cambridge, MD",2006,274,126,400,31677,12.6274584083089
15700,"Cambridge, MD",2007,95,30,125,32172,3.88536615690663
15700,"Cambridge, MD",2008,153,96,249,32466,7.66956200332656
15700,"Cambridge, MD",2009,52,41,93,32470,2.86418232214352
15700,"Cambridge, MD",2010,60,96,156,32688,4.77239353891336
15700,"Cambridge, MD",2011,52,0,52,32694,1.59050590322383
15700,"Cambridge, MD",2012,25,54,79,32473,2.43279031811043
15700,"Cambridge, MD",2013,36,0,36,32559,1.10568506403759
15700,"Cambridge, MD",2014,27,0,27,32495,0.830897061086321
15700,"Cambridge, MD",2015,36,0,36,32404,1.11097395383286
15700,"Cambridge, MD",2016,40,41,81,32261,2.5107715197917
15700,"Cambridge, MD",2017,41,2,43,32145,1.33768859853788
15700,"Cambridge, MD",2018,52,2,54,31998,1.68760547534221
15740,"Cambridge, OH",1990,43,0,43,38987,1.1029317464796
15740,"Cambridge, OH",1991,61,0,61,39178,1.55699627341876
15740,"Cambridge, OH",1992,87,0,87,39342,2.21137715418637
15740,"Cambridge, OH",1993,82,5,87,39417,2.20716949539539
15740,"Cambridge, OH",1994,86,0,86,39797,2.1609669070533
15740,"Cambridge, OH",1995,89,0,89,40182,2.21492210442487
15740,"Cambridge, OH",1996,93,0,93,40480,2.29743083003953
15740,"Cambridge, OH",1997,102,2,104,40629,2.55974796327746
15740,"Cambridge, OH",1998,106,0,106,40901,2.59162367668272
15740,"Cambridge, OH",1999,107,0,107,40940,2.61358085002443
15740,"Cambridge, OH",2000,84,0,84,40803,2.05867215645908
15740,"Cambridge, OH",2001,83,0,83,40860,2.03132648066569
15740,"Cambridge, OH",2002,93,4,97,40991,2.36637310629163
15740,"Cambridge, OH",2003,61,0,61,41138,1.48281394331275
15740,"Cambridge, OH",2004,61,0,61,40965,1.4890760405224
15740,"Cambridge, OH",2005,72,2,74,40752,1.81586179819395
15740,"Cambridge, OH",2006,72,0,72,40600,1.77339901477832
15740,"Cambridge, OH",2007,57,0,57,40531,1.40633095655178
15740,"Cambridge, OH",2008,46,0,46,40347,1.14010954965673
15740,"Cambridge, OH",2009,37,0,37,40242,0.919437403707569
15740,"Cambridge, OH",2010,28,0,28,40142,0.69752379054357
15740,"Cambridge, OH",2011,28,0,28,39902,0.70171921206957
15740,"Cambridge, OH",2012,39,3,42,39871,1.05339720598932
15740,"Cambridge, OH",2013,42,0,42,39703,1.05785457018361
15740,"Cambridge, OH",2014,49,5,54,39689,1.36057849782055
15740,"Cambridge, OH",2015,28,10,38,39386,0.964809830904382
15740,"Cambridge, OH",2016,34,0,34,39201,0.867324813142522
15740,"Cambridge, OH",2017,35,0,35,39071,0.895805072816155
15740,"Cambridge, OH",2018,39,0,39,39022,0.999436215468197
15780,"Camden, AR",1990,15,0,15,36198,0.41438753522294
15780,"Camden, AR",1991,8,57,65,35619,1.82486874982453
15780,"Camden, AR",1992,11,32,43,35298,1.21819933140688
15780,"Camden, AR",1993,10,0,10,35019,0.285559267826037
15780,"Camden, AR",1994,9,0,9,34775,0.258806613946801
15780,"Camden, AR",1995,12,0,12,34287,0.349986875492169
15780,"Camden, AR",1996,17,0,17,33928,0.50106107050224
15780,"Camden, AR",1997,13,0,13,33755,0.385128129166049
15780,"Camden, AR",1998,10,0,10,33526,0.298275964922746
15780,"Camden, AR",1999,15,0,15,33239,0.45127711423328
15780,"Camden, AR",2000,10,0,10,34386,0.290816029779561
15780,"Camden, AR",2001,2,0,2,33687,0.0593700834149672
15780,"Camden, AR",2002,6,0,6,33356,0.179877683175441
15780,"Camden, AR",2003,6,0,6,33134,0.181082875596064
15780,"Camden, AR",2004,11,0,11,32698,0.336412012967154
15780,"Camden, AR",2005,10,0,10,32609,0.306663804471158
15780,"Camden, AR",2006,6,0,6,32349,0.185477139942502
15780,"Camden, AR",2007,7,0,7,32107,0.218020992306974
15780,"Camden, AR",2008,9,0,9,31730,0.283643239836117
15780,"Camden, AR",2009,4,0,4,31445,0.127206233105422
15780,"Camden, AR",2010,7,0,7,31409,0.222866057499443
15780,"Camden, AR",2011,8,0,8,30980,0.25823111684958
15780,"Camden, AR",2012,2,0,2,30679,0.0651911731151602
15780,"Camden, AR",2013,0,0,0,30145,0
15780,"Camden, AR",2014,3,0,3,29931,0.100230530219505
15780,"Camden, AR",2015,4,0,4,29522,0.135492175326875
15780,"Camden, AR",2016,6,0,6,29157,0.205782487910279
15780,"Camden, AR",2017,6,0,6,29048,0.2065546681355
15780,"Camden, AR",2018,2,0,2,28883,0.069244884534155
15820,"Campbellsville, KY",1990,17,32,49,21176,2.31394030978466
15820,"Campbellsville, KY",1991,15,22,37,21401,1.72889117330966
15820,"Campbellsville, KY",1992,27,55,82,21729,3.77375857149432
15820,"Campbellsville, KY",1993,27,74,101,22035,4.5836169729975
15820,"Campbellsville, KY",1994,21,22,43,22341,1.92471241215702
15820,"Campbellsville, KY",1995,21,0,21,22594,0.929450296538904
15820,"Campbellsville, KY",1996,24,2,26,22703,1.14522309826895
15820,"Campbellsville, KY",1997,12,4,16,22863,0.699820670953068
15820,"Campbellsville, KY",1998,11,2,13,22952,0.566399442314395
15820,"Campbellsville, KY",1999,6,9,15,22882,0.655537103400052
15820,"Campbellsville, KY",2000,8,0,8,22874,0.349742065226895
15820,"Campbellsville, KY",2001,8,4,12,22918,0.523605899293132
15820,"Campbellsville, KY",2002,4,7,11,23338,0.471334304567658
15820,"Campbellsville, KY",2003,8,4,12,23388,0.513083632632119
15820,"Campbellsville, KY",2004,7,61,68,23536,2.88919102651258
15820,"Campbellsville, KY",2005,8,28,36,23755,1.51547042727847
15820,"Campbellsville, KY",2006,29,2,31,23971,1.29322931876017
15820,"Campbellsville, KY",2007,33,6,39,24078,1.61973585846001
15820,"Campbellsville, KY",2008,18,4,22,24256,0.906992084432718
15820,"Campbellsville, KY",2009,2,27,29,24367,1.19013419789059
15820,"Campbellsville, KY",2010,12,35,47,24664,1.90561141745053
15820,"Campbellsville, KY",2011,12,47,59,24985,2.36141685011007
15820,"Campbellsville, KY",2012,55,0,55,25071,2.19376969406884
15820,"Campbellsville, KY",2013,4,16,20,25162,0.79484937604324
15820,"Campbellsville, KY",2014,27,0,27,25362,1.06458481192335
15820,"Campbellsville, KY",2015,18,2,20,25583,0.781769143571903
15820,"Campbellsville, KY",2016,10,7,17,25442,0.668186463328355
15820,"Campbellsville, KY",2017,5,5,10,25562,0.391205695954933
15820,"Campbellsville, KY",2018,5,0,5,25549,0.195702375826843
15860,"CaÃ±on City, CO",1990,82,50,132,32236,4.09480084377714
15860,"CaÃ±on City, CO",1991,83,0,83,32263,2.57260639122214
15860,"CaÃ±on City, CO",1992,170,2,172,32959,5.2186049334021
15860,"CaÃ±on City, CO",1993,206,4,210,35831,5.86084675281181
15860,"CaÃ±on City, CO",1994,270,14,284,38566,7.36399937769019
15860,"CaÃ±on City, CO",1995,294,42,336,40747,8.2460058409208
15860,"CaÃ±on City, CO",1996,235,6,241,42065,5.72922857482468
15860,"CaÃ±on City, CO",1997,314,13,327,43105,7.58612689943162
15860,"CaÃ±on City, CO",1998,332,24,356,44187,8.05666825084301
15860,"CaÃ±on City, CO",1999,396,20,416,44703,9.30586314117621
15860,"CaÃ±on City, CO",2000,377,8,385,46245,8.32522434857822
15860,"CaÃ±on City, CO",2001,362,8,370,46633,7.93429545600755
15860,"CaÃ±on City, CO",2002,242,4,246,47019,5.23192751866267
15860,"CaÃ±on City, CO",2003,253,51,304,46901,6.48173812925098
15860,"CaÃ±on City, CO",2004,221,0,221,46605,4.74198047419805
15860,"CaÃ±on City, CO",2005,263,10,273,46641,5.85321927059883
15860,"CaÃ±on City, CO",2006,250,0,250,46873,5.33356089859834
15860,"CaÃ±on City, CO",2007,143,20,163,46959,3.47111309866053
15860,"CaÃ±on City, CO",2008,90,6,96,47166,2.03536445744816
15860,"CaÃ±on City, CO",2009,46,0,46,46871,0.981417080924239
15860,"CaÃ±on City, CO",2010,53,0,53,46835,1.13163232625173
15860,"CaÃ±on City, CO",2011,46,0,46,47379,0.970894278055679
15860,"CaÃ±on City, CO",2012,50,2,52,47060,1.10497237569061
15860,"CaÃ±on City, CO",2013,51,2,53,46310,1.14446123947312
15860,"CaÃ±on City, CO",2014,55,0,55,46133,1.19220514599094
15860,"CaÃ±on City, CO",2015,54,0,54,46267,1.16713856528411
15860,"CaÃ±on City, CO",2016,85,0,85,46982,1.80920352475416
15860,"CaÃ±on City, CO",2017,87,32,119,47607,2.49963240699897
15860,"CaÃ±on City, CO",2018,127,10,137,48021,2.85291851481643
15900,"Canton, IL",1990,38,2,40,38084,1.05030984140321
15900,"Canton, IL",1991,36,20,56,38220,1.46520146520147
15900,"Canton, IL",1992,52,2,54,38409,1.40592048738577
15900,"Canton, IL",1993,59,2,61,38418,1.58779738664168
15900,"Canton, IL",1994,63,4,67,38475,1.74139051332034
15900,"Canton, IL",1995,58,0,58,38589,1.5030189950504
15900,"Canton, IL",1996,65,24,89,39016,2.28111543981956
15900,"Canton, IL",1997,80,26,106,38820,2.73055126223596
15900,"Canton, IL",1998,83,12,95,38687,2.45560524207098
15900,"Canton, IL",1999,87,0,87,38696,2.24829439735373
15900,"Canton, IL",2000,73,0,73,38216,1.91019468285535
15900,"Canton, IL",2001,71,0,71,37880,1.87434002111932
15900,"Canton, IL",2002,69,0,69,37587,1.83574108069279
15900,"Canton, IL",2003,65,0,65,37705,1.72390929584936
15900,"Canton, IL",2004,68,2,70,37630,1.86021791124103
15900,"Canton, IL",2005,95,2,97,37452,2.58998184342625
15900,"Canton, IL",2006,83,0,83,37387,2.22002300264798
15900,"Canton, IL",2007,61,0,61,37272,1.63661729984975
15900,"Canton, IL",2008,49,0,49,37224,1.3163550397593
15900,"Canton, IL",2009,30,2,32,37090,0.862766244270693
15900,"Canton, IL",2010,32,0,32,37074,0.863138587689486
15900,"Canton, IL",2011,39,0,39,36907,1.05671010919338
15900,"Canton, IL",2012,46,40,86,36585,2.3506901735684
15900,"Canton, IL",2013,32,2,34,36322,0.936071802213534
15900,"Canton, IL",2014,44,0,44,35990,1.22256182272854
15900,"Canton, IL",2015,55,0,55,35707,1.54031422410172
15900,"Canton, IL",2016,56,0,56,35455,1.57946692991116
15900,"Canton, IL",2017,39,21,60,35095,1.70964524861091
15900,"Canton, IL",2018,45,0,45,34844,1.29147055447136
15940,"Canton-Massillon, OH",1990,880,376,1256,394485,3.18389799358657
15940,"Canton-Massillon, OH",1991,867,539,1406,396415,3.54678808824086
15940,"Canton-Massillon, OH",1992,944,178,1122,398292,2.81702871260281
15940,"Canton-Massillon, OH",1993,1068,372,1440,400494,3.59555948403721
15940,"Canton-Massillon, OH",1994,1026,297,1323,401515,3.29502011132834
15940,"Canton-Massillon, OH",1995,995,233,1228,402336,3.05217529626978
15940,"Canton-Massillon, OH",1996,1061,169,1230,402836,3.05335173619041
15940,"Canton-Massillon, OH",1997,1039,312,1351,402681,3.35501302519861
15940,"Canton-Massillon, OH",1998,1193,216,1409,402163,3.50355452888505
15940,"Canton-Massillon, OH",1999,1342,143,1485,402475,3.68967016584881
15940,"Canton-Massillon, OH",2000,1201,78,1279,406887,3.1433788742329
15940,"Canton-Massillon, OH",2001,1010,122,1132,406256,2.78642038517585
15940,"Canton-Massillon, OH",2002,1235,165,1400,406039,3.44794465556264
15940,"Canton-Massillon, OH",2003,1437,119,1556,406046,3.83207813893007
15940,"Canton-Massillon, OH",2004,1400,126,1526,405960,3.75899103359937
15940,"Canton-Massillon, OH",2005,1257,152,1409,405168,3.47756979820716
15940,"Canton-Massillon, OH",2006,946,64,1010,405343,2.49171689162018
15940,"Canton-Massillon, OH",2007,618,110,728,405939,1.79337289592771
15940,"Canton-Massillon, OH",2008,352,84,436,406140,1.07352144580686
15940,"Canton-Massillon, OH",2009,296,64,360,405127,0.888610238270962
15940,"Canton-Massillon, OH",2010,308,144,452,404212,1.11822508980436
15940,"Canton-Massillon, OH",2011,211,45,256,403295,0.634771073283824
15940,"Canton-Massillon, OH",2012,354,117,471,403416,1.16752929977988
15940,"Canton-Massillon, OH",2013,495,141,636,403367,1.576727892961
15940,"Canton-Massillon, OH",2014,404,147,551,403696,1.3648884308985
15940,"Canton-Massillon, OH",2015,405,153,558,402428,1.38658343852813
15940,"Canton-Massillon, OH",2016,458,96,554,401069,1.38130845315893
15940,"Canton-Massillon, OH",2017,445,80,525,399418,1.31441247014406
15940,"Canton-Massillon, OH",2018,413,115,528,398655,1.32445347480905
15980,"Cape Coral-Fort Myers, FL",1990,3383,1532,4915,338275,14.5295986992831
15980,"Cape Coral-Fort Myers, FL",1991,2728,645,3373,347267,9.7129874131432
15980,"Cape Coral-Fort Myers, FL",1992,3022,987,4009,352694,11.3667938779792
15980,"Cape Coral-Fort Myers, FL",1993,3672,1656,5328,358637,14.8562474033633
15980,"Cape Coral-Fort Myers, FL",1994,3736,1580,5316,367084,14.4816990116704
15980,"Cape Coral-Fort Myers, FL",1995,3028,1974,5002,374313,13.3631479537179
15980,"Cape Coral-Fort Myers, FL",1996,3677,2033,5710,379499,15.0461529542897
15980,"Cape Coral-Fort Myers, FL",1997,3534,2359,5893,385717,15.2780406360103
15980,"Cape Coral-Fort Myers, FL",1998,3995,4050,8045,392666,20.4881502345505
15980,"Cape Coral-Fort Myers, FL",1999,4722,4094,8816,398585,22.1182432856229
15980,"Cape Coral-Fort Myers, FL",2000,5152,3968,9120,444311,20.5261629804349
15980,"Cape Coral-Fort Myers, FL",2001,6534,4425,10959,461037,23.7703264596985
15980,"Cape Coral-Fort Myers, FL",2002,7149,3997,11146,478889,23.2747045766347
15980,"Cape Coral-Fort Myers, FL",2003,9668,6007,15675,497662,31.4972812872994
15980,"Cape Coral-Fort Myers, FL",2004,14958,5437,20395,522431,39.0386481659779
15980,"Cape Coral-Fort Myers, FL",2005,22211,7119,29330,555029,52.8440856243548
15980,"Cape Coral-Fort Myers, FL",2006,14700,4046,18746,582678,32.172143104768
15980,"Cape Coral-Fort Myers, FL",2007,4356,1549,5905,604716,9.76491443917475
15980,"Cape Coral-Fort Myers, FL",2008,1216,386,1602,610984,2.6219999214382
15980,"Cape Coral-Fort Myers, FL",2009,906,38,944,612297,1.5417354649786
15980,"Cape Coral-Fort Myers, FL",2010,1175,101,1276,620454,2.05655858452037
15980,"Cape Coral-Fort Myers, FL",2011,1262,325,1587,631031,2.5149319130122
15980,"Cape Coral-Fort Myers, FL",2012,1806,237,2043,644243,3.17116367581798
15980,"Cape Coral-Fort Myers, FL",2013,2531,645,3176,659920,4.81270457025094
15980,"Cape Coral-Fort Myers, FL",2014,3112,983,4095,677361,6.04552077843277
15980,"Cape Coral-Fort Myers, FL",2015,3819,3060,6879,699530,9.83374551484568
15980,"Cape Coral-Fort Myers, FL",2016,4092,1325,5417,722386,7.49876105018647
15980,"Cape Coral-Fort Myers, FL",2017,4841,2113,6954,739506,9.40357481886557
15980,"Cape Coral-Fort Myers, FL",2018,5803,3918,9721,754610,12.8821510449106
16020,"Cape Girardeau, MO-IL",1990,123,126,249,83014,2.99949406124268
16020,"Cape Girardeau, MO-IL",1991,228,26,254,83772,3.03203934488851
16020,"Cape Girardeau, MO-IL",1992,257,24,281,84896,3.30993215228044
16020,"Cape Girardeau, MO-IL",1993,303,109,412,85475,4.82012284293653
16020,"Cape Girardeau, MO-IL",1994,250,108,358,85831,4.17098717246682
16020,"Cape Girardeau, MO-IL",1995,169,179,348,86536,4.02144772117962
16020,"Cape Girardeau, MO-IL",1996,193,86,279,87311,3.19547365165901
16020,"Cape Girardeau, MO-IL",1997,146,37,183,87486,2.09176325354914
16020,"Cape Girardeau, MO-IL",1998,209,119,328,87786,3.73635887271319
16020,"Cape Girardeau, MO-IL",1999,188,220,408,88992,4.58468176914779
16020,"Cape Girardeau, MO-IL",2000,154,180,334,90527,3.68950699791223
16020,"Cape Girardeau, MO-IL",2001,156,48,204,91226,2.23620459079648
16020,"Cape Girardeau, MO-IL",2002,162,47,209,91694,2.27932034811438
16020,"Cape Girardeau, MO-IL",2003,156,75,231,91840,2.51524390243902
16020,"Cape Girardeau, MO-IL",2004,182,56,238,92734,2.56648047102465
16020,"Cape Girardeau, MO-IL",2005,188,66,254,93173,2.72611164178464
16020,"Cape Girardeau, MO-IL",2006,141,99,240,94167,2.54866354455382
16020,"Cape Girardeau, MO-IL",2007,164,30,194,94616,2.05039316817452
16020,"Cape Girardeau, MO-IL",2008,84,42,126,95031,1.32588313287243
16020,"Cape Girardeau, MO-IL",2009,66,88,154,95634,1.61030595813205
16020,"Cape Girardeau, MO-IL",2010,73,26,99,96449,1.02644921150038
16020,"Cape Girardeau, MO-IL",2011,94,28,122,96971,1.25810809417248
16020,"Cape Girardeau, MO-IL",2012,127,103,230,97208,2.3660604065509
16020,"Cape Girardeau, MO-IL",2013,127,84,211,97175,2.1713403653203
16020,"Cape Girardeau, MO-IL",2014,163,24,187,97408,1.91976018396846
16020,"Cape Girardeau, MO-IL",2015,119,60,179,97314,1.83940645744703
16020,"Cape Girardeau, MO-IL",2016,132,40,172,97108,1.77122379206656
16020,"Cape Girardeau, MO-IL",2017,260,338,598,96873,6.17303066902026
16020,"Cape Girardeau, MO-IL",2018,131,685,816,96982,8.41393248231631
16060,"Carbondale-Marion, IL",1990,114,121,235,118773,1.97856415178534
16060,"Carbondale-Marion, IL",1991,111,62,173,118593,1.45877075375444
16060,"Carbondale-Marion, IL",1992,122,59,181,119773,1.51119200487589
16060,"Carbondale-Marion, IL",1993,164,83,247,120946,2.04223372414135
16060,"Carbondale-Marion, IL",1994,156,113,269,121486,2.21424690910887
16060,"Carbondale-Marion, IL",1995,181,130,311,121591,2.55775509700553
16060,"Carbondale-Marion, IL",1996,166,199,365,121578,3.00218789583642
16060,"Carbondale-Marion, IL",1997,177,152,329,121891,2.69913283179234
16060,"Carbondale-Marion, IL",1998,176,16,192,121781,1.5766006191442
16060,"Carbondale-Marion, IL",1999,156,219,375,121621,3.08334909267314
16060,"Carbondale-Marion, IL",2000,180,77,257,120912,2.12551276961757
16060,"Carbondale-Marion, IL",2001,187,78,265,121267,2.18526062325282
16060,"Carbondale-Marion, IL",2002,202,203,405,121086,3.34473019176453
16060,"Carbondale-Marion, IL",2003,206,271,477,121792,3.9165133998949
16060,"Carbondale-Marion, IL",2004,329,140,469,122841,3.81794352048583
16060,"Carbondale-Marion, IL",2005,284,179,463,123881,3.73745772152307
16060,"Carbondale-Marion, IL",2006,291,573,864,124594,6.93452333178163
16060,"Carbondale-Marion, IL",2007,256,399,655,124719,5.25180606002293
16060,"Carbondale-Marion, IL",2008,99,294,393,125279,3.13699821997302
16060,"Carbondale-Marion, IL",2009,195,134,329,125893,2.61333036785206
16060,"Carbondale-Marion, IL",2010,89,104,193,126808,1.52198599457447
16060,"Carbondale-Marion, IL",2011,91,197,288,127091,2.2660927996475
16060,"Carbondale-Marion, IL",2012,150,155,305,125837,2.42377043317943
16060,"Carbondale-Marion, IL",2013,93,107,200,127204,1.57227760133329
16060,"Carbondale-Marion, IL",2014,86,159,245,126769,1.93264914923996
16060,"Carbondale-Marion, IL",2015,78,59,137,126685,1.08142242570154
16060,"Carbondale-Marion, IL",2016,90,46,136,126256,1.07717653022431
16060,"Carbondale-Marion, IL",2017,83,47,130,125065,1.03945948106984
16060,"Carbondale-Marion, IL",2018,196,42,238,124475,1.91203052821852
16100,"Carlsbad-Artesia, NM",1990,41,0,41,48743,0.841146421024557
16100,"Carlsbad-Artesia, NM",1991,41,2,43,49894,0.861827073395599
16100,"Carlsbad-Artesia, NM",1992,57,2,59,51245,1.15133183725241
16100,"Carlsbad-Artesia, NM",1993,82,0,82,52175,1.57163392429324
16100,"Carlsbad-Artesia, NM",1994,74,48,122,52818,2.30981862243932
16100,"Carlsbad-Artesia, NM",1995,49,4,53,52903,1.00183354441147
16100,"Carlsbad-Artesia, NM",1996,75,0,75,53084,1.41285509758119
16100,"Carlsbad-Artesia, NM",1997,50,0,50,53148,0.940769172875743
16100,"Carlsbad-Artesia, NM",1998,70,60,130,53514,2.42927084501252
16100,"Carlsbad-Artesia, NM",1999,58,0,58,53247,1.08926324487765
16100,"Carlsbad-Artesia, NM",2000,31,0,31,51399,0.603124574408062
16100,"Carlsbad-Artesia, NM",2001,40,0,40,50765,0.787944449916281
16100,"Carlsbad-Artesia, NM",2002,53,0,53,51002,1.0391749343163
16100,"Carlsbad-Artesia, NM",2003,67,0,67,51036,1.31279880868407
16100,"Carlsbad-Artesia, NM",2004,65,0,65,51242,1.26849069122985
16100,"Carlsbad-Artesia, NM",2005,85,0,85,50732,1.67547110305133
16100,"Carlsbad-Artesia, NM",2006,96,0,96,51366,1.86894054432893
16100,"Carlsbad-Artesia, NM",2007,144,4,148,51923,2.85037459314755
16100,"Carlsbad-Artesia, NM",2008,131,7,138,52566,2.62527108777537
16100,"Carlsbad-Artesia, NM",2009,67,0,67,53578,1.25051327037217
16100,"Carlsbad-Artesia, NM",2010,89,0,89,53901,1.65117530287008
16100,"Carlsbad-Artesia, NM",2011,65,224,289,54056,5.34630753292882
16100,"Carlsbad-Artesia, NM",2012,106,272,378,54416,6.94648632755072
16100,"Carlsbad-Artesia, NM",2013,115,116,231,55668,4.14960120715671
16100,"Carlsbad-Artesia, NM",2014,164,172,336,56690,5.92697124713353
16100,"Carlsbad-Artesia, NM",2015,154,98,252,57724,4.36560182939505
16100,"Carlsbad-Artesia, NM",2016,91,204,295,57667,5.11557736660482
16100,"Carlsbad-Artesia, NM",2017,150,0,150,57205,2.62214841360021
16100,"Carlsbad-Artesia, NM",2018,178,106,284,57900,4.90500863557858
16180,"Carson City, NV",1990,423,68,491,40664,12.0745622663781
16180,"Carson City, NV",1991,331,57,388,41668,9.31170202553518
16180,"Carson City, NV",1992,377,92,469,42752,10.970247005988
16180,"Carson City, NV",1993,412,95,507,43861,11.5592439752856
16180,"Carson City, NV",1994,375,128,503,45149,11.140889056236
16180,"Carson City, NV",1995,334,82,416,46544,8.9377793056033
16180,"Carson City, NV",1996,324,119,443,47791,9.26952773534766
16180,"Carson City, NV",1997,335,377,712,48688,14.6237265856063
16180,"Carson City, NV",1998,266,2,268,48834,5.48797968628415
16180,"Carson City, NV",1999,297,30,327,49635,6.58809307948021
16180,"Carson City, NV",2000,276,0,276,52568,5.25034241363567
16180,"Carson City, NV",2001,310,74,384,53472,7.18132854578097
16180,"Carson City, NV",2002,307,29,336,54503,6.16479826798525
16180,"Carson City, NV",2003,197,6,203,55234,3.67527247709744
16180,"Carson City, NV",2004,132,100,232,55995,4.14322707384588
16180,"Carson City, NV",2005,110,80,190,55982,3.39394805473188
16180,"Carson City, NV",2006,110,77,187,55410,3.37484208626602
16180,"Carson City, NV",2007,45,6,51,55288,0.922442482998119
16180,"Carson City, NV",2008,16,0,16,55552,0.288018433179724
16180,"Carson City, NV",2009,18,0,18,55401,0.324903882601397
16180,"Carson City, NV",2010,11,60,71,54986,1.29123776961408
16180,"Carson City, NV",2011,9,4,13,54679,0.237751239049727
16180,"Carson City, NV",2012,11,40,51,54319,0.938897991494689
16180,"Carson City, NV",2013,36,4,40,53736,0.744379931517046
16180,"Carson City, NV",2014,33,2,35,54096,0.646997929606625
16180,"Carson City, NV",2015,39,4,43,54069,0.795280105050953
16180,"Carson City, NV",2016,87,72,159,54147,2.93645077289601
16180,"Carson City, NV",2017,118,20,138,54608,2.5271022560797
16180,"Carson City, NV",2018,180,130,310,55414,5.59425415959866
16220,"Casper, WY",1990,30,0,30,61211,0.490107987126497
16220,"Casper, WY",1991,36,0,36,61881,0.581761768555776
16220,"Casper, WY",1992,45,0,45,62303,0.722276615893296
16220,"Casper, WY",1993,68,0,68,62836,1.08218218855433
16220,"Casper, WY",1994,81,6,87,63792,1.36380737396539
16220,"Casper, WY",1995,67,2,69,63800,1.08150470219436
16220,"Casper, WY",1996,157,15,172,63614,2.70380733800736
16220,"Casper, WY",1997,53,2,55,63697,0.863462957439126
16220,"Casper, WY",1998,79,2,81,63189,1.28186867967526
16220,"Casper, WY",1999,92,153,245,62970,3.89074162299508
16220,"Casper, WY",2000,107,38,145,66603,2.17707911055058
16220,"Casper, WY",2001,104,36,140,66978,2.09023858580429
16220,"Casper, WY",2002,280,20,300,67554,4.4408917310596
16220,"Casper, WY",2003,174,0,174,68246,2.5495999765554
16220,"Casper, WY",2004,284,0,284,69035,4.11385529079452
16220,"Casper, WY",2005,444,0,444,69922,6.34993278224307
16220,"Casper, WY",2006,423,0,423,70806,5.9740699940683
16220,"Casper, WY",2007,429,0,429,72365,5.92828024597527
16220,"Casper, WY",2008,379,40,419,73682,5.68659916940365
16220,"Casper, WY",2009,341,71,412,75238,5.47595629867886
16220,"Casper, WY",2010,264,543,807,75469,10.693132279479
16220,"Casper, WY",2011,256,146,402,76391,5.26240002094488
16220,"Casper, WY",2012,347,160,507,78562,6.45350169293042
16220,"Casper, WY",2013,357,246,603,81101,7.43517342572841
16220,"Casper, WY",2014,330,0,330,81375,4.05529953917051
16220,"Casper, WY",2015,227,44,271,82123,3.29992815654567
16220,"Casper, WY",2016,157,8,165,80882,2.04000890185703
16220,"Casper, WY",2017,151,122,273,79556,3.43154507516718
16220,"Casper, WY",2018,140,34,174,79115,2.19933008911079
16260,"Cedar City, UT",1990,77,8,85,20868,4.07322215832854
16260,"Cedar City, UT",1991,127,25,152,21382,7.10878308857918
16260,"Cedar City, UT",1992,221,239,460,22055,20.8569485377465
16260,"Cedar City, UT",1993,304,252,556,23349,23.8125829799991
16260,"Cedar City, UT",1994,406,136,542,24575,22.0549338758901
16260,"Cedar City, UT",1995,407,129,536,26103,20.5340382331533
16260,"Cedar City, UT",1996,463,293,756,26995,28.0051861455825
16260,"Cedar City, UT",1997,329,125,454,27787,16.3385755929032
16260,"Cedar City, UT",1998,325,27,352,28823,12.2124692086181
16260,"Cedar City, UT",1999,381,28,409,29606,13.8147672769033
16260,"Cedar City, UT",2000,286,166,452,34002,13.2933356861361
16260,"Cedar City, UT",2001,226,111,337,34771,9.69198469989359
16260,"Cedar City, UT",2002,257,195,452,35728,12.6511419614868
16260,"Cedar City, UT",2003,331,21,352,36202,9.72321971161814
16260,"Cedar City, UT",2004,522,109,631,37223,16.9518845874862
16260,"Cedar City, UT",2005,864,149,1013,39555,25.6099102515485
16260,"Cedar City, UT",2006,728,171,899,42000,21.4047619047619
16260,"Cedar City, UT",2007,378,333,711,43645,16.2905258334288
16260,"Cedar City, UT",2008,222,130,352,44547,7.90176667340113
16260,"Cedar City, UT",2009,130,60,190,45693,4.15818615542862
16260,"Cedar City, UT",2010,108,39,147,46263,3.17748524738992
16260,"Cedar City, UT",2011,62,6,68,46615,1.45875791054382
16260,"Cedar City, UT",2012,92,4,96,46644,2.05814252636995
16260,"Cedar City, UT",2013,182,45,227,46527,4.8788875276721
16260,"Cedar City, UT",2014,198,40,238,47045,5.05898607716017
16260,"Cedar City, UT",2015,188,53,241,48120,5.00831255195345
16260,"Cedar City, UT",2016,319,63,382,49692,7.68735410126378
16260,"Cedar City, UT",2017,337,86,423,50822,8.32316713234426
16260,"Cedar City, UT",2018,403,96,499,52775,9.45523448602558
16300,"Cedar Rapids, IA",1990,536,183,719,211085,3.40621076817396
16300,"Cedar Rapids, IA",1991,593,463,1056,212872,4.96072757337743
16300,"Cedar Rapids, IA",1992,796,507,1303,215753,6.0393134742043
16300,"Cedar Rapids, IA",1993,893,432,1325,218393,6.06704427339704
16300,"Cedar Rapids, IA",1994,871,423,1294,220660,5.86422550530227
16300,"Cedar Rapids, IA",1995,797,603,1400,223790,6.25586487331874
16300,"Cedar Rapids, IA",1996,852,445,1297,224872,5.7677256394749
16300,"Cedar Rapids, IA",1997,836,383,1219,226900,5.37241075363596
16300,"Cedar Rapids, IA",1998,986,411,1397,228301,6.11911467755288
16300,"Cedar Rapids, IA",1999,1029,787,1816,230720,7.87101248266297
16300,"Cedar Rapids, IA",2000,964,845,1809,237950,7.60243748686699
16300,"Cedar Rapids, IA",2001,946,728,1674,240145,6.97078848195882
16300,"Cedar Rapids, IA",2002,1024,752,1776,242099,7.33584194895477
16300,"Cedar Rapids, IA",2003,1113,702,1815,243272,7.46078463612746
16300,"Cedar Rapids, IA",2004,1186,870,2056,245108,8.38813910602673
16300,"Cedar Rapids, IA",2005,1098,634,1732,247265,7.00463065941399
16300,"Cedar Rapids, IA",2006,935,265,1200,249524,4.80915663423158
16300,"Cedar Rapids, IA",2007,840,347,1187,252709,4.69710220055479
16300,"Cedar Rapids, IA",2008,739,237,976,255503,3.81991600881399
16300,"Cedar Rapids, IA",2009,699,501,1200,256896,4.6711509715994
16300,"Cedar Rapids, IA",2010,691,164,855,258432,3.30841381872214
16300,"Cedar Rapids, IA",2011,577,154,731,260991,2.80086286500301
16300,"Cedar Rapids, IA",2012,617,171,788,261884,3.00896580165264
16300,"Cedar Rapids, IA",2013,625,324,949,262693,3.61258198733883
16300,"Cedar Rapids, IA",2014,644,237,881,264289,3.33347207034723
16300,"Cedar Rapids, IA",2015,703,370,1073,266256,4.02995613244396
16300,"Cedar Rapids, IA",2016,555,232,787,268138,2.93505582946095
16300,"Cedar Rapids, IA",2017,537,455,992,270594,3.66600885459397
16300,"Cedar Rapids, IA",2018,490,469,959,272295,3.52191556951101
16340,"Cedartown, GA",1990,122,31,153,33839,4.52141020715742
16340,"Cedartown, GA",1991,100,6,106,34129,3.1058630490199
16340,"Cedartown, GA",1992,97,12,109,34288,3.17895473635091
16340,"Cedartown, GA",1993,126,2,128,34247,3.73755365433469
16340,"Cedartown, GA",1994,144,62,206,34590,5.95547846198323
16340,"Cedartown, GA",1995,140,0,140,34849,4.01733191770209
16340,"Cedartown, GA",1996,177,75,252,35312,7.13638423198913
16340,"Cedartown, GA",1997,177,88,265,35892,7.38326089379249
16340,"Cedartown, GA",1998,222,36,258,36241,7.11900885737149
16340,"Cedartown, GA",1999,348,10,358,36445,9.82302099053368
16340,"Cedartown, GA",2000,256,10,266,38178,6.96736340300697
16340,"Cedartown, GA",2001,238,21,259,38612,6.70775924583031
16340,"Cedartown, GA",2002,313,42,355,39109,9.07719450765808
16340,"Cedartown, GA",2003,332,114,446,39246,11.3642154614483
16340,"Cedartown, GA",2004,202,24,226,39564,5.71226367404711
16340,"Cedartown, GA",2005,247,8,255,39860,6.39739086803813
16340,"Cedartown, GA",2006,203,8,211,40372,5.22639453086297
16340,"Cedartown, GA",2007,142,69,211,40789,5.17296329892863
16340,"Cedartown, GA",2008,89,0,89,41407,2.14939502982587
16340,"Cedartown, GA",2009,46,0,46,41386,1.11148697627217
16340,"Cedartown, GA",2010,30,64,94,41530,2.26342403082109
16340,"Cedartown, GA",2011,22,0,22,41262,0.533178226940042
16340,"Cedartown, GA",2012,20,10,30,41086,0.730175728958769
16340,"Cedartown, GA",2013,14,60,74,40959,1.806684733514
16340,"Cedartown, GA",2014,10,0,10,40866,0.244702197425733
16340,"Cedartown, GA",2015,32,0,32,41233,0.776077413722019
16340,"Cedartown, GA",2016,106,0,106,41625,2.54654654654655
16340,"Cedartown, GA",2017,61,0,61,41910,1.45549988069673
16340,"Cedartown, GA",2018,105,0,105,42470,2.47233341182011
16380,"Celina, OH",1990,68,35,103,39575,2.60265319014529
16380,"Celina, OH",1991,47,23,70,39709,1.762824548591
16380,"Celina, OH",1992,60,34,94,39891,2.35642124790053
16380,"Celina, OH",1993,114,28,142,40087,3.54229550727168
16380,"Celina, OH",1994,96,59,155,40385,3.83805868515538
16380,"Celina, OH",1995,110,19,129,40751,3.16556648916591
16380,"Celina, OH",1996,120,28,148,40843,3.62363195651642
16380,"Celina, OH",1997,93,22,115,40950,2.80830280830281
16380,"Celina, OH",1998,124,13,137,41116,3.33203619029088
16380,"Celina, OH",1999,121,61,182,41060,4.43253774963468
16380,"Celina, OH",2000,113,46,159,40913,3.88629530955931
16380,"Celina, OH",2001,103,18,121,40819,2.96430583796761
16380,"Celina, OH",2002,110,14,124,40843,3.03601596356781
16380,"Celina, OH",2003,126,44,170,40841,4.16248377855586
16380,"Celina, OH",2004,154,28,182,40889,4.45107486120962
16380,"Celina, OH",2005,117,28,145,40967,3.53943417872922
16380,"Celina, OH",2006,78,6,84,41063,2.04563719163237
16380,"Celina, OH",2007,72,54,126,41055,3.0690537084399
16380,"Celina, OH",2008,65,4,69,41022,1.68202427965482
16380,"Celina, OH",2009,51,38,89,40855,2.17843593195447
16380,"Celina, OH",2010,39,0,39,40786,0.956210464375031
16380,"Celina, OH",2011,26,0,26,40708,0.638695096786872
16380,"Celina, OH",2012,41,11,52,40700,1.27764127764128
16380,"Celina, OH",2013,54,0,54,40614,1.32959078150391
16380,"Celina, OH",2014,57,8,65,40730,1.59587527620918
16380,"Celina, OH",2015,58,8,66,40720,1.62082514734774
16380,"Celina, OH",2016,54,13,67,40713,1.64566600348783
16380,"Celina, OH",2017,70,24,94,40910,2.29772671718406
16380,"Celina, OH",2018,71,67,138,40959,3.369222881418
16460,"Centralia, IL",1990,24,2,26,41612,0.624819763529751
16460,"Centralia, IL",1991,22,0,22,41573,0.529189618261853
16460,"Centralia, IL",1992,30,3,33,41630,0.792697573865001
16460,"Centralia, IL",1993,28,18,46,41772,1.1012161256344
16460,"Centralia, IL",1994,27,12,39,41769,0.933706816059757
16460,"Centralia, IL",1995,50,9,59,41979,1.40546463708045
16460,"Centralia, IL",1996,22,0,22,42132,0.522168423051362
16460,"Centralia, IL",1997,32,6,38,42073,0.903192070924346
16460,"Centralia, IL",1998,25,8,33,41910,0.78740157480315
16460,"Centralia, IL",1999,29,6,35,41663,0.840073926505533
16460,"Centralia, IL",2000,15,2,17,41665,0.408016320652826
16460,"Centralia, IL",2001,27,17,44,41393,1.0629816635663
16460,"Centralia, IL",2002,21,42,63,40971,1.53767298821117
16460,"Centralia, IL",2003,18,48,66,40602,1.62553568789715
16460,"Centralia, IL",2004,12,0,12,40229,0.298292276715802
16460,"Centralia, IL",2005,41,4,45,39941,1.12666182619364
16460,"Centralia, IL",2006,19,4,23,40037,0.57446861652971
16460,"Centralia, IL",2007,12,0,12,39898,0.30076695573713
16460,"Centralia, IL",2008,6,50,56,39794,1.40724732371714
16460,"Centralia, IL",2009,7,2,9,39465,0.228050171037628
16460,"Centralia, IL",2010,0,0,0,39419,0
16460,"Centralia, IL",2011,4,0,4,39140,0.102197240674502
16460,"Centralia, IL",2012,6,2,8,39009,0.205080878771566
16460,"Centralia, IL",2013,1,0,1,38672,0.0258585022755482
16460,"Centralia, IL",2014,0,0,0,38558,0
16460,"Centralia, IL",2015,1,0,1,38366,0.0260647448261482
16460,"Centralia, IL",2016,4,0,4,38055,0.105111023518592
16460,"Centralia, IL",2017,13,0,13,37821,0.343724385923164
16460,"Centralia, IL",2018,12,0,12,37620,0.318979266347687
16500,"Centralia, WA",1990,154,20,174,59552,2.9218162278345
16500,"Centralia, WA",1991,169,29,198,60760,3.2587228439763
16500,"Centralia, WA",1992,225,100,325,61508,5.28386551342915
16500,"Centralia, WA",1993,277,62,339,63316,5.35409691073346
16500,"Centralia, WA",1994,337,131,468,64596,7.24503065205276
16500,"Centralia, WA",1995,314,52,366,65824,5.56028196402528
16500,"Centralia, WA",1996,292,77,369,66735,5.52933243425489
16500,"Centralia, WA",1997,253,61,314,67507,4.65136948760869
16500,"Centralia, WA",1998,197,83,280,68080,4.11280846063455
16500,"Centralia, WA",1999,222,82,304,68598,4.43161608210152
16500,"Centralia, WA",2000,182,2,184,68596,2.68237214997959
16500,"Centralia, WA",2001,166,8,174,68934,2.52415353816694
16500,"Centralia, WA",2002,209,14,223,69452,3.21085065944825
16500,"Centralia, WA",2003,306,68,374,70366,5.31506693573601
16500,"Centralia, WA",2004,337,59,396,71021,5.57581560383549
16500,"Centralia, WA",2005,499,30,529,72060,7.34110463502637
16500,"Centralia, WA",2006,499,72,571,73318,7.78799203469816
16500,"Centralia, WA",2007,487,20,507,74229,6.83021460615123
16500,"Centralia, WA",2008,243,34,277,74899,3.69831372915526
16500,"Centralia, WA",2009,132,80,212,75316,2.81480694673111
16500,"Centralia, WA",2010,124,80,204,75505,2.70180782729621
16500,"Centralia, WA",2011,82,11,93,75660,1.22918318794607
16500,"Centralia, WA",2012,97,24,121,75435,1.60402995956784
16500,"Centralia, WA",2013,95,0,95,74967,1.26722424533461
16500,"Centralia, WA",2014,129,35,164,74858,2.19081460899303
16500,"Centralia, WA",2015,129,0,129,75419,1.71044431774487
16500,"Centralia, WA",2016,156,76,232,76622,3.02785100884863
16500,"Centralia, WA",2017,218,16,234,78230,2.99117985427585
16500,"Centralia, WA",2018,271,4,275,79604,3.45460027134315
16540,"Chambersburg-Waynesboro, PA",1990,310,0,310,121496,2.5515243300191
16540,"Chambersburg-Waynesboro, PA",1991,181,0,181,123004,1.47149686189067
16540,"Chambersburg-Waynesboro, PA",1992,710,0,710,124031,5.72437535777346
16540,"Chambersburg-Waynesboro, PA",1993,643,0,643,124964,5.14548189878685
16540,"Chambersburg-Waynesboro, PA",1994,860,0,860,125882,6.83179485549959
16540,"Chambersburg-Waynesboro, PA",1995,425,0,425,126332,3.3641516005446
16540,"Chambersburg-Waynesboro, PA",1996,581,0,581,126722,4.58483925443096
16540,"Chambersburg-Waynesboro, PA",1997,540,85,625,127495,4.90215302560885
16540,"Chambersburg-Waynesboro, PA",1998,547,203,750,128265,5.84726932522512
16540,"Chambersburg-Waynesboro, PA",1999,564,116,680,128622,5.28680941052075
16540,"Chambersburg-Waynesboro, PA",2000,594,120,714,129745,5.50310223900728
16540,"Chambersburg-Waynesboro, PA",2001,544,140,684,130604,5.23720559860341
16540,"Chambersburg-Waynesboro, PA",2002,707,261,968,131998,7.33344444612797
16540,"Chambersburg-Waynesboro, PA",2003,786,206,992,133583,7.42609463779074
16540,"Chambersburg-Waynesboro, PA",2004,1095,104,1199,135742,8.83293306419531
16540,"Chambersburg-Waynesboro, PA",2005,955,127,1082,138927,7.78826290066006
16540,"Chambersburg-Waynesboro, PA",2006,779,90,869,142421,6.1016282711117
16540,"Chambersburg-Waynesboro, PA",2007,673,411,1084,144840,7.48412040872687
16540,"Chambersburg-Waynesboro, PA",2008,564,197,761,147032,5.17574405571576
16540,"Chambersburg-Waynesboro, PA",2009,398,110,508,148662,3.417147623468
16540,"Chambersburg-Waynesboro, PA",2010,513,57,570,149915,3.80215455424741
16540,"Chambersburg-Waynesboro, PA",2011,211,16,227,150910,1.50420780597707
16540,"Chambersburg-Waynesboro, PA",2012,188,185,373,151468,2.46256635064832
16540,"Chambersburg-Waynesboro, PA",2013,264,21,285,151938,1.87576511471785
16540,"Chambersburg-Waynesboro, PA",2014,251,105,356,152607,2.33278945264634
16540,"Chambersburg-Waynesboro, PA",2015,231,0,231,153074,1.50907404261991
16540,"Chambersburg-Waynesboro, PA",2016,285,42,327,153753,2.12678776999473
16540,"Chambersburg-Waynesboro, PA",2017,342,70,412,154487,2.66689106526763
16540,"Chambersburg-Waynesboro, PA",2018,349,74,423,154835,2.73194045274001
16580,"Champaign-Urbana, IL",1990,275,313,588,202842,2.89880793918419
16580,"Champaign-Urbana, IL",1991,449,59,508,203747,2.49328824473489
16580,"Champaign-Urbana, IL",1992,629,146,775,205344,3.77415458937198
16580,"Champaign-Urbana, IL",1993,630,583,1213,200952,6.0362673673315
16580,"Champaign-Urbana, IL",1994,677,411,1088,198056,5.49339580724643
16580,"Champaign-Urbana, IL",1995,606,145,751,197474,3.80303229792276
16580,"Champaign-Urbana, IL",1996,567,203,770,198609,3.8769642866134
16580,"Champaign-Urbana, IL",1997,594,922,1516,199291,7.60696669694065
16580,"Champaign-Urbana, IL",1998,608,287,895,198460,4.50972488158823
16580,"Champaign-Urbana, IL",1999,630,459,1089,199156,5.46807527767178
16580,"Champaign-Urbana, IL",2000,694,461,1155,210623,5.48373159626442
16580,"Champaign-Urbana, IL",2001,663,325,988,212461,4.6502652251472
16580,"Champaign-Urbana, IL",2002,934,646,1580,214532,7.36486864430481
16580,"Champaign-Urbana, IL",2003,941,432,1373,217483,6.31313711876331
16580,"Champaign-Urbana, IL",2004,1038,153,1191,219215,5.43302237529366
16580,"Champaign-Urbana, IL",2005,1295,883,2178,221400,9.83739837398374
16580,"Champaign-Urbana, IL",2006,1044,784,1828,224622,8.13811648013106
16580,"Champaign-Urbana, IL",2007,657,956,1613,227498,7.09017222129425
16580,"Champaign-Urbana, IL",2008,383,568,951,228381,4.16409421098953
16580,"Champaign-Urbana, IL",2009,369,151,520,230826,2.25277914966252
16580,"Champaign-Urbana, IL",2010,251,278,529,232331,2.27692387154534
16580,"Champaign-Urbana, IL",2011,215,303,518,233729,2.21624188697166
16580,"Champaign-Urbana, IL",2012,293,441,734,235004,3.12335109189631
16580,"Champaign-Urbana, IL",2013,300,414,714,236534,3.01859352143878
16580,"Champaign-Urbana, IL",2014,366,1123,1489,237906,6.2587744739519
16580,"Champaign-Urbana, IL",2015,329,906,1235,239109,5.16500842711901
16580,"Champaign-Urbana, IL",2016,440,571,1011,239833,4.21543323896211
16580,"Champaign-Urbana, IL",2017,408,430,838,239877,3.49345706341167
16580,"Champaign-Urbana, IL",2018,345,1161,1506,239643,6.28434796760181
16620,"Charleston, WV",1990,104,18,122,243090,0.501871734748447
16620,"Charleston, WV",1991,112,3,115,242957,0.473334787637319
16620,"Charleston, WV",1992,140,12,152,243780,0.623513003527771
16620,"Charleston, WV",1993,289,14,303,243564,1.24402621077006
16620,"Charleston, WV",1994,139,16,155,242528,0.639101464573163
16620,"Charleston, WV",1995,142,22,164,242130,0.677322099698509
16620,"Charleston, WV",1996,131,7,138,241468,0.571504298706247
16620,"Charleston, WV",1997,142,13,155,240132,0.645478320257192
16620,"Charleston, WV",1998,161,71,232,238187,0.974024610914953
16620,"Charleston, WV",1999,156,0,156,236169,0.660543932522897
16620,"Charleston, WV",2000,127,11,138,235518,0.585942475734339
16620,"Charleston, WV",2001,123,0,123,233423,0.526940361489656
16620,"Charleston, WV",2002,90,61,151,232093,0.650601267595317
16620,"Charleston, WV",2003,85,88,173,231566,0.747087223512951
16620,"Charleston, WV",2004,440,111,551,230874,2.38658315791297
16620,"Charleston, WV",2005,230,137,367,229041,1.60233320671845
16620,"Charleston, WV",2006,296,152,448,227750,1.96706915477497
16620,"Charleston, WV",2007,227,76,303,227165,1.33383223648009
16620,"Charleston, WV",2008,192,94,286,226811,1.26096176993179
16620,"Charleston, WV",2009,180,35,215,227421,0.945383231979457
16620,"Charleston, WV",2010,174,52,226,226891,0.996073004217884
16620,"Charleston, WV",2011,153,14,167,225895,0.739281524602138
16620,"Charleston, WV",2012,134,0,134,225793,0.593463924922385
16620,"Charleston, WV",2013,88,253,341,224754,1.51721437660731
16620,"Charleston, WV",2014,88,233,321,222943,1.43982991168146
16620,"Charleston, WV",2015,90,193,283,220390,1.28408729978674
16620,"Charleston, WV",2016,70,115,185,217792,0.84943432265648
16620,"Charleston, WV",2017,70,65,135,214398,0.629670052892285
16620,"Charleston, WV",2018,106,0,106,211037,0.502281590432009
16660,"Charleston-Mattoon, IL",1990,54,40,94,62288,1.50911893141536
16660,"Charleston-Mattoon, IL",1991,64,18,82,62293,1.31635978360329
16660,"Charleston-Mattoon, IL",1992,74,18,92,62655,1.46835847099194
16660,"Charleston-Mattoon, IL",1993,109,15,124,62817,1.9739879332028
16660,"Charleston-Mattoon, IL",1994,116,85,201,63155,3.1826458712691
16660,"Charleston-Mattoon, IL",1995,115,16,131,62381,2.09999839694779
16660,"Charleston-Mattoon, IL",1996,91,61,152,62436,2.43449292075085
16660,"Charleston-Mattoon, IL",1997,57,199,256,62358,4.10532730363386
16660,"Charleston-Mattoon, IL",1998,65,172,237,62126,3.81482793033513
16660,"Charleston-Mattoon, IL",1999,49,70,119,61841,1.92428971070972
16660,"Charleston-Mattoon, IL",2000,47,65,112,64432,1.73826669977651
16660,"Charleston-Mattoon, IL",2001,48,78,126,63787,1.97532412560553
16660,"Charleston-Mattoon, IL",2002,44,12,56,63625,0.880157170923379
16660,"Charleston-Mattoon, IL",2003,43,49,92,64040,1.4366021236727
16660,"Charleston-Mattoon, IL",2004,47,140,187,64260,2.91005291005291
16660,"Charleston-Mattoon, IL",2005,50,0,50,64073,0.780359901986796
16660,"Charleston-Mattoon, IL",2006,105,0,105,64462,1.62886661909342
16660,"Charleston-Mattoon, IL",2007,41,102,143,64569,2.21468506558875
16660,"Charleston-Mattoon, IL",2008,24,90,114,64554,1.76596337949624
16660,"Charleston-Mattoon, IL",2009,18,34,52,64656,0.804256372185103
16660,"Charleston-Mattoon, IL",2010,17,112,129,64921,1.98703039078264
16660,"Charleston-Mattoon, IL",2011,17,8,25,64699,0.386404735776442
16660,"Charleston-Mattoon, IL",2012,18,17,35,64263,0.544636882809704
16660,"Charleston-Mattoon, IL",2013,13,17,30,63957,0.469065153149772
16660,"Charleston-Mattoon, IL",2014,16,0,16,63446,0.252182958736563
16660,"Charleston-Mattoon, IL",2015,10,5,15,63020,0.23801967629324
16660,"Charleston-Mattoon, IL",2016,10,4,14,62635,0.223517202841862
16660,"Charleston-Mattoon, IL",2017,11,4,15,62212,0.241111039670803
16660,"Charleston-Mattoon, IL",2018,9,4,13,61693,0.210720827322387
16700,"Charleston-North Charleston, SC",1990,3034,508,3542,509038,6.95822315819251
16700,"Charleston-North Charleston, SC",1991,2859,93,2952,524817,5.62481779363092
16700,"Charleston-North Charleston, SC",1992,2841,557,3398,532147,6.38545364344814
16700,"Charleston-North Charleston, SC",1993,2699,122,2821,534437,5.278451903592
16700,"Charleston-North Charleston, SC",1994,2565,107,2672,532645,5.01647438725605
16700,"Charleston-North Charleston, SC",1995,2171,91,2262,526236,4.29845164526942
16700,"Charleston-North Charleston, SC",1996,2536,256,2792,522763,5.34085235565639
16700,"Charleston-North Charleston, SC",1997,2969,381,3350,534005,6.27334950047284
16700,"Charleston-North Charleston, SC",1998,3298,1976,5274,542146,9.72800684686413
16700,"Charleston-North Charleston, SC",1999,4324,1530,5854,553434,10.5775937148784
16700,"Charleston-North Charleston, SC",2000,3906,1481,5387,550916,9.77826020663767
16700,"Charleston-North Charleston, SC",2001,3916,768,4684,556901,8.41083065033103
16700,"Charleston-North Charleston, SC",2002,4985,997,5982,565179,10.5842573768664
16700,"Charleston-North Charleston, SC",2003,5384,2010,7394,573376,12.895551958924
16700,"Charleston-North Charleston, SC",2004,7371,935,8306,587231,14.1443486464441
16700,"Charleston-North Charleston, SC",2005,8084,2734,10818,598313,18.0808372875067
16700,"Charleston-North Charleston, SC",2006,7304,1769,9073,614463,14.7657385391797
16700,"Charleston-North Charleston, SC",2007,5602,1178,6780,628384,10.7895808932118
16700,"Charleston-North Charleston, SC",2008,3694,1478,5172,643613,8.03588491842147
16700,"Charleston-North Charleston, SC",2009,2732,217,2949,655447,4.4992196165365
16700,"Charleston-North Charleston, SC",2010,2787,273,3060,667440,4.58468176914779
16700,"Charleston-North Charleston, SC",2011,2597,1225,3822,681174,5.61090117943433
16700,"Charleston-North Charleston, SC",2012,3132,1461,4593,696795,6.59160872279508
16700,"Charleston-North Charleston, SC",2013,3779,1638,5417,711266,7.61599739056837
16700,"Charleston-North Charleston, SC",2014,4144,2011,6155,726837,8.46819850943196
16700,"Charleston-North Charleston, SC",2015,4608,1982,6590,745188,8.84340595930155
16700,"Charleston-North Charleston, SC",2016,4787,2187,6974,761482,9.15845679871619
16700,"Charleston-North Charleston, SC",2017,4726,2541,7267,775089,9.3756975005451
16700,"Charleston-North Charleston, SC",2018,4787,2215,7002,787643,8.8898142940393
16740,"Charlotte-Concord-Gastonia, NC-SC",1990,8627,3191,11818,1348592,8.76321378148469
16740,"Charlotte-Concord-Gastonia, NC-SC",1991,7714,1696,9410,1374506,6.84609597920999
16740,"Charlotte-Concord-Gastonia, NC-SC",1992,9502,1184,10686,1393518,7.66836165733058
16740,"Charlotte-Concord-Gastonia, NC-SC",1993,10462,1547,12009,1418306,8.46714319758924
16740,"Charlotte-Concord-Gastonia, NC-SC",1994,11445,3764,15209,1447030,10.510493908212
16740,"Charlotte-Concord-Gastonia, NC-SC",1995,11215,3967,15182,1479435,10.2620257057593
16740,"Charlotte-Concord-Gastonia, NC-SC",1996,14010,6472,20482,1514491,13.5240156593866
16740,"Charlotte-Concord-Gastonia, NC-SC",1997,14542,5249,19791,1551655,12.7547682957874
16740,"Charlotte-Concord-Gastonia, NC-SC",1998,17418,4909,22327,1589469,14.0468294757557
16740,"Charlotte-Concord-Gastonia, NC-SC",1999,19677,7212,26889,1628493,16.5115846368391
16740,"Charlotte-Concord-Gastonia, NC-SC",2000,18172,8041,26213,1728616,15.1641544449432
16740,"Charlotte-Concord-Gastonia, NC-SC",2001,18647,6072,24719,1769476,13.9696723775852
16740,"Charlotte-Concord-Gastonia, NC-SC",2002,19199,3848,23047,1806638,12.7568444812962
16740,"Charlotte-Concord-Gastonia, NC-SC",2003,19052,3528,22580,1841489,12.2618163888028
16740,"Charlotte-Concord-Gastonia, NC-SC",2004,21311,4481,25792,1880010,13.7190759623619
16740,"Charlotte-Concord-Gastonia, NC-SC",2005,23094,3507,26601,1934168,13.7532003424728
16740,"Charlotte-Concord-Gastonia, NC-SC",2006,23992,5369,29361,2009239,14.6129952683578
16740,"Charlotte-Concord-Gastonia, NC-SC",2007,20520,5793,26313,2086153,12.613168832775
16740,"Charlotte-Concord-Gastonia, NC-SC",2008,10016,4996,15012,2151756,6.97662746147797
16740,"Charlotte-Concord-Gastonia, NC-SC",2009,5480,2677,8157,2195856,3.7147244628063
16740,"Charlotte-Concord-Gastonia, NC-SC",2010,5154,948,6102,2223238,2.74464542257734
16740,"Charlotte-Concord-Gastonia, NC-SC",2011,5570,1552,7122,2254513,3.15899708717581
16740,"Charlotte-Concord-Gastonia, NC-SC",2012,7586,5642,13228,2292168,5.77095570656252
16740,"Charlotte-Concord-Gastonia, NC-SC",2013,11074,5770,16844,2332687,7.22085732033488
16740,"Charlotte-Concord-Gastonia, NC-SC",2014,11306,7231,18537,2374668,7.80614384831901
16740,"Charlotte-Concord-Gastonia, NC-SC",2015,12389,7154,19543,2422408,8.06759224705335
16740,"Charlotte-Concord-Gastonia, NC-SC",2016,14041,6533,20574,2474478,8.31448087232944
16740,"Charlotte-Concord-Gastonia, NC-SC",2017,15247,7622,22869,2524863,9.057521140751
16740,"Charlotte-Concord-Gastonia, NC-SC",2018,16407,9802,26209,2569213,10.2011783374909
16820,"Charlottesville, VA",1990,1143,440,1583,157729,10.0362013326655
16820,"Charlottesville, VA",1991,1136,243,1379,159715,8.63412954324891
16820,"Charlottesville, VA",1992,1130,555,1685,161624,10.4254318665545
16820,"Charlottesville, VA",1993,1241,284,1525,164481,9.27158759978356
16820,"Charlottesville, VA",1994,1369,266,1635,167321,9.77163655488552
16820,"Charlottesville, VA",1995,1221,94,1315,169887,7.74043923313732
16820,"Charlottesville, VA",1996,1149,198,1347,172466,7.81023506082358
16820,"Charlottesville, VA",1997,1185,327,1512,175087,8.63570682003804
16820,"Charlottesville, VA",1998,1272,359,1631,177990,9.16343614809821
16820,"Charlottesville, VA",1999,1356,130,1486,181245,8.1988468647411
16820,"Charlottesville, VA",2000,1299,56,1355,190613,7.10864421629165
16820,"Charlottesville, VA",2001,1323,390,1713,193611,8.8476377891752
16820,"Charlottesville, VA",2002,1511,1185,2696,196350,13.7305831423478
16820,"Charlottesville, VA",2003,1377,705,2082,198602,10.483278114017
16820,"Charlottesville, VA",2004,1559,777,2336,200985,11.6227579172575
16820,"Charlottesville, VA",2005,1678,453,2131,204975,10.3963898036346
16820,"Charlottesville, VA",2006,1384,526,1910,208519,9.15983675348529
16820,"Charlottesville, VA",2007,1252,166,1418,211383,6.70820264638121
16820,"Charlottesville, VA",2008,906,92,998,214672,4.64895282104792
16820,"Charlottesville, VA",2009,620,82,702,217176,3.23240137031716
16820,"Charlottesville, VA",2010,638,498,1136,218978,5.18773575427669
16820,"Charlottesville, VA",2011,649,389,1038,220810,4.70087405461709
16820,"Charlottesville, VA",2012,616,629,1245,222599,5.59301703960934
16820,"Charlottesville, VA",2013,703,349,1052,223913,4.69825333946667
16820,"Charlottesville, VA",2014,706,167,873,226139,3.86045750622405
16820,"Charlottesville, VA",2015,757,232,989,228622,4.32591789066669
16820,"Charlottesville, VA",2016,886,348,1234,230950,5.34314786750379
16820,"Charlottesville, VA",2017,963,313,1276,233586,5.4626561523379
16820,"Charlottesville, VA",2018,1028,587,1615,235232,6.86556250850224
16860,"Chattanooga, TN-GA",1990,1288,216,1504,424534,3.54270800454145
16860,"Chattanooga, TN-GA",1991,1365,181,1546,436413,3.54251591955327
16860,"Chattanooga, TN-GA",1992,1634,140,1774,438878,4.04212560210355
16860,"Chattanooga, TN-GA",1993,1763,183,1946,443472,4.38810116534979
16860,"Chattanooga, TN-GA",1994,2364,301,2665,447642,5.9534181332404
16860,"Chattanooga, TN-GA",1995,2297,166,2463,451633,5.45354303162081
16860,"Chattanooga, TN-GA",1996,2544,151,2695,454367,5.93132863962392
16860,"Chattanooga, TN-GA",1997,2296,679,2975,457769,6.49891102280845
16860,"Chattanooga, TN-GA",1998,2442,306,2748,459914,5.97503011432572
16860,"Chattanooga, TN-GA",1999,2256,462,2718,462340,5.87879050049747
16860,"Chattanooga, TN-GA",2000,2178,355,2533,477630,5.30326822017043
16860,"Chattanooga, TN-GA",2001,2250,630,2880,481798,5.97760887342828
16860,"Chattanooga, TN-GA",2002,2522,412,2934,485957,6.03757122543764
16860,"Chattanooga, TN-GA",2003,2781,485,3266,490089,6.66409570506581
16860,"Chattanooga, TN-GA",2004,3141,417,3558,494709,7.19210687495073
16860,"Chattanooga, TN-GA",2005,3330,468,3798,499564,7.60262949291782
16860,"Chattanooga, TN-GA",2006,3029,426,3455,506473,6.82168644725385
16860,"Chattanooga, TN-GA",2007,2118,569,2687,513100,5.23679594620932
16860,"Chattanooga, TN-GA",2008,1316,228,1544,518778,2.97622489774046
16860,"Chattanooga, TN-GA",2009,994,132,1126,524082,2.1485187432501
16860,"Chattanooga, TN-GA",2010,955,131,1086,529154,2.05233259126833
16860,"Chattanooga, TN-GA",2011,959,372,1331,533601,2.49437313648213
16860,"Chattanooga, TN-GA",2012,1181,134,1315,538143,2.4435884142319
16860,"Chattanooga, TN-GA",2013,1264,678,1942,542202,3.58169095650698
16860,"Chattanooga, TN-GA",2014,1226,1120,2346,544116,4.31158061883863
16860,"Chattanooga, TN-GA",2015,1532,561,2093,547295,3.82426296604208
16860,"Chattanooga, TN-GA",2016,1725,762,2487,551922,4.50607151010469
16860,"Chattanooga, TN-GA",2017,1928,703,2631,556081,4.7313251127084
16860,"Chattanooga, TN-GA",2018,1971,256,2227,560793,3.97116226486422
16940,"Cheyenne, WY",1990,79,0,79,73121,1.08040097919886
16940,"Cheyenne, WY",1991,91,0,91,73703,1.2346851552854
16940,"Cheyenne, WY",1992,229,14,243,75319,3.22627756608558
16940,"Cheyenne, WY",1993,263,20,283,76748,3.68739250534216
16940,"Cheyenne, WY",1994,353,16,369,77893,4.73726779043046
16940,"Cheyenne, WY",1995,258,40,298,78280,3.80684721512519
16940,"Cheyenne, WY",1996,302,362,664,78709,8.43613817987778
16940,"Cheyenne, WY",1997,254,221,475,78615,6.0421039241875
16940,"Cheyenne, WY",1998,320,149,469,78573,5.96897152966032
16940,"Cheyenne, WY",1999,289,34,323,78816,4.09815265935851
16940,"Cheyenne, WY",2000,245,0,245,81825,2.99419492820043
16940,"Cheyenne, WY",2001,257,62,319,82554,3.86413741308719
16940,"Cheyenne, WY",2002,446,32,478,83226,5.74339749597482
16940,"Cheyenne, WY",2003,622,157,779,84084,9.26454497883069
16940,"Cheyenne, WY",2004,744,132,876,85427,10.2543692275276
16940,"Cheyenne, WY",2005,696,176,872,85732,10.171231278869
16940,"Cheyenne, WY",2006,492,17,509,86819,5.86277197387669
16940,"Cheyenne, WY",2007,316,0,316,87654,3.60508362424989
16940,"Cheyenne, WY",2008,160,42,202,89077,2.26770097780572
16940,"Cheyenne, WY",2009,169,218,387,90430,4.27955324560433
16940,"Cheyenne, WY",2010,238,0,238,92235,2.58036537106305
16940,"Cheyenne, WY",2011,275,4,279,92561,3.01422845474876
16940,"Cheyenne, WY",2012,347,24,371,94690,3.91804836835991
16940,"Cheyenne, WY",2013,410,228,638,95706,6.66624872003845
16940,"Cheyenne, WY",2014,305,98,403,96038,4.19625564880568
16940,"Cheyenne, WY",2015,388,52,440,97006,4.53580190916026
16940,"Cheyenne, WY",2016,433,43,476,97978,4.85823348098553
16940,"Cheyenne, WY",2017,389,184,573,98460,5.81962218159659
16940,"Cheyenne, WY",2018,391,148,539,98976,5.44576462980925
16980,"Chicago-Naperville-Elgin, IL-IN-WI",1990,22854,8750,31604,8197925,3.8551218753526
16980,"Chicago-Naperville-Elgin, IL-IN-WI",1991,20731,6360,27091,8277847,3.27271088726332
16980,"Chicago-Naperville-Elgin, IL-IN-WI",1992,25487,6808,32295,8364132,3.86112988173788
16980,"Chicago-Naperville-Elgin, IL-IN-WI",1993,28704,6283,34987,8442131,4.14433275200302
16980,"Chicago-Naperville-Elgin, IL-IN-WI",1994,30060,8081,38141,8512631,4.48051842021579
16980,"Chicago-Naperville-Elgin, IL-IN-WI",1995,27547,9160,36707,8577826,4.27928941435744
16980,"Chicago-Naperville-Elgin, IL-IN-WI",1996,28047,10693,38740,8643964,4.48174009054179
16980,"Chicago-Naperville-Elgin, IL-IN-WI",1997,25356,9799,35155,8701804,4.03996688502752
16980,"Chicago-Naperville-Elgin, IL-IN-WI",1998,28479,9620,38099,8765303,4.34656965081527
16980,"Chicago-Naperville-Elgin, IL-IN-WI",1999,31513,12552,44065,8828644,4.99114020227795
16980,"Chicago-Naperville-Elgin, IL-IN-WI",2000,30527,11963,42490,9113234,4.66245023446122
16980,"Chicago-Naperville-Elgin, IL-IN-WI",2001,31608,13763,45371,9169580,4.94799107483658
16980,"Chicago-Naperville-Elgin, IL-IN-WI",2002,33857,15341,49198,9206032,5.3441048217082
16980,"Chicago-Naperville-Elgin, IL-IN-WI",2003,35750,14204,49954,9233303,5.41019827899074
16980,"Chicago-Naperville-Elgin, IL-IN-WI",2004,35810,11731,47541,9260676,5.13364251162658
16980,"Chicago-Naperville-Elgin, IL-IN-WI",2005,37470,16438,53908,9276302,5.81136750399028
16980,"Chicago-Naperville-Elgin, IL-IN-WI",2006,28632,18090,46722,9297749,5.02508725499043
16980,"Chicago-Naperville-Elgin, IL-IN-WI",2007,18095,15838,33933,9337140,3.63419633849337
16980,"Chicago-Naperville-Elgin, IL-IN-WI",2008,7637,8421,16058,9384555,1.71110937066275
16980,"Chicago-Naperville-Elgin, IL-IN-WI",2009,4383,1714,6097,9429498,0.646587973187968
16980,"Chicago-Naperville-Elgin, IL-IN-WI",2010,4244,3023,7267,9470880,0.767299342827699
16980,"Chicago-Naperville-Elgin, IL-IN-WI",2011,4145,3448,7593,9500991,0.799179790823926
16980,"Chicago-Naperville-Elgin, IL-IN-WI",2012,5658,3699,9357,9529773,0.981870187254198
16980,"Chicago-Naperville-Elgin, IL-IN-WI",2013,7261,4366,11627,9553268,1.21707043076777
16980,"Chicago-Naperville-Elgin, IL-IN-WI",2014,7723,7956,15679,9564614,1.63927159005058
16980,"Chicago-Naperville-Elgin, IL-IN-WI",2015,7676,8137,15813,9557880,1.65444638350764
16980,"Chicago-Naperville-Elgin, IL-IN-WI",2016,8032,11909,19941,9540144,2.09022002183615
16980,"Chicago-Naperville-Elgin, IL-IN-WI",2017,8416,13716,22132,9520784,2.32459847844463
16980,"Chicago-Naperville-Elgin, IL-IN-WI",2018,8546,9135,17681,9498716,1.86140947892326
17020,"Chico, CA",1990,1153,759,1912,183492,10.4200728097138
17020,"Chico, CA",1991,972,526,1498,186858,8.01678279763243
17020,"Chico, CA",1992,842,51,893,188913,4.72704366560268
17020,"Chico, CA",1993,638,98,736,190648,3.86051781293273
17020,"Chico, CA",1994,692,232,924,191773,4.81819651358638
17020,"Chico, CA",1995,652,76,728,192514,3.78154316049742
17020,"Chico, CA",1996,614,59,673,192082,3.50371195635197
17020,"Chico, CA",1997,626,22,648,193041,3.3567998508089
17020,"Chico, CA",1998,881,88,969,194314,4.9867739843758
17020,"Chico, CA",1999,1023,5,1028,194889,5.27479744880419
17020,"Chico, CA",2000,965,169,1134,203807,5.56408759267346
17020,"Chico, CA",2001,1023,70,1093,206193,5.30085890403651
17020,"Chico, CA",2002,1152,34,1186,209120,5.67138485080337
17020,"Chico, CA",2003,1441,328,1769,211481,8.36481764319253
17020,"Chico, CA",2004,1498,491,1989,213065,9.33517940534579
17020,"Chico, CA",2005,1493,200,1693,214752,7.8835121442408
17020,"Chico, CA",2006,1189,93,1282,216824,5.91262959819946
17020,"Chico, CA",2007,804,181,985,217469,4.52938119915942
17020,"Chico, CA",2008,532,60,592,219034,2.70277673785805
17020,"Chico, CA",2009,306,54,360,219777,1.63802399705156
17020,"Chico, CA",2010,157,355,512,219945,2.32785469094546
17020,"Chico, CA",2011,202,38,240,219952,1.09114715938023
17020,"Chico, CA",2012,213,138,351,220873,1.5891485152101
17020,"Chico, CA",2013,307,213,520,221664,2.3458928829219
17020,"Chico, CA",2014,355,195,550,223570,2.46007961712215
17020,"Chico, CA",2015,356,265,621,224812,2.76230806184723
17020,"Chico, CA",2016,445,252,697,226529,3.07686874528206
17020,"Chico, CA",2017,457,366,823,229207,3.59064077449642
17020,"Chico, CA",2018,595,108,703,231256,3.03992112637078
17060,"Chillicothe, OH",1990,28,3,31,69445,0.446396428828569
17060,"Chillicothe, OH",1991,36,3,39,70540,0.552877799829884
17060,"Chillicothe, OH",1992,33,29,62,71349,0.86896803038585
17060,"Chillicothe, OH",1993,29,15,44,72445,0.607357305542136
17060,"Chillicothe, OH",1994,46,8,54,73057,0.739148883748306
17060,"Chillicothe, OH",1995,43,0,43,73608,0.584175633083361
17060,"Chillicothe, OH",1996,43,8,51,74144,0.687850668968494
17060,"Chillicothe, OH",1997,24,14,38,74879,0.507485409794468
17060,"Chillicothe, OH",1998,53,14,67,75383,0.888794555801706
17060,"Chillicothe, OH",1999,56,21,77,75014,1.02647505798918
17060,"Chillicothe, OH",2000,53,15,68,73507,0.925081964982927
17060,"Chillicothe, OH",2001,43,21,64,73840,0.866738894907909
17060,"Chillicothe, OH",2002,46,0,46,74363,0.618587200623966
17060,"Chillicothe, OH",2003,48,0,48,75008,0.639931740614335
17060,"Chillicothe, OH",2004,47,0,47,75251,0.624576417589135
17060,"Chillicothe, OH",2005,39,0,39,75935,0.513597155461908
17060,"Chillicothe, OH",2006,41,0,41,76639,0.53497566513133
17060,"Chillicothe, OH",2007,31,0,31,77419,0.400418501918134
17060,"Chillicothe, OH",2008,86,0,86,77675,1.10717734148697
17060,"Chillicothe, OH",2009,80,0,80,77862,1.02745883743033
17060,"Chillicothe, OH",2010,13,0,13,78102,0.166449002586361
17060,"Chillicothe, OH",2011,18,0,18,77573,0.23203949827904
17060,"Chillicothe, OH",2012,12,16,28,77339,0.362042436545598
17060,"Chillicothe, OH",2013,15,0,15,77276,0.194109425953724
17060,"Chillicothe, OH",2014,15,40,55,77093,0.713424046281764
17060,"Chillicothe, OH",2015,20,0,20,77050,0.259571706683971
17060,"Chillicothe, OH",2016,19,0,19,76862,0.24719627384143
17060,"Chillicothe, OH",2017,16,0,16,77320,0.206932229694775
17060,"Chillicothe, OH",2018,13,0,13,76931,0.168982594792736
17140,"Cincinnati, OH-KY-IN",1990,6540,2796,9336,1829186,5.10390960788023
17140,"Cincinnati, OH-KY-IN",1991,6965,3124,10089,1849882,5.45386138142865
17140,"Cincinnati, OH-KY-IN",1992,8485,3023,11508,1868517,6.15889499533587
17140,"Cincinnati, OH-KY-IN",1993,9139,2619,11758,1889142,6.22398951481678
17140,"Cincinnati, OH-KY-IN",1994,9196,2983,12179,1901657,6.40441467625339
17140,"Cincinnati, OH-KY-IN",1995,8115,3192,11307,1914241,5.90677976284073
17140,"Cincinnati, OH-KY-IN",1996,9601,2790,12391,1926357,6.43234872871436
17140,"Cincinnati, OH-KY-IN",1997,8683,3388,12071,1942021,6.21568973764959
17140,"Cincinnati, OH-KY-IN",1998,9717,2382,12099,1956175,6.18502945799839
17140,"Cincinnati, OH-KY-IN",1999,11135,4372,15507,1968929,7.87585535080239
17140,"Cincinnati, OH-KY-IN",2000,9409,2739,12148,1991287,6.10057716441678
17140,"Cincinnati, OH-KY-IN",2001,10033,2449,12482,2003894,6.2288723854655
17140,"Cincinnati, OH-KY-IN",2002,10438,2324,12762,2011988,6.34298017682014
17140,"Cincinnati, OH-KY-IN",2003,10842,2266,13108,2023142,6.47903113078568
17140,"Cincinnati, OH-KY-IN",2004,10856,2105,12961,2034161,6.3716687125552
17140,"Cincinnati, OH-KY-IN",2005,10617,2228,12845,2046346,6.27704210333932
17140,"Cincinnati, OH-KY-IN",2006,7370,2011,9381,2061476,4.55062295171033
17140,"Cincinnati, OH-KY-IN",2007,5230,1595,6825,2075574,3.28824701022464
17140,"Cincinnati, OH-KY-IN",2008,3245,681,3926,2086569,1.88155771508155
17140,"Cincinnati, OH-KY-IN",2009,3068,406,3474,2099176,1.65493507928825
17140,"Cincinnati, OH-KY-IN",2010,2798,382,3180,2109163,1.50770708570177
17140,"Cincinnati, OH-KY-IN",2011,2500,848,3348,2113934,1.58377697695387
17140,"Cincinnati, OH-KY-IN",2012,2625,963,3588,2119873,1.69255422376718
17140,"Cincinnati, OH-KY-IN",2013,3277,1024,4301,2129573,2.01965370522635
17140,"Cincinnati, OH-KY-IN",2014,3218,1988,5206,2139832,2.43290127449258
17140,"Cincinnati, OH-KY-IN",2015,3477,1184,4661,2149352,2.1685605708139
17140,"Cincinnati, OH-KY-IN",2016,3938,1929,5867,2159866,2.71637221938768
17140,"Cincinnati, OH-KY-IN",2017,4440,2025,6465,2171581,2.97709364743935
17140,"Cincinnati, OH-KY-IN",2018,4282,1794,6076,2181970,2.78463956883
17200,"Claremont-Lebanon, NH-VT",1990,553,70,623,194110,3.20952037504508
17200,"Claremont-Lebanon, NH-VT",1991,569,49,618,194656,3.17483149761631
17200,"Claremont-Lebanon, NH-VT",1992,519,117,636,195126,3.25943236677839
17200,"Claremont-Lebanon, NH-VT",1993,574,96,670,195821,3.42149207694782
17200,"Claremont-Lebanon, NH-VT",1994,584,81,665,197318,3.37019430563861
17200,"Claremont-Lebanon, NH-VT",1995,667,91,758,198800,3.81287726358149
17200,"Claremont-Lebanon, NH-VT",1996,590,86,676,200064,3.37891874600128
17200,"Claremont-Lebanon, NH-VT",1997,531,54,585,200665,2.91530660553659
17200,"Claremont-Lebanon, NH-VT",1998,639,120,759,201864,3.75995719890619
17200,"Claremont-Lebanon, NH-VT",1999,626,130,756,202409,3.73501178307289
17200,"Claremont-Lebanon, NH-VT",2000,755,131,886,208230,4.25491043557605
17200,"Claremont-Lebanon, NH-VT",2001,816,153,969,209383,4.62788287492299
17200,"Claremont-Lebanon, NH-VT",2002,998,172,1170,210959,5.54610137514873
17200,"Claremont-Lebanon, NH-VT",2003,1203,97,1300,212904,6.1060384022846
17200,"Claremont-Lebanon, NH-VT",2004,1303,168,1471,214538,6.85659416979742
17200,"Claremont-Lebanon, NH-VT",2005,1054,133,1187,215675,5.50365132722847
17200,"Claremont-Lebanon, NH-VT",2006,1015,95,1110,217065,5.1136756271163
17200,"Claremont-Lebanon, NH-VT",2007,720,213,933,217552,4.28862984481871
17200,"Claremont-Lebanon, NH-VT",2008,463,66,529,218394,2.42222771687867
17200,"Claremont-Lebanon, NH-VT",2009,311,105,416,218327,1.9053987825601
17200,"Claremont-Lebanon, NH-VT",2010,338,241,579,218437,2.65064984411981
17200,"Claremont-Lebanon, NH-VT",2011,256,69,325,218401,1.48808842450355
17200,"Claremont-Lebanon, NH-VT",2012,271,41,312,217912,1.43177062300378
17200,"Claremont-Lebanon, NH-VT",2013,284,18,302,217806,1.38655500766737
17200,"Claremont-Lebanon, NH-VT",2014,276,76,352,217694,1.61694856082391
17200,"Claremont-Lebanon, NH-VT",2015,273,100,373,216995,1.71893361598194
17200,"Claremont-Lebanon, NH-VT",2016,309,136,445,217326,2.04761510357711
17200,"Claremont-Lebanon, NH-VT",2017,286,70,356,217272,1.63849920836555
17200,"Claremont-Lebanon, NH-VT",2018,340,143,483,217215,2.22360334231061
17220,"Clarksburg, WV",1990,35,13,48,84364,0.568963064814376
17220,"Clarksburg, WV",1991,101,0,101,84689,1.19259880267803
17220,"Clarksburg, WV",1992,160,57,217,85248,2.54551426426426
17220,"Clarksburg, WV",1993,142,28,170,85624,1.98542464729515
17220,"Clarksburg, WV",1994,217,38,255,85805,2.97185478701707
17220,"Clarksburg, WV",1995,181,38,219,85972,2.54734099474247
17220,"Clarksburg, WV",1996,175,18,193,86108,2.24137130115669
17220,"Clarksburg, WV",1997,120,76,196,86471,2.26665587306727
17220,"Clarksburg, WV",1998,186,61,247,86102,2.86869062274976
17220,"Clarksburg, WV",1999,159,69,228,85670,2.66137504377262
17220,"Clarksburg, WV",2000,121,47,168,84570,1.98652004256829
17220,"Clarksburg, WV",2001,90,61,151,83896,1.79984743015162
17220,"Clarksburg, WV",2002,172,0,172,83867,2.05086625251887
17220,"Clarksburg, WV",2003,131,4,135,83867,1.60969153540725
17220,"Clarksburg, WV",2004,151,0,151,84147,1.79447870987676
17220,"Clarksburg, WV",2005,146,82,228,84307,2.70440176972256
17220,"Clarksburg, WV",2006,140,6,146,84639,1.72497312113801
17220,"Clarksburg, WV",2007,126,35,161,84580,1.90352329155829
17220,"Clarksburg, WV",2008,94,39,133,85233,1.56042847253998
17220,"Clarksburg, WV",2009,61,0,61,85534,0.713166693946267
17220,"Clarksburg, WV",2010,117,0,117,86148,1.35812787296281
17220,"Clarksburg, WV",2011,57,57,114,86234,1.32198436811466
17220,"Clarksburg, WV",2012,134,4,138,86073,1.60329023038584
17220,"Clarksburg, WV",2013,63,32,95,85905,1.10587276642803
17220,"Clarksburg, WV",2014,84,24,108,85780,1.25903474003264
17220,"Clarksburg, WV",2015,73,11,84,94168,0.892022767819217
17220,"Clarksburg, WV",2016,126,114,240,93879,2.55648228038219
17220,"Clarksburg, WV",2017,67,30,97,93362,1.03896660311476
17220,"Clarksburg, WV",2018,59,92,151,92822,1.62676951584754
17260,"Clarksdale, MS",1990,18,2,20,31573,0.633452633579324
17260,"Clarksdale, MS",1991,14,36,50,31460,1.58931977113795
17260,"Clarksdale, MS",1992,25,19,44,31608,1.39205264490003
17260,"Clarksdale, MS",1993,29,6,35,31734,1.10291800592425
17260,"Clarksdale, MS",1994,35,4,39,31561,1.23570229080194
17260,"Clarksdale, MS",1995,15,4,19,31562,0.601989734490843
17260,"Clarksdale, MS",1996,23,0,23,31623,0.727318723713753
17260,"Clarksdale, MS",1997,5,0,5,31471,0.158876425915923
17260,"Clarksdale, MS",1998,7,0,7,31273,0.223835257250664
17260,"Clarksdale, MS",1999,11,0,11,31115,0.35352723766672
17260,"Clarksdale, MS",2000,22,0,22,30526,0.720697110659765
17260,"Clarksdale, MS",2001,38,0,38,30172,1.25944584382872
17260,"Clarksdale, MS",2002,42,0,42,29662,1.41595307126964
17260,"Clarksdale, MS",2003,25,0,25,29055,0.86043710204784
17260,"Clarksdale, MS",2004,28,0,28,28508,0.982180440578083
17260,"Clarksdale, MS",2005,44,0,44,27875,1.57847533632287
17260,"Clarksdale, MS",2006,76,0,76,27441,2.76957836813527
17260,"Clarksdale, MS",2007,31,0,31,27025,1.14708603145236
17260,"Clarksdale, MS",2008,17,0,17,26549,0.64032543598629
17260,"Clarksdale, MS",2009,6,0,6,26257,0.228510492440111
17260,"Clarksdale, MS",2010,8,0,8,26106,0.306442963303455
17260,"Clarksdale, MS",2011,12,0,12,25850,0.4642166344294
17260,"Clarksdale, MS",2012,6,0,6,25617,0.234219463637428
17260,"Clarksdale, MS",2013,8,0,8,25183,0.317674621768653
17260,"Clarksdale, MS",2014,6,0,6,24843,0.241516725033209
17260,"Clarksdale, MS",2015,17,0,17,24509,0.693622750826227
17260,"Clarksdale, MS",2016,16,0,16,23843,0.671056494568636
17260,"Clarksdale, MS",2017,18,0,18,23185,0.776364028466681
17260,"Clarksdale, MS",2018,18,0,18,22628,0.795474633197808
17300,"Clarksville, TN-KY",1990,796,133,929,180779,5.13887121844905
17300,"Clarksville, TN-KY",1991,1222,119,1341,179700,7.46243739565943
17300,"Clarksville, TN-KY",1992,1532,203,1735,189213,9.16956023106235
17300,"Clarksville, TN-KY",1993,2097,392,2489,190522,13.0641080820063
17300,"Clarksville, TN-KY",1994,1981,564,2545,195235,13.035572515174
17300,"Clarksville, TN-KY",1995,1783,555,2338,199176,11.7383620516528
17300,"Clarksville, TN-KY",1996,1705,399,2104,205996,10.21379055904
17300,"Clarksville, TN-KY",1997,1456,372,1828,209783,8.71376612976266
17300,"Clarksville, TN-KY",1998,1372,185,1557,211818,7.35065008639492
17300,"Clarksville, TN-KY",1999,1582,338,1920,213677,8.985524881012
17300,"Clarksville, TN-KY",2000,1227,457,1684,220923,7.62256532819127
17300,"Clarksville, TN-KY",2001,1218,548,1766,223001,7.91924699889238
17300,"Clarksville, TN-KY",2002,1311,372,1683,224096,7.51017421105241
17300,"Clarksville, TN-KY",2003,1496,633,2129,223891,9.50909147754934
17300,"Clarksville, TN-KY",2004,2209,510,2719,228899,11.878601479255
17300,"Clarksville, TN-KY",2005,1959,783,2742,237633,11.5388014290944
17300,"Clarksville, TN-KY",2006,2088,1105,3193,237426,13.4484007648699
17300,"Clarksville, TN-KY",2007,1608,599,2207,247849,8.90461531012834
17300,"Clarksville, TN-KY",2008,968,424,1392,248331,5.60542179590949
17300,"Clarksville, TN-KY",2009,1273,183,1456,256545,5.67541756806798
17300,"Clarksville, TN-KY",2010,1088,829,1917,261609,7.32772955058886
17300,"Clarksville, TN-KY",2011,1426,574,2000,264193,7.57022328373575
17300,"Clarksville, TN-KY",2012,1385,509,1894,274048,6.91119803829986
17300,"Clarksville, TN-KY",2013,1252,586,1838,272169,6.7531570458061
17300,"Clarksville, TN-KY",2014,1276,231,1507,276473,5.45080351426722
17300,"Clarksville, TN-KY",2015,1132,210,1342,279843,4.79554607404866
17300,"Clarksville, TN-KY",2016,1316,363,1679,280702,5.98143226624677
17300,"Clarksville, TN-KY",2017,1558,255,1813,285691,6.34601720040183
17300,"Clarksville, TN-KY",2018,1516,287,1803,292264,6.1690800098541
17340,"Clearlake, CA",1990,524,8,532,51103,10.4103477290961
17340,"Clearlake, CA",1991,446,37,483,52796,9.14842033487385
17340,"Clearlake, CA",1992,375,24,399,53915,7.40053788370583
17340,"Clearlake, CA",1993,261,9,270,54840,4.92341356673961
17340,"Clearlake, CA",1994,192,2,194,55238,3.512075020819
17340,"Clearlake, CA",1995,133,38,171,55203,3.09765773599261
17340,"Clearlake, CA",1996,101,2,103,55068,1.87041475993317
17340,"Clearlake, CA",1997,97,0,97,54815,1.76958861625467
17340,"Clearlake, CA",1998,93,6,99,55025,1.79918218991368
17340,"Clearlake, CA",1999,174,8,182,55329,3.28941423123498
17340,"Clearlake, CA",2000,132,0,132,58538,2.25494550548362
17340,"Clearlake, CA",2001,102,0,102,60219,1.69381756588452
17340,"Clearlake, CA",2002,301,12,313,61513,5.08835530700827
17340,"Clearlake, CA",2003,404,124,528,62496,8.44854070660522
17340,"Clearlake, CA",2004,521,111,632,63116,10.0133088281894
17340,"Clearlake, CA",2005,461,53,514,63811,8.0550375327138
17340,"Clearlake, CA",2006,453,115,568,64202,8.84707641506495
17340,"Clearlake, CA",2007,335,70,405,64077,6.3205206236247
17340,"Clearlake, CA",2008,125,25,150,64392,2.32948192322028
17340,"Clearlake, CA",2009,57,0,57,64413,0.884914535885613
17340,"Clearlake, CA",2010,46,0,46,64735,0.71058932571252
17340,"Clearlake, CA",2011,43,0,43,64247,0.669291951375162
17340,"Clearlake, CA",2012,38,50,88,63963,1.37579538170505
17340,"Clearlake, CA",2013,48,0,48,63809,0.752244981115517
17340,"Clearlake, CA",2014,45,0,45,64058,0.702488369914765
17340,"Clearlake, CA",2015,71,0,71,64254,1.10498957263361
17340,"Clearlake, CA",2016,240,2,242,63884,3.78811596017782
17340,"Clearlake, CA",2017,153,6,159,64162,2.47810230354415
17340,"Clearlake, CA",2018,87,26,113,64382,1.75514895467677
17380,"Cleveland, MS",1990,45,8,53,41846,1.26654877407638
17380,"Cleveland, MS",1991,34,8,42,41615,1.00925147182506
17380,"Cleveland, MS",1992,34,22,56,41728,1.3420245398773
17380,"Cleveland, MS",1993,38,0,38,41512,0.91539795721719
17380,"Cleveland, MS",1994,43,2,45,41489,1.08462484031912
17380,"Cleveland, MS",1995,42,36,78,41458,1.88142216218824
17380,"Cleveland, MS",1996,31,21,52,40877,1.2721090099567
17380,"Cleveland, MS",1997,36,16,52,40567,1.2818300589148801
17380,"Cleveland, MS",1998,39,10,49,40176,1.21963361210673
17380,"Cleveland, MS",1999,31,0,31,39860,0.777722027094832
17380,"Cleveland, MS",2000,47,30,77,40381,1.90683737401253
17380,"Cleveland, MS",2001,31,0,31,39723,0.780404299775948
17380,"Cleveland, MS",2002,36,0,36,38634,0.931821711445877
17380,"Cleveland, MS",2003,35,12,47,38027,1.23596392037237
17380,"Cleveland, MS",2004,36,0,36,37211,0.967455859826395
17380,"Cleveland, MS",2005,52,0,52,36305,1.43230959922876
17380,"Cleveland, MS",2006,54,0,54,36102,1.49576200764501
17380,"Cleveland, MS",2007,38,2,40,35628,1.12271247333558
17380,"Cleveland, MS",2008,48,0,48,35032,1.3701758392327
17380,"Cleveland, MS",2009,13,0,13,34450,0.377358490566038
17380,"Cleveland, MS",2010,16,0,16,34105,0.469139422372086
17380,"Cleveland, MS",2011,60,16,76,33804,2.24825464442078
17380,"Cleveland, MS",2012,59,24,83,33997,2.44139188751949
17380,"Cleveland, MS",2013,71,24,95,33986,2.79526864002825
17380,"Cleveland, MS",2014,22,0,22,33822,0.650464194902726
17380,"Cleveland, MS",2015,25,0,25,33279,0.751224495928363
17380,"Cleveland, MS",2016,26,0,26,32631,0.796788330115534
17380,"Cleveland, MS",2017,29,0,29,31895,0.909233422166484
17380,"Cleveland, MS",2018,32,2,34,31333,1.08511792678646
17420,"Cleveland, TN",1990,338,50,388,87589,4.42977999520488
17420,"Cleveland, TN",1991,348,95,443,88475,5.00706414241311
17420,"Cleveland, TN",1992,398,79,477,89441,5.33312462964412
17420,"Cleveland, TN",1993,431,120,551,90695,6.07530734880644
17420,"Cleveland, TN",1994,483,150,633,91465,6.92068004154595
17420,"Cleveland, TN",1995,439,165,604,92999,6.49469349132786
17420,"Cleveland, TN",1996,525,125,650,94270,6.89508857536862
17420,"Cleveland, TN",1997,502,443,945,96940,9.74829791623685
17420,"Cleveland, TN",1998,499,205,704,98200,7.16904276985743
17420,"Cleveland, TN",1999,472,77,549,98959,5.54775209935428
17420,"Cleveland, TN",2000,432,78,510,104338,4.88796028292664
17420,"Cleveland, TN",2001,441,63,504,105295,4.78655206799943
17420,"Cleveland, TN",2002,477,48,525,105979,4.95381160418574
17420,"Cleveland, TN",2003,614,111,725,106754,6.79131461116211
17420,"Cleveland, TN",2004,681,178,859,108099,7.94641948584168
17420,"Cleveland, TN",2005,758,68,826,109410,7.54958413307742
17420,"Cleveland, TN",2006,789,52,841,111177,7.56451424305387
17420,"Cleveland, TN",2007,651,168,819,112935,7.25195909151282
17420,"Cleveland, TN",2008,322,124,446,114306,3.90180742918132
17420,"Cleveland, TN",2009,262,89,351,115090,3.04978712312104
17420,"Cleveland, TN",2010,267,283,550,115901,4.74542928878957
17420,"Cleveland, TN",2011,303,73,376,116594,3.22486577353895
17420,"Cleveland, TN",2012,351,59,410,117683,3.48393565765659
17420,"Cleveland, TN",2013,409,42,451,118420,3.80847829758487
17420,"Cleveland, TN",2014,419,270,689,119481,5.76660724299261
17420,"Cleveland, TN",2015,439,293,732,120485,6.07544507615056
17420,"Cleveland, TN",2016,465,67,532,121024,4.3958223162348
17420,"Cleveland, TN",2017,519,120,639,122082,5.23418685801347
17420,"Cleveland, TN",2018,608,68,676,123625,5.46814964610718
17460,"Cleveland-Elyria, OH",1990,4618,2008,6626,2103381,3.1501663274509
17460,"Cleveland-Elyria, OH",1991,4624,1128,5752,2112949,2.72226163527847
17460,"Cleveland-Elyria, OH",1992,5232,1432,6664,2122766,3.13930032796832
17460,"Cleveland-Elyria, OH",1993,5491,953,6444,2128437,3.02757375482572
17460,"Cleveland-Elyria, OH",1994,5762,1078,6840,2130678,3.21024575276039
17460,"Cleveland-Elyria, OH",1995,5405,1838,7243,2130945,3.39896149360964
17460,"Cleveland-Elyria, OH",1996,5746,1333,7079,2130722,3.32234801161296
17460,"Cleveland-Elyria, OH",1997,5494,1117,6611,2126278,3.10918892073379
17460,"Cleveland-Elyria, OH",1998,6090,1168,7258,2121663,3.42090143439368
17460,"Cleveland-Elyria, OH",1999,6367,1070,7437,2116560,3.51372037645992
17460,"Cleveland-Elyria, OH",2000,5739,1215,6954,2147532,3.23813568319354
17460,"Cleveland-Elyria, OH",2001,6085,673,6758,2141787,3.15530909469522
17460,"Cleveland-Elyria, OH",2002,6169,635,6804,2136201,3.18509353754633
17460,"Cleveland-Elyria, OH",2003,6601,439,7040,2131150,3.30338080379138
17460,"Cleveland-Elyria, OH",2004,6711,698,7409,2122934,3.48998131830759
17460,"Cleveland-Elyria, OH",2005,5875,563,6438,2111699,3.04872995630533
17460,"Cleveland-Elyria, OH",2006,4542,652,5194,2099415,2.47402252532253
17460,"Cleveland-Elyria, OH",2007,3574,501,4075,2091596,1.94827299344615
17460,"Cleveland-Elyria, OH",2008,2259,426,2685,2085110,1.28770184786414
17460,"Cleveland-Elyria, OH",2009,1809,260,2069,2081063,0.994203443144201
17460,"Cleveland-Elyria, OH",2010,1853,88,1941,2075481,0.935204899490769
17460,"Cleveland-Elyria, OH",2011,1585,182,1767,2068801,0.854117916609669
17460,"Cleveland-Elyria, OH",2012,1925,407,2332,2064716,1.12945315481645
17460,"Cleveland-Elyria, OH",2013,2241,500,2741,2067127,1.32599496789505
17460,"Cleveland-Elyria, OH",2014,2256,644,2900,2067459,1.40268803395859
17460,"Cleveland-Elyria, OH",2015,2533,405,2938,2064284,1.42325377709656
17460,"Cleveland-Elyria, OH",2016,2618,435,3053,2061527,1.48094106941117
17460,"Cleveland-Elyria, OH",2017,2749,478,3227,2058549,1.56760902946687
17460,"Cleveland-Elyria, OH",2018,2733,248,2981,2057009,1.44919152030934
17500,"Clewiston, FL",1990,89,24,113,25808,4.37848729076255
17500,"Clewiston, FL",1991,60,2,62,26901,2.30474703542619
17500,"Clewiston, FL",1992,86,4,90,27417,3.28263486158223
17500,"Clewiston, FL",1993,135,4,139,27757,5.0077457938538
17500,"Clewiston, FL",1994,153,8,161,28383,5.67240954092238
17500,"Clewiston, FL",1995,88,0,88,28607,3.07617016814066
17500,"Clewiston, FL",1996,73,2,75,28682,2.61488041280245
17500,"Clewiston, FL",1997,48,4,52,29199,1.78088290694887
17500,"Clewiston, FL",1998,31,38,69,29111,2.37023805434372
17500,"Clewiston, FL",1999,43,2,45,29390,1.53113303844845
17500,"Clewiston, FL",2000,75,0,75,36255,2.06868018204386
17500,"Clewiston, FL",2001,55,0,55,36029,1.52654805850842
17500,"Clewiston, FL",2002,67,0,67,36035,1.85930345497433
17500,"Clewiston, FL",2003,96,0,96,36138,2.65648347999336
17500,"Clewiston, FL",2004,133,0,133,36903,3.60404303173184
17500,"Clewiston, FL",2005,410,0,410,38201,10.7327033323735
17500,"Clewiston, FL",2006,282,2,284,38776,7.32411801114091
17500,"Clewiston, FL",2007,96,27,123,39006,3.15336102138133
17500,"Clewiston, FL",2008,128,0,128,39177,3.26722311560354
17500,"Clewiston, FL",2009,40,14,54,39010,1.38426044603948
17500,"Clewiston, FL",2010,22,0,22,39013,0.563914592571707
17500,"Clewiston, FL",2011,24,8,32,38977,0.820996998229725
17500,"Clewiston, FL",2012,23,0,23,37887,0.607068387573574
17500,"Clewiston, FL",2013,22,17,39,37831,1.030900584177
17500,"Clewiston, FL",2014,24,0,24,38508,0.623247117482082
17500,"Clewiston, FL",2015,26,61,87,39325,2.21233312142403
17500,"Clewiston, FL",2016,62,2,64,40103,1.59589058175199
17500,"Clewiston, FL",2017,93,0,93,41144,2.26035387905892
17500,"Clewiston, FL",2018,79,0,79,41556,1.90104918663972
17540,"Clinton, IA",1990,58,4,62,51072,1.21397243107769
17540,"Clinton, IA",1991,54,2,56,50970,1.09868550127526
17540,"Clinton, IA",1992,77,6,83,51235,1.61998633746462
17540,"Clinton, IA",1993,82,2,84,51243,1.63924828757099
17540,"Clinton, IA",1994,80,2,82,51001,1.60781161153703
17540,"Clinton, IA",1995,70,22,92,50877,1.80828272107239
17540,"Clinton, IA",1996,97,95,192,50330,3.81482217365388
17540,"Clinton, IA",1997,75,11,86,50101,1.71653260413964
17540,"Clinton, IA",1998,90,2,92,49948,1.8419155922159
17540,"Clinton, IA",1999,104,30,134,49672,2.69769689160895
17540,"Clinton, IA",2000,104,32,136,50120,2.71348762968875
17540,"Clinton, IA",2001,92,11,103,49889,2.06458337509271
17540,"Clinton, IA",2002,104,2,106,49659,2.13455768340079
17540,"Clinton, IA",2003,146,2,148,49585,2.98477362105475
17540,"Clinton, IA",2004,167,7,174,49498,3.51529354721403
17540,"Clinton, IA",2005,142,52,194,49475,3.92117230924709
17540,"Clinton, IA",2006,126,18,144,49487,2.90985511346414
17540,"Clinton, IA",2007,93,26,119,49342,2.41173847837542
17540,"Clinton, IA",2008,72,2,74,49303,1.5009228647344
17540,"Clinton, IA",2009,51,4,55,49147,1.1190917044784
17540,"Clinton, IA",2010,72,8,80,49097,1.62942745992627
17540,"Clinton, IA",2011,38,2,40,49093,0.814780111217485
17540,"Clinton, IA",2012,39,44,83,48698,1.70438211014826
17540,"Clinton, IA",2013,43,39,82,48279,1.69846102860457
17540,"Clinton, IA",2014,58,44,102,47894,2.12970309433332
17540,"Clinton, IA",2015,40,16,56,47550,1.17770767613039
17540,"Clinton, IA",2016,54,26,80,47228,1.69391039214026
17540,"Clinton, IA",2017,52,186,238,46902,5.07441047290094
17540,"Clinton, IA",2018,50,37,87,46518,1.87024377660261
17580,"Clovis, NM",1990,236,0,236,42281,5.58170336557792
17580,"Clovis, NM",1991,425,15,440,44263,9.94058242776134
17580,"Clovis, NM",1992,196,4,200,45725,4.37397484964461
17580,"Clovis, NM",1993,121,2,123,46402,2.65074781259428
17580,"Clovis, NM",1994,116,6,122,47955,2.54405171514962
17580,"Clovis, NM",1995,44,0,44,47432,0.927643784786642
17580,"Clovis, NM",1996,71,0,71,47787,1.48575972544834
17580,"Clovis, NM",1997,30,0,30,46571,0.644177707156814
17580,"Clovis, NM",1998,35,0,35,44816,0.780971081756516
17580,"Clovis, NM",1999,37,0,37,43484,0.850887682825867
17580,"Clovis, NM",2000,39,0,39,44991,0.866840034673601
17580,"Clovis, NM",2001,55,25,80,44964,1.77920113868873
17580,"Clovis, NM",2002,84,47,131,45133,2.90253251501119
17580,"Clovis, NM",2003,101,60,161,45385,3.54742756417318
17580,"Clovis, NM",2004,220,8,228,46640,4.8885077186964
17580,"Clovis, NM",2005,133,11,144,46981,3.06506885762329
17580,"Clovis, NM",2006,249,0,249,47018,5.29584414479561
17580,"Clovis, NM",2007,132,18,150,46588,3.2197132308749
17580,"Clovis, NM",2008,112,139,251,45512,5.51502900333978
17580,"Clovis, NM",2009,211,4,215,46555,4.61819353452905
17580,"Clovis, NM",2010,155,6,161,48963,3.28819721013827
17580,"Clovis, NM",2011,126,65,191,49806,3.83487933180741
17580,"Clovis, NM",2012,146,36,182,50799,3.5827476918837
17580,"Clovis, NM",2013,134,152,286,50775,5.63269325455441
17580,"Clovis, NM",2014,88,53,141,51115,2.75848576738726
17580,"Clovis, NM",2015,54,4,58,50299,1.15310443547585
17580,"Clovis, NM",2016,38,64,102,50303,2.02771206488679
17580,"Clovis, NM",2017,52,32,84,49842,1.6853256289876
17580,"Clovis, NM",2018,56,54,110,49437,2.22505410927038
17660,"Coeur d'Alene, ID",1990,530,44,574,70412,8.1520195421235
17660,"Coeur d'Alene, ID",1991,843,214,1057,73781,14.3261815372521
17660,"Coeur d'Alene, ID",1992,1196,335,1531,77264,19.8151791261131
17660,"Coeur d'Alene, ID",1993,1373,515,1888,82174,22.9756370628179
17660,"Coeur d'Alene, ID",1994,1242,442,1684,87379,19.2723652136097
17660,"Coeur d'Alene, ID",1995,1203,415,1618,91812,17.6229686751187
17660,"Coeur d'Alene, ID",1996,1186,203,1389,95518,14.541761762181
17660,"Coeur d'Alene, ID",1997,1049,129,1178,98823,11.9203019539986
17660,"Coeur d'Alene, ID",1998,1168,99,1267,101220,12.5172890733057
17660,"Coeur d'Alene, ID",1999,1266,101,1367,104612,13.0673345314113
17660,"Coeur d'Alene, ID",2000,1058,116,1174,109487,10.7227342058875
17660,"Coeur d'Alene, ID",2001,1083,261,1344,111542,12.0492729196177
17660,"Coeur d'Alene, ID",2002,1266,148,1414,113667,12.4398462174598
17660,"Coeur d'Alene, ID",2003,1674,163,1837,116512,15.7666163141994
17660,"Coeur d'Alene, ID",2004,2090,275,2365,121002,19.54513148543
17660,"Coeur d'Alene, ID",2005,2288,400,2688,125972,21.3380751278062
17660,"Coeur d'Alene, ID",2006,1208,391,1599,129510,12.3465369469539
17660,"Coeur d'Alene, ID",2007,995,666,1661,132811,12.5064941909932
17660,"Coeur d'Alene, ID",2008,699,75,774,135627,5.70682828640315
17660,"Coeur d'Alene, ID",2009,761,100,861,137407,6.26605631445268
17660,"Coeur d'Alene, ID",2010,473,154,627,138852,4.51559934318555
17660,"Coeur d'Alene, ID",2011,421,202,623,140919,4.4209794278983
17660,"Coeur d'Alene, ID",2012,560,318,878,142078,6.17970410619519
17660,"Coeur d'Alene, ID",2013,826,451,1277,143898,8.87434154748502
17660,"Coeur d'Alene, ID",2014,820,227,1047,146536,7.14500191079325
17660,"Coeur d'Alene, ID",2015,1090,324,1414,149395,9.46484152749423
17660,"Coeur d'Alene, ID",2016,1296,370,1666,153103,10.8815633919649
17660,"Coeur d'Alene, ID",2017,1415,363,1778,157485,11.2899641235673
17660,"Coeur d'Alene, ID",2018,1658,552,2210,161505,13.6837868796632
17700,"Coffeyville, KS",1990,8,2,10,38765,0.257964658841739
17700,"Coffeyville, KS",1991,6,0,6,38676,0.155134967421657
17700,"Coffeyville, KS",1992,7,0,7,38000,0.184210526315789
17700,"Coffeyville, KS",1993,8,40,48,37873,1.2673936577509
17700,"Coffeyville, KS",1994,13,0,13,37713,0.344708721130645
17700,"Coffeyville, KS",1995,28,11,39,37593,1.03742718059213
17700,"Coffeyville, KS",1996,30,98,128,37315,3.43025592925097
17700,"Coffeyville, KS",1997,13,0,13,37183,0.349622139149611
17700,"Coffeyville, KS",1998,16,6,22,37035,0.594032671796949
17700,"Coffeyville, KS",1999,22,0,22,36754,0.598574304837569
17700,"Coffeyville, KS",2000,14,0,14,36242,0.386292147232493
17700,"Coffeyville, KS",2001,8,0,8,35935,0.22262418255183
17700,"Coffeyville, KS",2002,21,0,21,35490,0.591715976331361
17700,"Coffeyville, KS",2003,10,6,16,35152,0.455166135639508
17700,"Coffeyville, KS",2004,11,0,11,35150,0.312944523470839
17700,"Coffeyville, KS",2005,11,3,14,35034,0.399611805674488
17700,"Coffeyville, KS",2006,20,2,22,35246,0.624184304601941
17700,"Coffeyville, KS",2007,35,2,37,35504,1.04213609734114
17700,"Coffeyville, KS",2008,15,4,19,35538,0.534638977995385
17700,"Coffeyville, KS",2009,34,4,38,35589,1.06774565174633
17700,"Coffeyville, KS",2010,6,0,6,35353,0.169716855712386
17700,"Coffeyville, KS",2011,24,0,24,34781,0.690031913976021
17700,"Coffeyville, KS",2012,26,0,26,34475,0.75416968817984
17700,"Coffeyville, KS",2013,2,0,2,34449,0.0580568376440535
17700,"Coffeyville, KS",2014,1,0,1,34095,0.0293298137556827
17700,"Coffeyville, KS",2015,21,0,21,33426,0.628253455394005
17700,"Coffeyville, KS",2016,20,0,20,32820,0.60938452163315
17700,"Coffeyville, KS",2017,9,0,9,32388,0.277880696554279
17700,"Coffeyville, KS",2018,2,0,2,32120,0.062266500622665
17740,"Coldwater, MI",1990,124,8,132,41569,3.1754432389521
17740,"Coldwater, MI",1991,130,0,130,41678,3.11915159076731
17740,"Coldwater, MI",1992,111,2,113,41844,2.70050664372431
17740,"Coldwater, MI",1993,121,42,163,42003,3.88067518986739
17740,"Coldwater, MI",1994,138,16,154,42109,3.65717542568097
17740,"Coldwater, MI",1995,155,19,174,42760,4.06922357343312
17740,"Coldwater, MI",1996,198,20,218,43031,5.06611512630429
17740,"Coldwater, MI",1997,192,78,270,43775,6.16790405482581
17740,"Coldwater, MI",1998,192,10,202,43741,4.61809286481791
17740,"Coldwater, MI",1999,155,7,162,43841,3.69517118678862
17740,"Coldwater, MI",2000,123,0,123,45875,2.68119891008174
17740,"Coldwater, MI",2001,101,180,281,46099,6.09557691056205
17740,"Coldwater, MI",2002,129,6,135,46651,2.89382864247283
17740,"Coldwater, MI",2003,138,65,203,46680,4.34875749785776
17740,"Coldwater, MI",2004,132,4,136,46791,2.90654185633989
17740,"Coldwater, MI",2005,120,7,127,46733,2.71756574583271
17740,"Coldwater, MI",2006,100,0,100,46805,2.13652387565431
17740,"Coldwater, MI",2007,86,24,110,46788,2.35103017867829
17740,"Coldwater, MI",2008,30,0,30,46305,0.647878198898607
17740,"Coldwater, MI",2009,25,0,25,45378,0.5509277623518
17740,"Coldwater, MI",2010,19,0,19,45180,0.420540061974325
17740,"Coldwater, MI",2011,17,0,17,43923,0.387040958040207
17740,"Coldwater, MI",2012,2,0,2,43795,0.0456673136202763
17740,"Coldwater, MI",2013,1,0,1,43587,0.0229426205061142
17740,"Coldwater, MI",2014,0,0,0,43731,0
17740,"Coldwater, MI",2015,30,0,30,43653,0.687237990516116
17740,"Coldwater, MI",2016,41,0,41,43490,0.942745458726144
17740,"Coldwater, MI",2017,82,2,84,43423,1.93445869700389
17740,"Coldwater, MI",2018,78,4,82,43622,1.8797854293705
17780,"College Station-Bryan, TX",1990,224,0,224,151104,1.48242270224481
17780,"College Station-Bryan, TX",1991,280,0,280,152079,1.84114835052834
17780,"College Station-Bryan, TX",1992,493,8,501,154649,3.23959417778324
17780,"College Station-Bryan, TX",1993,619,164,783,159258,4.91655050295746
17780,"College Station-Bryan, TX",1994,606,938,1544,160637,9.61173328685172
17780,"College Station-Bryan, TX",1995,550,470,1020,161533,6.31449920449691
17780,"College Station-Bryan, TX",1996,614,739,1353,161484,8.37853905030839
17780,"College Station-Bryan, TX",1997,775,338,1113,163280,6.81651151396374
17780,"College Station-Bryan, TX",1998,783,767,1550,164706,9.41070756378031
17780,"College Station-Bryan, TX",1999,776,842,1618,165554,9.77324619157495
17780,"College Station-Bryan, TX",2000,763,620,1383,185760,7.44509043927649
17780,"College Station-Bryan, TX",2001,856,591,1447,188315,7.68393383426705
17780,"College Station-Bryan, TX",2002,999,840,1839,192016,9.57732688942588
17780,"College Station-Bryan, TX",2003,1156,728,1884,196234,9.6007827389749
17780,"College Station-Bryan, TX",2004,892,300,1192,199374,5.97871337285704
17780,"College Station-Bryan, TX",2005,815,821,1636,203500,8.03931203931204
17780,"College Station-Bryan, TX",2006,920,665,1585,209014,7.58322409025233
17780,"College Station-Bryan, TX",2007,891,1036,1927,213000,9.04694835680751
17780,"College Station-Bryan, TX",2008,814,1344,2158,218658,9.86929360005122
17780,"College Station-Bryan, TX",2009,727,109,836,225114,3.71367396074878
17780,"College Station-Bryan, TX",2010,777,218,995,229453,4.33640004706846
17780,"College Station-Bryan, TX",2011,619,825,1444,231396,6.24038444916939
17780,"College Station-Bryan, TX",2012,767,1236,2003,234146,8.55449164196698
17780,"College Station-Bryan, TX",2013,773,852,1625,237840,6.83232425159771
17780,"College Station-Bryan, TX",2014,972,831,1803,242888,7.42317446724416
17780,"College Station-Bryan, TX",2015,1209,503,1712,250765,6.82710904631827
17780,"College Station-Bryan, TX",2016,1218,1642,2860,254825,11.2233886000196
17780,"College Station-Bryan, TX",2017,1155,1928,3083,258825,11.9115232299816
17780,"College Station-Bryan, TX",2018,1023,833,1856,262431,7.07233520430132
17820,"Colorado Springs, CO",1990,813,304,1117,409835,2.72548708626642
17820,"Colorado Springs, CO",1991,1258,50,1308,416298,3.14198002392517
17820,"Colorado Springs, CO",1992,3044,8,3052,433942,7.03319798498417
17820,"Colorado Springs, CO",1993,3820,95,3915,449263,8.71427204109842
17820,"Colorado Springs, CO",1994,3887,169,4056,469437,8.64013701519054
17820,"Colorado Springs, CO",1995,3678,1310,4988,482423,10.3394738642229
17820,"Colorado Springs, CO",1996,4367,1457,5824,491186,11.8570154686819
17820,"Colorado Springs, CO",1997,4162,1000,5162,499825,10.3276146651328
17820,"Colorado Springs, CO",1998,4535,719,5254,510514,10.2915884774952
17820,"Colorado Springs, CO",1999,4678,1162,5840,521017,11.2088473120839
17820,"Colorado Springs, CO",2000,5448,1184,6632,540593,12.2680093896887
17820,"Colorado Springs, CO",2001,5461,1862,7323,557057,13.1458719664235
17820,"Colorado Springs, CO",2002,5230,1832,7062,565688,12.4839133939557
17820,"Colorado Springs, CO",2003,5272,177,5449,569231,9.5725636867985
17820,"Colorado Springs, CO",2004,6452,314,6766,578345,11.6988994458325
17820,"Colorado Springs, CO",2005,6451,532,6983,587778,11.88033577303
17820,"Colorado Springs, CO",2006,4300,295,4595,602532,7.62615097621371
17820,"Colorado Springs, CO",2007,2824,405,3229,609490,5.29787199133702
17820,"Colorado Springs, CO",2008,1644,432,2076,620644,3.34491270357886
17820,"Colorado Springs, CO",2009,1353,16,1369,630998,2.16957898440249
17820,"Colorado Springs, CO",2010,1676,84,1760,650373,2.70613940000584
17820,"Colorado Springs, CO",2011,1616,659,2275,660486,3.44443334150913
17820,"Colorado Springs, CO",2012,2410,601,3011,669321,4.49858886842038
17820,"Colorado Springs, CO",2013,2885,702,3587,678674,5.28530634737739
17820,"Colorado Springs, CO",2014,2662,1011,3673,686696,5.34880063375933
17820,"Colorado Springs, CO",2015,3022,643,3665,697533,5.25423169943214
17820,"Colorado Springs, CO",2016,3610,1556,5166,712723,7.24825773827981
17820,"Colorado Springs, CO",2017,3852,1113,4965,725438,6.84414105685117
17820,"Colorado Springs, CO",2018,4229,1505,5734,738939,7.75977448747461
17860,"Columbia, MO",1990,611,176,787,112736,6.9809111552654
17860,"Columbia, MO",1991,680,583,1263,114704,11.0109499232808
17860,"Columbia, MO",1992,823,491,1314,116793,11.2506742698621
17860,"Columbia, MO",1993,1050,234,1284,119064,10.7841161056239
17860,"Columbia, MO",1994,1128,430,1558,121133,12.8618956023544
17860,"Columbia, MO",1995,846,507,1353,123399,10.9644324508302
17860,"Columbia, MO",1996,861,777,1638,125789,13.0218063582666
17860,"Columbia, MO",1997,856,700,1556,127938,12.1621410370648
17860,"Columbia, MO",1998,1042,160,1202,129104,9.31032346015615
17860,"Columbia, MO",1999,1012,204,1216,130126,9.3447888969153
17860,"Columbia, MO",2000,899,364,1263,135940,9.29086361630131
17860,"Columbia, MO",2001,1049,140,1189,138181,8.6046562117802
17860,"Columbia, MO",2002,1131,655,1786,140695,12.694125590817
17860,"Columbia, MO",2003,1328,766,2094,143019,14.6414112810186
17860,"Columbia, MO",2004,1662,668,2330,145348,16.0304923356359
17860,"Columbia, MO",2005,1607,717,2324,148786,15.6197491699488
17860,"Columbia, MO",2006,945,987,1932,152784,12.6453031731071
17860,"Columbia, MO",2007,863,301,1164,155666,7.4775480837177
17860,"Columbia, MO",2008,477,66,543,158089,3.43477408295327
17860,"Columbia, MO",2009,520,110,630,160565,3.92364462990066
17860,"Columbia, MO",2010,547,60,607,163194,3.71949949140287
17860,"Columbia, MO",2011,477,560,1037,166231,6.23830693432633
17860,"Columbia, MO",2012,914,312,1226,168789,7.26350650812553
17860,"Columbia, MO",2013,834,396,1230,170966,7.19441292420715
17860,"Columbia, MO",2014,663,751,1414,172795,8.18310715009115
17860,"Columbia, MO",2015,771,662,1433,174585,8.20803620013174
17860,"Columbia, MO",2016,863,441,1304,176667,7.38111814883368
17860,"Columbia, MO",2017,769,865,1634,178523,9.15288226166937
17860,"Columbia, MO",2018,555,2,557,180005,3.09435849004194
17900,"Columbia, SC",1990,2512,483,2995,551121,5.43437829442173
17900,"Columbia, SC",1991,2642,738,3380,560626,6.02897475322229
17900,"Columbia, SC",1992,3252,303,3555,567554,6.26372116133443
17900,"Columbia, SC",1993,3373,378,3751,574979,6.52371651834241
17900,"Columbia, SC",1994,3455,766,4221,580670,7.26918904024661
17900,"Columbia, SC",1995,3398,652,4050,587653,6.89182221481044
17900,"Columbia, SC",1996,4149,365,4514,595077,7.58557295946575
17900,"Columbia, SC",1997,3832,1324,5156,603450,8.54420415941669
17900,"Columbia, SC",1998,4366,872,5238,612148,8.55675424897247
17900,"Columbia, SC",1999,4383,1699,6082,618795,9.82878012912192
17900,"Columbia, SC",2000,4393,442,4835,649567,7.44342000132396
17900,"Columbia, SC",2001,4339,465,4804,659125,7.28845059738289
17900,"Columbia, SC",2002,4834,364,5198,666087,7.80378539139782
17900,"Columbia, SC",2003,5527,912,6439,676083,9.52397856476202
17900,"Columbia, SC",2004,6056,1193,7249,690421,10.4993909513181
17900,"Columbia, SC",2005,6651,779,7430,699160,10.6270381600778
17900,"Columbia, SC",2006,6494,1623,8117,715091,11.3510028793538
17900,"Columbia, SC",2007,5576,1289,6865,730546,9.39708108729635
17900,"Columbia, SC",2008,3488,860,4348,745740,5.83045029098613
17900,"Columbia, SC",2009,2583,915,3498,759400,4.60626810639979
17900,"Columbia, SC",2010,2527,415,2942,769647,3.82253162813602
17900,"Columbia, SC",2011,2390,507,2897,776106,3.73273753842903
17900,"Columbia, SC",2012,2791,938,3729,783227,4.76107182208989
17900,"Columbia, SC",2013,3183,462,3645,790890,4.60873193490877
17900,"Columbia, SC",2014,3300,767,4067,798956,5.09039296281648
17900,"Columbia, SC",2015,3678,964,4642,809244,5.73621800099846
17900,"Columbia, SC",2016,3916,711,4627,817337,5.66106758901163
17900,"Columbia, SC",2017,4072,557,4629,825110,5.61016106943317
17900,"Columbia, SC",2018,4478,474,4952,832666,5.94716248772017
17980,"Columbus, GA-AL",1990,715,96,811,266864,3.03900113915702
17980,"Columbus, GA-AL",1991,804,208,1012,265944,3.80531239659477
17980,"Columbus, GA-AL",1992,1188,39,1227,275042,4.46113684455465
17980,"Columbus, GA-AL",1993,1330,219,1549,276646,5.59921343522046
17980,"Columbus, GA-AL",1994,1242,708,1950,273325,7.13436385255648
17980,"Columbus, GA-AL",1995,1112,330,1442,271631,5.30867242693213
17980,"Columbus, GA-AL",1996,1105,151,1256,271386,4.62809430110617
17980,"Columbus, GA-AL",1997,1055,648,1703,272056,6.25974064163261
17980,"Columbus, GA-AL",1998,1032,661,1693,271358,6.23899055859787
17980,"Columbus, GA-AL",1999,1063,486,1549,271187,5.7119257191532
17980,"Columbus, GA-AL",2000,969,669,1638,275242,5.95112664491611
17980,"Columbus, GA-AL",2001,1011,746,1757,276324,6.35847772904272
17980,"Columbus, GA-AL",2002,1226,277,1503,277998,5.40651371592601
17980,"Columbus, GA-AL",2003,1419,572,1991,271448,7.33473814505909
17980,"Columbus, GA-AL",2004,1590,488,2078,284887,7.29412012482142
17980,"Columbus, GA-AL",2005,1823,422,2245,286358,7.8398368475824
17980,"Columbus, GA-AL",2006,1635,592,2227,289129,7.70244423769321
17980,"Columbus, GA-AL",2007,1199,609,1808,286274,6.31562768536437
17980,"Columbus, GA-AL",2008,823,277,1100,286985,3.83295294179138
17980,"Columbus, GA-AL",2009,881,327,1208,292968,4.12331722235876
17980,"Columbus, GA-AL",2010,869,515,1384,296495,4.66786960994283
17980,"Columbus, GA-AL",2011,906,154,1060,302346,3.5059170619092
17980,"Columbus, GA-AL",2012,782,450,1232,309943,3.9749244215872
17980,"Columbus, GA-AL",2013,752,287,1039,315704,3.29105744621544
17980,"Columbus, GA-AL",2014,703,252,955,312847,3.05261038143246
17980,"Columbus, GA-AL",2015,604,640,1244,310293,4.00911396647685
17980,"Columbus, GA-AL",2016,581,128,709,306591,2.31252711266802
17980,"Columbus, GA-AL",2017,669,248,917,303436,3.02205407400572
17980,"Columbus, GA-AL",2018,747,257,1004,305451,3.28694291392073
18020,"Columbus, IN",1990,201,7,208,63832,3.25855370347161
18020,"Columbus, IN",1991,227,0,227,64728,3.50698306760598
18020,"Columbus, IN",1992,379,0,379,65258,5.8077170615097
18020,"Columbus, IN",1993,393,193,586,66052,8.87179797735118
18020,"Columbus, IN",1994,350,0,350,66869,5.23411446260599
18020,"Columbus, IN",1995,393,94,487,67904,7.17188972667295
18020,"Columbus, IN",1996,360,6,366,68424,5.34900035075412
18020,"Columbus, IN",1997,376,236,612,68860,8.88759802497822
18020,"Columbus, IN",1998,342,28,370,69464,5.32650005758378
18020,"Columbus, IN",1999,298,2,300,69727,4.3024940123625
18020,"Columbus, IN",2000,210,2,212,71763,2.95416858269582
18020,"Columbus, IN",2001,219,4,223,72110,3.09249757315213
18020,"Columbus, IN",2002,131,0,131,71890,1.82222840450689
18020,"Columbus, IN",2003,283,0,283,72299,3.91430033610423
18020,"Columbus, IN",2004,278,0,278,72882,3.81438489613348
18020,"Columbus, IN",2005,292,0,292,73660,3.96415965245724
18020,"Columbus, IN",2006,281,0,281,74508,3.77140709722446
18020,"Columbus, IN",2007,257,0,257,75265,3.41460174051684
18020,"Columbus, IN",2008,192,0,192,76080,2.52365930599369
18020,"Columbus, IN",2009,125,0,125,76566,1.63257842906773
18020,"Columbus, IN",2010,131,0,131,76820,1.70528508200989
18020,"Columbus, IN",2011,178,0,178,77614,2.29340067513593
18020,"Columbus, IN",2012,200,0,200,78999,2.53167761617236
18020,"Columbus, IN",2013,241,0,241,79655,3.02554767434562
18020,"Columbus, IN",2014,254,0,254,80499,3.15531869961118
18020,"Columbus, IN",2015,233,0,233,81473,2.85984313821757
18020,"Columbus, IN",2016,300,0,300,82313,3.64462478587829
18020,"Columbus, IN",2017,204,0,204,82429,2.47485714978952
18020,"Columbus, IN",2018,170,0,170,82753,2.05430618829529
18060,"Columbus, MS",1990,254,5,259,59529,4.35082060844294
18060,"Columbus, MS",1991,218,11,229,59874,3.8246985335872
18060,"Columbus, MS",1992,266,3,269,59989,4.48415542849522
18060,"Columbus, MS",1993,230,45,275,59882,4.59236498446946
18060,"Columbus, MS",1994,242,35,277,60582,4.57231520913803
18060,"Columbus, MS",1995,235,39,274,60703,4.51378020855641
18060,"Columbus, MS",1996,249,41,290,61002,4.75394249368873
18060,"Columbus, MS",1997,280,27,307,61261,5.01134490132384
18060,"Columbus, MS",1998,288,40,328,60987,5.37819535310804
18060,"Columbus, MS",1999,297,22,319,60418,5.27988347843358
18060,"Columbus, MS",2000,170,0,170,61529,2.76292479968795
18060,"Columbus, MS",2001,140,0,140,60958,2.29666327635421
18060,"Columbus, MS",2002,168,0,168,60508,2.776492364646
18060,"Columbus, MS",2003,178,106,284,59919,4.73973197149485
18060,"Columbus, MS",2004,163,94,257,59699,4.30492973081626
18060,"Columbus, MS",2005,154,3,157,59237,2.65037054543613
18060,"Columbus, MS",2006,232,2,234,59396,3.93965923631221
18060,"Columbus, MS",2007,339,122,461,59355,7.76682672057956
18060,"Columbus, MS",2008,161,2,163,59160,2.7552400270453
18060,"Columbus, MS",2009,78,132,210,59663,3.51976937130215
18060,"Columbus, MS",2010,82,27,109,59796,1.82286440564586
18060,"Columbus, MS",2011,92,55,147,59613,2.46590508781642
18060,"Columbus, MS",2012,96,53,149,59606,2.4997483474818
18060,"Columbus, MS",2013,119,59,178,59811,2.97604119643544
18060,"Columbus, MS",2014,85,0,85,59813,1.4210957484159
18060,"Columbus, MS",2015,96,0,96,59695,1.60817488901918
18060,"Columbus, MS",2016,125,0,125,59558,2.0987944524665
18060,"Columbus, MS",2017,127,0,127,59189,2.14566895875923
18060,"Columbus, MS",2018,123,0,123,58930,2.0872221279484102
18100,"Columbus, NE",1990,71,121,192,29837,6.43496330059993
18100,"Columbus, NE",1991,64,68,132,29923,4.41132239414497
18100,"Columbus, NE",1992,94,61,155,30070,5.15463917525773
18100,"Columbus, NE",1993,85,8,93,30390,3.06021717670286
18100,"Columbus, NE",1994,100,135,235,30595,7.68099362640954
18100,"Columbus, NE",1995,63,32,95,30544,3.11026715557884
18100,"Columbus, NE",1996,49,22,71,30552,2.32390678188007
18100,"Columbus, NE",1997,54,10,64,30637,2.0889773802918
18100,"Columbus, NE",1998,66,16,82,30711,2.67005307544528
18100,"Columbus, NE",1999,61,0,61,30523,1.99849293975035
18100,"Columbus, NE",2000,60,56,116,31500,3.68253968253968
18100,"Columbus, NE",2001,49,34,83,31319,2.65014847217344
18100,"Columbus, NE",2002,53,15,68,30939,2.19787323442904
18100,"Columbus, NE",2003,44,8,52,30756,1.69072701261542
18100,"Columbus, NE",2004,43,12,55,30658,1.79398525670298
18100,"Columbus, NE",2005,53,16,69,30865,2.23554187591123
18100,"Columbus, NE",2006,67,4,71,31100,2.28295819935691
18100,"Columbus, NE",2007,64,10,74,31408,2.35608762098828
18100,"Columbus, NE",2008,80,12,92,31527,2.91813366320931
18100,"Columbus, NE",2009,77,10,87,32017,2.71730643095855
18100,"Columbus, NE",2010,80,8,88,32305,2.72403652685343
18100,"Columbus, NE",2011,52,8,60,32513,1.84541567988189
18100,"Columbus, NE",2012,62,42,104,32674,3.18295892758768
18100,"Columbus, NE",2013,52,6,58,32603,1.77897739471828
18100,"Columbus, NE",2014,49,12,61,32752,1.86248168050806
18100,"Columbus, NE",2015,55,16,71,32890,2.15871085436303
18100,"Columbus, NE",2016,64,27,91,33028,2.75523797989585
18100,"Columbus, NE",2017,52,20,72,33282,2.16333153055706
18100,"Columbus, NE",2018,52,8,60,33363,1.79839942451218
18140,"Columbus, OH",1990,5852,3743,9595,1467443,6.53858446290588
18140,"Columbus, OH",1991,6279,2311,8590,1488383,5.7713639567235004
18140,"Columbus, OH",1992,6980,3008,9988,1510006,6.61454325347052
18140,"Columbus, OH",1993,7988,3822,11810,1529534,7.72130596639238
18140,"Columbus, OH",1994,8056,4045,12101,1545657,7.82903322017757
18140,"Columbus, OH",1995,7234,4076,11310,1561350,7.24373138630032
18140,"Columbus, OH",1996,8131,4689,12820,1571627,8.15715179237822
18140,"Columbus, OH",1997,7025,3887,10912,1588033,6.87139373048293
18140,"Columbus, OH",1998,8040,3399,11439,1607782,7.11477053481131
18140,"Columbus, OH",1999,9563,6919,16482,1625505,10.1396181494366
18140,"Columbus, OH",2000,10704,4688,15392,1682068,9.15064075887538
18140,"Columbus, OH",2001,10623,5179,15802,1706779,9.25837498586519
18140,"Columbus, OH",2002,10959,6201,17160,1726352,9.94003540413543
18140,"Columbus, OH",2003,12199,4410,16609,1749262,9.49486126149199
18140,"Columbus, OH",2004,10894,2519,13413,1769572,7.57979895703594
18140,"Columbus, OH",2005,8899,3637,12536,1791126,6.99894926431753
18140,"Columbus, OH",2006,5738,2254,7992,1816992,4.39847836424156
18140,"Columbus, OH",2007,4381,2084,6465,1841539,3.51065060256666
18140,"Columbus, OH",2008,2651,1891,4542,1865647,2.43454415545921
18140,"Columbus, OH",2009,2602,1527,4129,1887548,2.18749403988667
18140,"Columbus, OH",2010,2915,1564,4479,1906361,2.34950253388524
18140,"Columbus, OH",2011,2443,2314,4757,1926157,2.46968445459015
18140,"Columbus, OH",2012,2944,3902,6846,1947157,3.51589522570599
18140,"Columbus, OH",2013,3529,4870,8399,1974121,4.25455177266236
18140,"Columbus, OH",2014,3497,3547,7044,2001776,3.51887523878796
18140,"Columbus, OH",2015,3523,4032,7555,2027559,3.72615544109937
18140,"Columbus, OH",2016,4157,4480,8637,2051957,4.20915253097409
18140,"Columbus, OH",2017,4295,4597,8892,2082475,4.26991920671317
18140,"Columbus, OH",2018,4493,4947,9440,2106541,4.48127997508712
18180,"Concord, NH",1990,368,65,433,120616,3.58990515354514
18180,"Concord, NH",1991,326,18,344,120740,2.84909723372536
18180,"Concord, NH",1992,322,56,378,120139,3.14635547157875
18180,"Concord, NH",1993,319,22,341,120453,2.83097971823035
18180,"Concord, NH",1994,388,18,406,121926,3.32988862096682
18180,"Concord, NH",1995,415,8,423,123596,3.42244085569112
18180,"Concord, NH",1996,442,80,522,125146,4.17112812235309
18180,"Concord, NH",1997,509,88,597,126359,4.72463378152724
18180,"Concord, NH",1998,554,31,585,127605,4.58445985658869
18180,"Concord, NH",1999,619,10,629,129375,4.86183574879227
18180,"Concord, NH",2000,688,4,692,136576,5.06677600749766
18180,"Concord, NH",2001,810,3,813,138309,5.87814242023296
18180,"Concord, NH",2002,955,365,1320,140880,9.36967632027257
18180,"Concord, NH",2003,857,171,1028,142548,7.21160591520049
18180,"Concord, NH",2004,927,96,1023,143841,7.11201952155505
18180,"Concord, NH",2005,824,7,831,145195,5.7233375804952
18180,"Concord, NH",2006,567,74,641,146609,4.37217360462182
18180,"Concord, NH",2007,435,4,439,147024,2.98590706279247
18180,"Concord, NH",2008,261,76,337,147170,2.28986885914249
18180,"Concord, NH",2009,160,62,222,146723,1.51305521288414
18180,"Concord, NH",2010,178,2,180,146394,1.22955858846674
18180,"Concord, NH",2011,113,6,119,146858,0.810306554631004
18180,"Concord, NH",2012,115,12,127,147106,0.863323045966854
18180,"Concord, NH",2013,193,44,237,147511,1.60665984231684
18180,"Concord, NH",2014,221,91,312,148141,2.10610161940314
18180,"Concord, NH",2015,227,151,378,148670,2.54254388915047
18180,"Concord, NH",2016,241,7,248,149150,1.66275561515253
18180,"Concord, NH",2017,287,2,289,150169,1.92449839847106
18180,"Concord, NH",2018,262,86,348,151132,2.30262287272054
18220,"Connersville, IN",1990,88,8,96,26006,3.69145581788818
18220,"Connersville, IN",1991,69,2,71,25970,2.73392375818252
18220,"Connersville, IN",1992,76,2,78,26144,2.98347613219094
18220,"Connersville, IN",1993,77,0,77,26209,2.93792208783242
18220,"Connersville, IN",1994,92,40,132,26203,5.03759111552112
18220,"Connersville, IN",1995,63,4,67,26217,2.55559369874509
18220,"Connersville, IN",1996,89,0,89,26208,3.39590964590965
18220,"Connersville, IN",1997,78,4,82,26134,3.13767505930971
18220,"Connersville, IN",1998,105,0,105,25995,4.03923831506059
18220,"Connersville, IN",1999,86,8,94,25843,3.63734860503811
18220,"Connersville, IN",2000,88,0,88,25556,3.4434183753326
18220,"Connersville, IN",2001,62,0,62,25263,2.4541820053042
18220,"Connersville, IN",2002,63,64,127,25094,5.06097074998007
18220,"Connersville, IN",2003,59,0,59,24953,2.36444515689496
18220,"Connersville, IN",2004,71,0,71,24844,2.85783287715344
18220,"Connersville, IN",2005,25,0,25,24700,1.01214574898785
18220,"Connersville, IN",2006,27,0,27,24508,1.10168108372776
18220,"Connersville, IN",2007,27,0,27,24413,1.10596813173309
18220,"Connersville, IN",2008,4,0,4,24384,0.164041994750656
18220,"Connersville, IN",2009,11,0,11,24247,0.453664370850002
18220,"Connersville, IN",2010,4,0,4,24326,0.164433116829729
18220,"Connersville, IN",2011,4,0,4,24150,0.165631469979296
18220,"Connersville, IN",2012,4,0,4,23949,0.16702158754019
18220,"Connersville, IN",2013,11,0,11,23829,0.461622392882622
18220,"Connersville, IN",2014,11,0,11,23444,0.469203207643747
18220,"Connersville, IN",2015,11,0,11,23393,0.470226136023597
18220,"Connersville, IN",2016,5,0,5,23257,0.214989035559186
18220,"Connersville, IN",2017,3,0,3,23153,0.129572841532415
18220,"Connersville, IN",2018,17,0,17,23047,0.737623117976309
18260,"Cookeville, TN",1990,156,27,183,78601,2.32821465375759
18260,"Cookeville, TN",1991,114,63,177,78901,2.24331757518916
18260,"Cookeville, TN",1992,149,85,234,80186,2.91821514977677
18260,"Cookeville, TN",1993,145,101,246,81722,3.01020533026602
18260,"Cookeville, TN",1994,113,328,441,82690,5.3331720885234
18260,"Cookeville, TN",1995,130,271,401,83901,4.77944243811158
18260,"Cookeville, TN",1996,152,110,262,85447,3.06622818823364
18260,"Cookeville, TN",1997,102,104,206,87052,2.36640169094334
18260,"Cookeville, TN",1998,71,48,119,88221,1.34888518606681
18260,"Cookeville, TN",1999,94,73,167,88965,1.87714269656607
18260,"Cookeville, TN",2000,90,156,246,93728,2.62461590986685
18260,"Cookeville, TN",2001,97,24,121,94637,1.27856969261494
18260,"Cookeville, TN",2002,331,140,471,95699,4.92168152227296
18260,"Cookeville, TN",2003,383,233,616,96524,6.38183249761717
18260,"Cookeville, TN",2004,462,61,523,86642,6.03633341797281
18260,"Cookeville, TN",2005,518,203,721,87854,8.20679764154165
18260,"Cookeville, TN",2006,492,116,608,89864,6.7657793999822
18260,"Cookeville, TN",2007,430,98,528,91151,5.79258592884335
18260,"Cookeville, TN",2008,274,290,564,92502,6.09716546669261
18260,"Cookeville, TN",2009,207,170,377,93567,4.02919832847051
18260,"Cookeville, TN",2010,214,72,286,94647,3.02175451942481
18260,"Cookeville, TN",2011,188,114,302,95198,3.17233555326793
18260,"Cookeville, TN",2012,247,20,267,95652,2.79136871157948
18260,"Cookeville, TN",2013,244,39,283,96074,2.94564606449195
18260,"Cookeville, TN",2014,286,141,427,96890,4.40705955206936
18260,"Cookeville, TN",2015,235,331,566,108659,5.20895646011835
18260,"Cookeville, TN",2016,395,328,723,109524,6.60129286731675
18260,"Cookeville, TN",2017,409,136,545,111033,4.90845064080048
18260,"Cookeville, TN",2018,375,126,501,112669,4.44665347167366
18300,"Coos Bay, OR",1990,182,5,187,60407,3.0956677206284
18300,"Coos Bay, OR",1991,117,10,127,60892,2.08565985679564
18300,"Coos Bay, OR",1992,113,36,149,61829,2.40987238997881
18300,"Coos Bay, OR",1993,125,48,173,62525,2.76689324270292
18300,"Coos Bay, OR",1994,140,127,267,62686,4.25932425102894
18300,"Coos Bay, OR",1995,43,105,148,62810,2.35631268906225
18300,"Coos Bay, OR",1996,36,28,64,62627,1.02192345154646
18300,"Coos Bay, OR",1997,37,40,77,62501,1.23198028831539
18300,"Coos Bay, OR",1998,33,27,60,62129,0.965732588646204
18300,"Coos Bay, OR",1999,17,25,42,61683,0.680900734400078
18300,"Coos Bay, OR",2000,34,2,36,62662,0.574510867830583
18300,"Coos Bay, OR",2001,26,2,28,62190,0.450233156456022
18300,"Coos Bay, OR",2002,41,2,43,62286,0.690363805670616
18300,"Coos Bay, OR",2003,39,6,45,62625,0.718562874251497
18300,"Coos Bay, OR",2004,57,8,65,63208,1.02835084166561
18300,"Coos Bay, OR",2005,76,83,159,63843,2.49048446971477
18300,"Coos Bay, OR",2006,69,63,132,63844,2.06753962784287
18300,"Coos Bay, OR",2007,32,40,72,63420,1.1352885525071
18300,"Coos Bay, OR",2008,19,4,23,63226,0.36377439660899
18300,"Coos Bay, OR",2009,21,2,23,63079,0.364622140490496
18300,"Coos Bay, OR",2010,18,6,24,63011,0.380885877069083
18300,"Coos Bay, OR",2011,16,0,16,62775,0.254878534448427
18300,"Coos Bay, OR",2012,18,0,18,62678,0.287182105363924
18300,"Coos Bay, OR",2013,17,0,17,62380,0.272523244629689
18300,"Coos Bay, OR",2014,30,0,30,62367,0.481023618259657
18300,"Coos Bay, OR",2015,25,4,29,62654,0.462859514157117
18300,"Coos Bay, OR",2016,35,4,39,63347,0.615656621465894
18300,"Coos Bay, OR",2017,32,0,32,63781,0.501716812216804
18300,"Coos Bay, OR",2018,41,13,54,64389,0.838652564879094
18380,"Cordele, GA",1990,33,7,40,19991,2.00090040518233
18380,"Cordele, GA",1991,47,84,131,20438,6.40962912222331
18380,"Cordele, GA",1992,55,0,55,20330,2.70536153467782
18380,"Cordele, GA",1993,47,16,63,20330,3.09886866699459
18380,"Cordele, GA",1994,68,16,84,20543,4.08898408216911
18380,"Cordele, GA",1995,54,70,124,20562,6.03054177609182
18380,"Cordele, GA",1996,57,14,71,20695,3.43078038173472
18380,"Cordele, GA",1997,61,24,85,20542,4.13786388861844
18380,"Cordele, GA",1998,65,20,85,20681,4.11005270538175
18380,"Cordele, GA",1999,42,7,49,20672,2.3703560371517
18380,"Cordele, GA",2000,70,18,88,22018,3.99672994822418
18380,"Cordele, GA",2001,45,36,81,22184,3.65128020194735
18380,"Cordele, GA",2002,43,0,43,22284,1.92963561299587
18380,"Cordele, GA",2003,132,0,132,22194,5.94755339280887
18380,"Cordele, GA",2004,71,4,75,22320,3.36021505376344
18380,"Cordele, GA",2005,71,56,127,22456,5.65550409690061
18380,"Cordele, GA",2006,86,2,88,22718,3.87358042081169
18380,"Cordele, GA",2007,69,2,71,23146,3.06748466257669
18380,"Cordele, GA",2008,39,0,39,23243,1.67792453641957
18380,"Cordele, GA",2009,20,0,20,23378,0.855505175806314
18380,"Cordele, GA",2010,75,0,75,23429,3.20116095437279
18380,"Cordele, GA",2011,15,0,15,23750,0.631578947368421
18380,"Cordele, GA",2012,16,0,16,23587,0.678339763429007
18380,"Cordele, GA",2013,23,0,23,23294,0.98737872413497
18380,"Cordele, GA",2014,12,0,12,23063,0.520313922733383
18380,"Cordele, GA",2015,18,0,18,22949,0.784347901869362
18380,"Cordele, GA",2016,20,0,20,22893,0.873629493731708
18380,"Cordele, GA",2017,17,0,17,22723,0.748140650442283
18380,"Cordele, GA",2018,15,0,15,22601,0.663687447458077
18420,"Corinth, MS",1990,54,6,60,31758,1.88928773852258
18420,"Corinth, MS",1991,37,5,42,32200,1.30434782608696
18420,"Corinth, MS",1992,25,8,33,32629,1.01137025345552
18420,"Corinth, MS",1993,20,12,32,32667,0.979581841001622
18420,"Corinth, MS",1994,33,67,100,32672,3.06072477962782
18420,"Corinth, MS",1995,25,22,47,32729,1.43603532035809
18420,"Corinth, MS",1996,41,0,41,32591,1.25801601669172
18420,"Corinth, MS",1997,31,16,47,32799,1.43297051739382
18420,"Corinth, MS",1998,35,40,75,32765,2.2890279261407
18420,"Corinth, MS",1999,53,2,55,33021,1.66560673510796
18420,"Corinth, MS",2000,29,7,36,34600,1.04046242774566
18420,"Corinth, MS",2001,34,3,37,34746,1.06487077649226
18420,"Corinth, MS",2002,27,24,51,34946,1.45939449436273
18420,"Corinth, MS",2003,34,4,38,35045,1.08432015979455
18420,"Corinth, MS",2004,34,10,44,35448,1.24125479575717
18420,"Corinth, MS",2005,1,4,5,35688,0.140103115893297
18420,"Corinth, MS",2006,33,4,37,36183,1.02257966448332
18420,"Corinth, MS",2007,2,0,2,36608,0.0546328671328671
18420,"Corinth, MS",2008,30,20,50,36793,1.35895414888702
18420,"Corinth, MS",2009,20,0,20,36868,0.542475859824238
18420,"Corinth, MS",2010,11,2,13,37106,0.350347652670727
18420,"Corinth, MS",2011,7,14,21,37275,0.563380281690141
18420,"Corinth, MS",2012,5,4,9,37203,0.241915974518184
18420,"Corinth, MS",2013,11,0,11,37278,0.295080208165674
18420,"Corinth, MS",2014,10,0,10,37250,0.268456375838926
18420,"Corinth, MS",2015,11,0,11,37273,0.295119791806401
18420,"Corinth, MS",2016,10,0,10,37249,0.268463582914978
18420,"Corinth, MS",2017,12,0,12,37203,0.322554632690912
18420,"Corinth, MS",2018,14,0,14,36925,0.37914691943128
18460,"Cornelia, GA",1990,194,27,221,27740,7.96683489545782
18460,"Cornelia, GA",1991,199,13,212,28124,7.5380457971839
18460,"Cornelia, GA",1992,240,5,245,28593,8.56853075927675
18460,"Cornelia, GA",1993,40,10,50,29139,1.71591338069254
18460,"Cornelia, GA",1994,191,10,201,29477,6.81887573362282
18460,"Cornelia, GA",1995,195,9,204,30105,6.77628300946687
18460,"Cornelia, GA",1996,340,62,402,30661,13.1111183588272
18460,"Cornelia, GA",1997,314,10,324,31220,10.3779628443306
18460,"Cornelia, GA",1998,380,11,391,31703,12.3332176765606
18460,"Cornelia, GA",1999,392,10,402,32559,12.3468165484198
18460,"Cornelia, GA",2000,374,2,376,36095,10.4169552569608
18460,"Cornelia, GA",2001,366,41,407,36914,11.0256271333369
18460,"Cornelia, GA",2002,363,59,422,37421,11.277090403784
18460,"Cornelia, GA",2003,406,99,505,38051,13.2716617171691
18460,"Cornelia, GA",2004,400,41,441,38491,11.4572237665948
18460,"Cornelia, GA",2005,416,28,444,39155,11.3395479504533
18460,"Cornelia, GA",2006,513,17,530,40616,13.0490447114438
18460,"Cornelia, GA",2007,338,18,356,41865,8.50352322942792
18460,"Cornelia, GA",2008,169,3,172,42550,4.04230317273796
18460,"Cornelia, GA",2009,69,3,72,42947,1.67648496984655
18460,"Cornelia, GA",2010,31,4,35,43064,0.812743823146944
18460,"Cornelia, GA",2011,44,68,112,43045,2.60192821465908
18460,"Cornelia, GA",2012,33,4,37,43393,0.852672089968428
18460,"Cornelia, GA",2013,34,0,34,43177,0.787456284595966
18460,"Cornelia, GA",2014,35,0,35,43583,0.803065415414267
18460,"Cornelia, GA",2015,17,0,17,43804,0.388092411651904
18460,"Cornelia, GA",2016,96,0,96,44123,2.17573601069737
18460,"Cornelia, GA",2017,112,80,192,44547,4.31005454912789
18460,"Cornelia, GA",2018,141,82,223,45388,4.91319291442672
18500,"Corning, NY",1990,183,42,225,99267,2.26661428269213
18500,"Corning, NY",1991,208,46,254,99741,2.5465956828185
18500,"Corning, NY",1992,234,38,272,100061,2.71834181149499
18500,"Corning, NY",1993,239,14,253,100303,2.52235725750975
18500,"Corning, NY",1994,169,6,175,100312,1.74455698221549
18500,"Corning, NY",1995,159,7,166,99556,1.66740327052111
18500,"Corning, NY",1996,158,40,198,98748,2.0051039008385
18500,"Corning, NY",1997,167,0,167,98372,1.69763753913715
18500,"Corning, NY",1998,172,8,180,98053,1.83574189468961
18500,"Corning, NY",1999,200,180,380,97784,3.88611633805121
18500,"Corning, NY",2000,237,8,245,98764,2.48066096958406
18500,"Corning, NY",2001,260,41,301,99216,3.03378487340752
18500,"Corning, NY",2002,183,0,183,99583,1.8376630549391
18500,"Corning, NY",2003,175,40,215,99191,2.16753536107107
18500,"Corning, NY",2004,177,0,177,98983,1.78818585009547
18500,"Corning, NY",2005,195,2,197,98868,1.99255573087349
18500,"Corning, NY",2006,163,28,191,98473,1.93961796634611
18500,"Corning, NY",2007,150,4,154,98541,1.56280127053714
18500,"Corning, NY",2008,104,2,106,98726,1.07367866620748
18500,"Corning, NY",2009,113,0,113,98949,1.14200244570435
18500,"Corning, NY",2010,99,5,104,99012,1.05037773199208
18500,"Corning, NY",2011,96,214,310,99145,3.12673357204095
18500,"Corning, NY",2012,74,0,74,98926,0.748033883913228
18500,"Corning, NY",2013,80,0,80,98845,0.80934796904244
18500,"Corning, NY",2014,86,0,86,98173,0.876004604117222
18500,"Corning, NY",2015,65,0,65,97524,0.666502604487101
18500,"Corning, NY",2016,80,0,80,96895,0.825635997729501
18500,"Corning, NY",2017,155,67,222,96249,2.30651747031138
18500,"Corning, NY",2018,89,4,93,95796,0.970812977577352
18580,"Corpus Christi, TX",1990,517,51,568,368397,1.54181494420421
18580,"Corpus Christi, TX",1991,526,49,575,373961,1.53759349236953
18580,"Corpus Christi, TX",1992,774,17,791,379378,2.08499174965338
18580,"Corpus Christi, TX",1993,1053,144,1197,387730,3.0871998555696
18580,"Corpus Christi, TX",1994,1086,82,1168,394667,2.95945695991811
18580,"Corpus Christi, TX",1995,1066,341,1407,397980,3.53535353535354
18580,"Corpus Christi, TX",1996,1515,921,2436,402505,6.05209873169277
18580,"Corpus Christi, TX",1997,1226,761,1987,407230,4.87930653439088
18580,"Corpus Christi, TX",1998,1408,512,1920,409280,4.69116497263487
18580,"Corpus Christi, TX",1999,1010,308,1318,410333,3.21202535501653
18580,"Corpus Christi, TX",2000,1071,576,1647,403458,4.08220930059634
18580,"Corpus Christi, TX",2001,1156,141,1297,402647,3.22118381609698
18580,"Corpus Christi, TX",2002,1420,561,1981,405692,4.88301470080751
18580,"Corpus Christi, TX",2003,1668,329,1997,406915,4.90765884767089
18580,"Corpus Christi, TX",2004,1969,1086,3055,411936,7.41620057484658
18580,"Corpus Christi, TX",2005,2141,472,2613,416308,6.27660289977613
18580,"Corpus Christi, TX",2006,2113,1187,3300,419530,7.8659452244178
18580,"Corpus Christi, TX",2007,1771,246,2017,420407,4.79773172187904
18580,"Corpus Christi, TX",2008,1220,383,1603,423168,3.78809361766485
18580,"Corpus Christi, TX",2009,1049,101,1150,427262,2.6915569369614
18580,"Corpus Christi, TX",2010,925,300,1225,427864,2.86305928986781
18580,"Corpus Christi, TX",2011,884,258,1142,430920,2.65014387821405
18580,"Corpus Christi, TX",2012,1273,223,1496,436682,3.42583390201565
18580,"Corpus Christi, TX",2013,1592,904,2496,443026,5.6339808498824
18580,"Corpus Christi, TX",2014,1667,1197,2864,447982,6.39311400904501
18580,"Corpus Christi, TX",2015,1607,546,2153,452557,4.75741177354455
18580,"Corpus Christi, TX",2016,1631,279,1910,454299,4.20427956037764
18580,"Corpus Christi, TX",2017,1178,8,1186,453684,2.61415434531524
18580,"Corpus Christi, TX",2018,1711,16,1727,452950,3.81278286786621
18620,"Corsicana, TX",1990,17,0,17,39928,0.42576637948307
18620,"Corsicana, TX",1991,14,0,14,39802,0.351741118536757
18620,"Corsicana, TX",1992,19,2,21,39941,0.525775518890363
18620,"Corsicana, TX",1993,30,0,30,40252,0.745304581138825
18620,"Corsicana, TX",1994,27,6,33,40382,0.817195780298153
18620,"Corsicana, TX",1995,22,0,22,40894,0.537976231231966
18620,"Corsicana, TX",1996,40,4,44,41200,1.06796116504854
18620,"Corsicana, TX",1997,34,4,38,41109,0.924371792064998
18620,"Corsicana, TX",1998,32,2,34,41667,0.815993472052224
18620,"Corsicana, TX",1999,37,2,39,42149,0.925288856200622
18620,"Corsicana, TX",2000,35,4,39,45202,0.8627936816955
18620,"Corsicana, TX",2001,31,4,35,45577,0.767931193365075
18620,"Corsicana, TX",2002,51,0,51,45937,1.11021616561813
18620,"Corsicana, TX",2003,21,0,21,46078,0.455748947436955
18620,"Corsicana, TX",2004,41,0,41,46545,0.88086797722634
18620,"Corsicana, TX",2005,68,0,68,46854,1.45131685661843
18620,"Corsicana, TX",2006,47,78,125,47338,2.64058473108285
18620,"Corsicana, TX",2007,66,0,66,47272,1.39617532577424
18620,"Corsicana, TX",2008,28,0,28,47408,0.590617617279784
18620,"Corsicana, TX",2009,21,0,21,47584,0.441324815063887
18620,"Corsicana, TX",2010,10,99,109,47872,2.2769050802139
18620,"Corsicana, TX",2011,17,11,28,48077,0.582399068161491
18620,"Corsicana, TX",2012,22,6,28,48177,0.581190194491147
18620,"Corsicana, TX",2013,22,0,22,48060,0.457761131918435
18620,"Corsicana, TX",2014,23,0,23,47947,0.479696331365883
18620,"Corsicana, TX",2015,96,2,98,48209,2.03281544939742
18620,"Corsicana, TX",2016,167,11,178,48417,3.67639465477002
18620,"Corsicana, TX",2017,249,7,256,48779,5.2481600688821
18620,"Corsicana, TX",2018,152,2,154,49565,3.10703117118935
18660,"Cortland, NY",1990,104,36,140,49110,2.85074322948483
18660,"Cortland, NY",1991,112,73,185,49193,3.76069766023621
18660,"Cortland, NY",1992,119,5,124,49343,2.51302109721744
18660,"Cortland, NY",1993,115,6,121,49358,2.45147696422059
18660,"Cortland, NY",1994,82,23,105,49207,2.13384274595078
18660,"Cortland, NY",1995,86,94,180,48762,3.69139904023625
18660,"Cortland, NY",1996,71,26,97,48301,2.00823999503116
18660,"Cortland, NY",1997,59,0,59,48128,1.22589760638298
18660,"Cortland, NY",1998,70,0,70,48197,1.45237255430836
18660,"Cortland, NY",1999,82,2,84,48110,1.74599875285803
18660,"Cortland, NY",2000,63,0,63,48693,1.29382046700758
18660,"Cortland, NY",2001,49,0,49,48903,1.00198351839355
18660,"Cortland, NY",2002,71,0,71,48891,1.45221001820376
18660,"Cortland, NY",2003,111,0,111,49475,2.24355735219808
18660,"Cortland, NY",2004,98,12,110,49628,2.2164906907391
18660,"Cortland, NY",2005,57,0,57,49330,1.15548347861342
18660,"Cortland, NY",2006,55,3,58,49449,1.17292564055896
18660,"Cortland, NY",2007,49,5,54,49624,1.08818313719168
18660,"Cortland, NY",2008,52,127,179,49537,3.61346064557805
18660,"Cortland, NY",2009,33,8,41,49358,0.830665748206978
18660,"Cortland, NY",2010,63,0,63,49283,1.27833127041779
18660,"Cortland, NY",2011,37,0,37,49378,0.749321560209
18660,"Cortland, NY",2012,40,0,40,49027,0.815876965753564
18660,"Cortland, NY",2013,43,0,43,48907,0.879219743594986
18660,"Cortland, NY",2014,36,6,42,48743,0.86166218739101
18660,"Cortland, NY",2015,32,41,73,48296,1.51151234056651
18660,"Cortland, NY",2016,37,6,43,47919,0.897347607420856
18660,"Cortland, NY",2017,22,2,24,47836,0.501714190149678
18660,"Cortland, NY",2018,32,61,93,47823,1.94467097421743
18700,"Corvallis, OR",1990,220,181,401,71027,5.64574035226041
18700,"Corvallis, OR",1991,218,60,278,71347,3.89644974560949
18700,"Corvallis, OR",1992,277,202,479,72326,6.62279125072588
18700,"Corvallis, OR",1993,300,85,385,73568,5.23325358851675
18700,"Corvallis, OR",1994,355,121,476,74910,6.35429181684688
18700,"Corvallis, OR",1995,263,190,453,75803,5.97601678033851
18700,"Corvallis, OR",1996,302,371,673,76914,8.75003250383545
18700,"Corvallis, OR",1997,228,99,327,77553,4.21647131639008
18700,"Corvallis, OR",1998,282,114,396,77794,5.09036686633931
18700,"Corvallis, OR",1999,229,172,401,76980,5.20914523252793
18700,"Corvallis, OR",2000,226,38,264,78236,3.37440564446035
18700,"Corvallis, OR",2001,310,485,795,78491,10.1285497700373
18700,"Corvallis, OR",2002,357,12,369,80203,4.60082540553346
18700,"Corvallis, OR",2003,278,161,439,80322,5.46550135703792
18700,"Corvallis, OR",2004,291,75,366,80149,4.56649490324271
18700,"Corvallis, OR",2005,320,176,496,80943,6.12776892381058
18700,"Corvallis, OR",2006,301,54,355,81957,4.33153970984785
18700,"Corvallis, OR",2007,193,20,213,83718,2.54425571561671
18700,"Corvallis, OR",2008,106,2,108,84150,1.28342245989305
18700,"Corvallis, OR",2009,96,0,96,85390,1.12425342545966
18700,"Corvallis, OR",2010,75,18,93,85574,1.08677869446327
18700,"Corvallis, OR",2011,66,298,364,86260,4.21980060282866
18700,"Corvallis, OR",2012,86,226,312,86675,3.59965387943467
18700,"Corvallis, OR",2013,133,90,223,86168,2.58796769102219
18700,"Corvallis, OR",2014,119,332,451,87221,5.17077309363571
18700,"Corvallis, OR",2015,138,4,142,88270,1.60870057777274
18700,"Corvallis, OR",2016,149,46,195,89743,2.17287142172649
18700,"Corvallis, OR",2017,116,20,136,91567,1.48525123679928
18700,"Corvallis, OR",2018,103,519,622,92101,6.75345544565206
18740,"Coshocton, OH",1990,4,0,4,35438,0.112873186974434
18740,"Coshocton, OH",1991,7,0,7,35542,0.196950087220753
18740,"Coshocton, OH",1992,13,0,13,35628,0.364881553834063
18740,"Coshocton, OH",1993,8,0,8,35839,0.223220513965233
18740,"Coshocton, OH",1994,15,0,15,35872,0.418153434433541
18740,"Coshocton, OH",1995,9,0,9,36027,0.24981264051961
18740,"Coshocton, OH",1996,19,6,25,36070,0.69309675630718
18740,"Coshocton, OH",1997,13,2,15,36157,0.414857427330807
18740,"Coshocton, OH",1998,17,3,20,36108,0.553893873933754
18740,"Coshocton, OH",1999,10,0,10,36053,0.277369428341608
18740,"Coshocton, OH",2000,5,3,8,36724,0.217841193769742
18740,"Coshocton, OH",2001,7,0,7,36975,0.189317106152806
18740,"Coshocton, OH",2002,14,0,14,37149,0.376860749952892
18740,"Coshocton, OH",2003,4,0,4,37288,0.10727311735679
18740,"Coshocton, OH",2004,7,0,7,37421,0.187060741294995
18740,"Coshocton, OH",2005,5,0,5,37363,0.133822230548939
18740,"Coshocton, OH",2006,4,0,4,37339,0.107126596855834
18740,"Coshocton, OH",2007,6,0,6,37184,0.161359724612737
18740,"Coshocton, OH",2008,4,0,4,36953,0.108245609287473
18740,"Coshocton, OH",2009,2,0,2,36878,0.0542328759694127
18740,"Coshocton, OH",2010,2,0,2,36936,0.0541477149664284
18740,"Coshocton, OH",2011,3,0,3,36926,0.0812435682175161
18740,"Coshocton, OH",2012,3,0,3,36820,0.0814774579033134
18740,"Coshocton, OH",2013,1,0,1,36722,0.0272316322640379
18740,"Coshocton, OH",2014,3,0,3,36529,0.0821265296066139
18740,"Coshocton, OH",2015,1,12,13,36578,0.355404888184154
18740,"Coshocton, OH",2016,3,0,3,36616,0.0819313961109897
18740,"Coshocton, OH",2017,3,0,3,36516,0.0821557673348669
18740,"Coshocton, OH",2018,7,2,9,36629,0.245706953506784
18780,"Craig, CO",1990,7,0,7,11398,0.614142832075803
18780,"Craig, CO",1991,14,0,14,11466,1.22100122100122
18780,"Craig, CO",1992,17,0,17,11562,1.47033385227469
18780,"Craig, CO",1993,15,0,15,11707,1.28128470146066
18780,"Craig, CO",1994,24,0,24,11907,2.01562106324011
18780,"Craig, CO",1995,44,0,44,11993,3.66880680396898
18780,"Craig, CO",1996,40,2,42,12068,3.48027842227378
18780,"Craig, CO",1997,58,2,60,12325,4.86815415821501
18780,"Craig, CO",1998,34,0,34,12577,2.70334738013835
18780,"Craig, CO",1999,44,0,44,12746,3.45206339243684
18780,"Craig, CO",2000,41,0,41,13147,3.11858218605005
18780,"Craig, CO",2001,44,0,44,13065,3.36777650210486
18780,"Craig, CO",2002,57,4,61,13193,4.62366406427651
18780,"Craig, CO",2003,58,4,62,13106,4.73065771402411
18780,"Craig, CO",2004,71,0,71,13175,5.38899430740038
18780,"Craig, CO",2005,76,0,76,12956,5.86600802716888
18780,"Craig, CO",2006,52,0,52,13115,3.96492565764392
18780,"Craig, CO",2007,66,0,66,13348,4.94456098291879
18780,"Craig, CO",2008,41,0,41,13585,3.01803459698197
18780,"Craig, CO",2009,21,0,21,13728,1.52972027972028
18780,"Craig, CO",2010,7,0,7,13794,0.507467014644048
18780,"Craig, CO",2011,10,0,10,13421,0.74510096118024
18780,"Craig, CO",2012,11,0,11,13169,0.835295011010707
18780,"Craig, CO",2013,9,0,9,13124,0.685766534593112
18780,"Craig, CO",2014,9,0,9,12934,0.695840420596876
18780,"Craig, CO",2015,7,0,7,12938,0.541041892100788
18780,"Craig, CO",2016,10,0,10,13143,0.760861294985924
18780,"Craig, CO",2017,11,0,11,13095,0.840015273004964
18780,"Craig, CO",2018,7,0,7,13188,0.530785562632696
18820,"Crawfordsville, IN",1990,93,112,205,34465,5.94806325257508
18820,"Crawfordsville, IN",1991,96,40,136,34738,3.91502101445103
18820,"Crawfordsville, IN",1992,142,36,178,35084,5.07353779500627
18820,"Crawfordsville, IN",1993,176,73,249,35487,7.01665398596669
18820,"Crawfordsville, IN",1994,203,4,207,35788,5.7840616966581
18820,"Crawfordsville, IN",1995,108,96,204,36061,5.6570810570977
18820,"Crawfordsville, IN",1996,167,8,175,36195,4.83492195054566
18820,"Crawfordsville, IN",1997,134,18,152,36301,4.18721247348558
18820,"Crawfordsville, IN",1998,112,34,146,36411,4.00977726511219
18820,"Crawfordsville, IN",1999,86,106,192,36507,5.25926534637193
18820,"Crawfordsville, IN",2000,116,0,116,37601,3.08502433445919
18820,"Crawfordsville, IN",2001,134,100,234,37793,6.19162278728865
18820,"Crawfordsville, IN",2002,140,16,156,37782,4.12895029379069
18820,"Crawfordsville, IN",2003,159,18,177,37634,4.70319392039114
18820,"Crawfordsville, IN",2004,165,14,179,37795,4.73607620055563
18820,"Crawfordsville, IN",2005,86,16,102,38105,2.67681406639549
18820,"Crawfordsville, IN",2006,85,0,85,38040,2.23449001051525
18820,"Crawfordsville, IN",2007,75,11,86,38172,2.25296028502567
18820,"Crawfordsville, IN",2008,37,6,43,38204,1.12553659302691
18820,"Crawfordsville, IN",2009,32,0,32,38180,0.838135149292824
18820,"Crawfordsville, IN",2010,34,8,42,38097,1.10244901173321
18820,"Crawfordsville, IN",2011,37,0,37,38332,0.965250965250965
18820,"Crawfordsville, IN",2012,40,0,40,38173,1.04786105362429
18820,"Crawfordsville, IN",2013,47,0,47,38135,1.23246361610069
18820,"Crawfordsville, IN",2014,45,0,45,38144,1.17973993288591
18820,"Crawfordsville, IN",2015,32,0,32,38242,0.836776319230166
18820,"Crawfordsville, IN",2016,46,0,46,38249,1.20264582080577
18820,"Crawfordsville, IN",2017,57,0,57,38397,1.48449097585749
18820,"Crawfordsville, IN",2018,67,0,67,38346,1.74724873520054
18860,"Crescent City, CA",1990,168,38,206,23978,8.59120860789057
18860,"Crescent City, CA",1991,108,2,110,26968,4.0789083358054
18860,"Crescent City, CA",1992,97,6,103,27225,3.78328741965106
18860,"Crescent City, CA",1993,96,16,112,27823,4.02544657297919
18860,"Crescent City, CA",1994,111,38,149,27949,5.33113886006655
18860,"Crescent City, CA",1995,55,42,97,27612,3.51296537737216
18860,"Crescent City, CA",1996,52,0,52,27754,1.87360380485696
18860,"Crescent City, CA",1997,47,0,47,28074,1.67414689748522
18860,"Crescent City, CA",1998,36,16,52,27887,1.86466812493276
18860,"Crescent City, CA",1999,32,2,34,27295,1.24564938633449
18860,"Crescent City, CA",2000,45,0,45,27440,1.6399416909621
18860,"Crescent City, CA",2001,56,0,56,27292,2.05188333577605
18860,"Crescent City, CA",2002,72,6,78,27397,2.84702704675694
18860,"Crescent City, CA",2003,113,14,127,27601,4.60128256222601
18860,"Crescent City, CA",2004,123,77,200,27950,7.15563506261181
18860,"Crescent City, CA",2005,106,0,106,28281,3.7480994307132
18860,"Crescent City, CA",2006,37,0,37,28211,1.3115451419659
18860,"Crescent City, CA",2007,76,0,76,28415,2.67464367411578
18860,"Crescent City, CA",2008,32,84,116,28496,4.0707467714767
18860,"Crescent City, CA",2009,28,0,28,28599,0.97905521172069
18860,"Crescent City, CA",2010,29,0,29,28568,1.01512181461775
18860,"Crescent City, CA",2011,25,64,89,28442,3.12917516349061
18860,"Crescent City, CA",2012,32,0,32,28189,1.13519457944588
18860,"Crescent City, CA",2013,18,0,18,27817,0.647086314124456
18860,"Crescent City, CA",2014,7,2,9,27198,0.330906684315023
18860,"Crescent City, CA",2015,20,0,20,27246,0.734052704984218
18860,"Crescent City, CA",2016,22,0,22,27422,0.8022755451827
18860,"Crescent City, CA",2017,23,0,23,27428,0.83855913664868
18860,"Crescent City, CA",2018,25,0,25,27828,0.898375736668104
18880,"Crestview-Fort Walton Beach-Destin, FL",1990,1238,167,1405,172278,8.15542321132124
18880,"Crestview-Fort Walton Beach-Destin, FL",1991,1538,520,2058,177743,11.5785150470061
18880,"Crestview-Fort Walton Beach-Destin, FL",1992,1917,381,2298,183174,12.5454485898654
18880,"Crestview-Fort Walton Beach-Destin, FL",1993,2079,450,2529,188559,13.4122476254117
18880,"Crestview-Fort Walton Beach-Destin, FL",1994,2237,783,3020,193388,15.6162740190705
18880,"Crestview-Fort Walton Beach-Destin, FL",1995,1588,1185,2773,197142,14.0660031855211
18880,"Crestview-Fort Walton Beach-Destin, FL",1996,2155,837,2992,200739,14.9049262973314
18880,"Crestview-Fort Walton Beach-Destin, FL",1997,2128,1634,3762,204275,18.4163505078938
18880,"Crestview-Fort Walton Beach-Destin, FL",1998,2175,1693,3868,206075,18.7698653402887
18880,"Crestview-Fort Walton Beach-Destin, FL",1999,2225,1136,3361,208179,16.1447600382363
18880,"Crestview-Fort Walton Beach-Destin, FL",2000,1960,993,2953,211955,13.9322025901724
18880,"Crestview-Fort Walton Beach-Destin, FL",2001,2005,599,2604,214955,12.114163429555
18880,"Crestview-Fort Walton Beach-Destin, FL",2002,2555,660,3215,220192,14.6008937654411
18880,"Crestview-Fort Walton Beach-Destin, FL",2003,2791,782,3573,223227,16.0061282909325
18880,"Crestview-Fort Walton Beach-Destin, FL",2004,3419,1884,5303,230024,23.0541160922339
18880,"Crestview-Fort Walton Beach-Destin, FL",2005,3412,3027,6439,233437,27.583459348775
18880,"Crestview-Fort Walton Beach-Destin, FL",2006,2731,336,3067,235216,13.0390789742194
18880,"Crestview-Fort Walton Beach-Destin, FL",2007,1351,251,1602,235032,6.81609312774431
18880,"Crestview-Fort Walton Beach-Destin, FL",2008,774,742,1516,235315,6.44242823449419
18880,"Crestview-Fort Walton Beach-Destin, FL",2009,620,21,641,235687,2.71970876628749
18880,"Crestview-Fort Walton Beach-Destin, FL",2010,846,89,935,235926,3.96310707594754
18880,"Crestview-Fort Walton Beach-Destin, FL",2011,1299,2,1301,238678,5.45085847878732
18880,"Crestview-Fort Walton Beach-Destin, FL",2012,1504,529,2033,246947,8.23253572628945
18880,"Crestview-Fort Walton Beach-Destin, FL",2013,1794,438,2232,251883,8.86125701218423
18880,"Crestview-Fort Walton Beach-Destin, FL",2014,1564,102,1666,255816,6.51249335459862
18880,"Crestview-Fort Walton Beach-Destin, FL",2015,1777,250,2027,260887,7.76964739523242
18880,"Crestview-Fort Walton Beach-Destin, FL",2016,2140,389,2529,265670,9.51932849023224
18880,"Crestview-Fort Walton Beach-Destin, FL",2017,2076,395,2471,271959,9.08592839361816
18880,"Crestview-Fort Walton Beach-Destin, FL",2018,2087,298,2385,278644,8.55930865189992
18900,"Crossville, TN",1990,44,25,69,34982,1.97244297067063
18900,"Crossville, TN",1991,32,18,50,36019,1.3881562508676
18900,"Crossville, TN",1992,39,25,64,36711,1.74334668083136
18900,"Crossville, TN",1993,39,40,79,37904,2.08421274799493
18900,"Crossville, TN",1994,67,77,144,39260,3.66785532348446
18900,"Crossville, TN",1995,63,24,87,40546,2.14571104424604
18900,"Crossville, TN",1996,87,86,173,41923,4.12661307635427
18900,"Crossville, TN",1997,86,14,100,43168,2.31653076352854
18900,"Crossville, TN",1998,78,8,86,44152,1.94781663344809
18900,"Crossville, TN",1999,91,24,115,45336,2.53661549320628
18900,"Crossville, TN",2000,54,47,101,47027,2.147702383737
18900,"Crossville, TN",2001,35,80,115,47849,2.40339401032414
18900,"Crossville, TN",2002,52,4,56,48918,1.14477288523652
18900,"Crossville, TN",2003,61,41,102,49607,2.05616142883061
18900,"Crossville, TN",2004,158,8,166,50584,3.28167009331014
18900,"Crossville, TN",2005,109,15,124,51758,2.39576490590827
18900,"Crossville, TN",2006,127,56,183,53363,3.42934242827427
18900,"Crossville, TN",2007,100,62,162,54534,2.97062383100451
18900,"Crossville, TN",2008,66,47,113,55184,2.04769498405335
18900,"Crossville, TN",2009,44,25,69,55672,1.23940221296163
18900,"Crossville, TN",2010,39,30,69,56197,1.22782354929978
18900,"Crossville, TN",2011,154,22,176,56529,3.11344619575793
18900,"Crossville, TN",2012,160,22,182,56900,3.19859402460457
18900,"Crossville, TN",2013,210,52,262,57341,4.56915645000959
18900,"Crossville, TN",2014,201,45,246,57851,4.25230333097094
18900,"Crossville, TN",2015,260,2,262,58137,4.50659648760686
18900,"Crossville, TN",2016,247,0,247,58506,4.22178921819984
18900,"Crossville, TN",2017,285,0,285,59005,4.83009914414033
18900,"Crossville, TN",2018,914,0,914,59673,15.3168099475475
18980,"Cullman, AL",1990,32,5,37,67792,0.54578711352372
18980,"Cullman, AL",1991,62,68,130,68571,1.89584518236572
18980,"Cullman, AL",1992,67,13,80,69599,1.14944180232475
18980,"Cullman, AL",1993,52,20,72,70437,1.02219004216534
18980,"Cullman, AL",1994,91,150,241,71451,3.37294089655848
18980,"Cullman, AL",1995,79,154,233,72288,3.22321823815848
18980,"Cullman, AL",1996,83,90,173,73412,2.3565629597341
18980,"Cullman, AL",1997,89,12,101,74087,1.36326211076167
18980,"Cullman, AL",1998,94,23,117,74977,1.56047854675434
18980,"Cullman, AL",1999,116,87,203,75685,2.68216951839863
18980,"Cullman, AL",2000,42,24,66,77473,0.851909697572057
18980,"Cullman, AL",2001,25,0,25,77415,0.322934831750953
18980,"Cullman, AL",2002,32,124,156,77443,2.01438477331715
18980,"Cullman, AL",2003,46,0,46,77657,0.592348403878594
18980,"Cullman, AL",2004,84,2,86,78131,1.10071546505228
18980,"Cullman, AL",2005,90,2,92,78692,1.16911503075281
18980,"Cullman, AL",2006,82,2,84,79044,1.06269925611052
18980,"Cullman, AL",2007,91,56,147,79576,1.84729064039409
18980,"Cullman, AL",2008,51,0,51,80273,0.635331929789593
18980,"Cullman, AL",2009,42,0,42,80351,0.522706624684198
18980,"Cullman, AL",2010,24,0,24,80454,0.298307107166828
18980,"Cullman, AL",2011,67,2,69,80401,0.858198281115907
18980,"Cullman, AL",2012,48,0,48,80273,0.597959463331382
18980,"Cullman, AL",2013,67,6,73,80688,0.904719413047789
18980,"Cullman, AL",2014,71,6,77,81067,0.949831620758138
18980,"Cullman, AL",2015,62,11,73,81764,0.892813463137811
18980,"Cullman, AL",2016,103,10,113,82456,1.37042786455807
18980,"Cullman, AL",2017,119,2,121,82836,1.46071756241248
18980,"Cullman, AL",2018,118,17,135,83442,1.6178902710865
19000,"Cullowhee, NC",1990,214,19,233,26876,8.66944485786575
19000,"Cullowhee, NC",1991,167,27,194,27210,7.12973171628078
19000,"Cullowhee, NC",1992,258,2,260,27561,9.43361997024781
19000,"Cullowhee, NC",1993,241,6,247,27729,8.90764181903422
19000,"Cullowhee, NC",1994,248,27,275,28460,9.66268446943078
19000,"Cullowhee, NC",1995,268,26,294,28995,10.139679255044
19000,"Cullowhee, NC",1996,318,12,330,29401,11.2241080235366
19000,"Cullowhee, NC",1997,342,34,376,29661,12.6765786723307
19000,"Cullowhee, NC",1998,391,56,447,29960,14.9198931909212
19000,"Cullowhee, NC",1999,371,63,434,30271,14.3371543721714
19000,"Cullowhee, NC",2000,424,321,745,33303,22.3703570248927
19000,"Cullowhee, NC",2001,428,16,444,33885,13.1031429836211
19000,"Cullowhee, NC",2002,860,116,976,34587,28.2186948853616
19000,"Cullowhee, NC",2003,412,147,559,35711,15.6534401164907
19000,"Cullowhee, NC",2004,505,173,678,36555,18.5473943373
19000,"Cullowhee, NC",2005,546,223,769,37075,20.7417397167903
19000,"Cullowhee, NC",2006,560,259,819,38129,21.4797136038186
19000,"Cullowhee, NC",2007,484,0,484,38404,12.6028538693886
19000,"Cullowhee, NC",2008,281,21,302,38994,7.74478124839719
19000,"Cullowhee, NC",2009,155,98,253,39856,6.3478522681654
19000,"Cullowhee, NC",2010,155,0,155,40357,3.84072156007632
19000,"Cullowhee, NC",2011,99,51,150,40223,3.72920965616687
19000,"Cullowhee, NC",2012,125,0,125,40617,3.07752911342541
19000,"Cullowhee, NC",2013,150,317,467,40984,11.3946906109701
19000,"Cullowhee, NC",2014,169,42,211,40907,5.15804141100545
19000,"Cullowhee, NC",2015,149,42,191,41281,4.62682590053536
19000,"Cullowhee, NC",2016,154,14,168,42573,3.94616306109506
19000,"Cullowhee, NC",2017,212,18,230,43192,5.32506019633265
19000,"Cullowhee, NC",2018,241,180,421,43327,9.71680476377317
19060,"Cumberland, MD-WV",1990,269,54,323,101566,3.18019809778863
19060,"Cumberland, MD-WV",1991,256,60,316,101756,3.10546798223201
19060,"Cumberland, MD-WV",1992,289,102,391,101691,3.84498136511589
19060,"Cumberland, MD-WV",1993,283,62,345,101465,3.4001872566895
19060,"Cumberland, MD-WV",1994,271,44,315,101344,3.10822544995264
19060,"Cumberland, MD-WV",1995,285,15,300,101264,2.96255332595987
19060,"Cumberland, MD-WV",1996,228,13,241,100720,2.39277204130262
19060,"Cumberland, MD-WV",1997,250,22,272,100482,2.70695248900301
19060,"Cumberland, MD-WV",1998,186,27,213,100470,2.12003583159152
19060,"Cumberland, MD-WV",1999,385,7,392,99952,3.92188250360173
19060,"Cumberland, MD-WV",2000,368,39,407,101858,3.99575880146871
19060,"Cumberland, MD-WV",2001,144,7,151,101596,1.48627898736171
19060,"Cumberland, MD-WV",2002,196,12,208,101462,2.05002858212927
19060,"Cumberland, MD-WV",2003,217,0,217,101457,2.13883714282898
19060,"Cumberland, MD-WV",2004,211,20,231,101658,2.27232485392197
19060,"Cumberland, MD-WV",2005,235,10,245,101172,2.42161862966038
19060,"Cumberland, MD-WV",2006,234,0,234,101304,2.30987917555082
19060,"Cumberland, MD-WV",2007,244,2,246,101981,2.41221403987017
19060,"Cumberland, MD-WV",2008,143,9,152,102462,1.48347680115555
19060,"Cumberland, MD-WV",2009,124,75,199,103181,1.92864965449065
19060,"Cumberland, MD-WV",2010,95,66,161,103145,1.56090939938921
19060,"Cumberland, MD-WV",2011,112,6,118,102590,1.15020957208305
19060,"Cumberland, MD-WV",2012,88,0,88,101793,0.864499523542876
19060,"Cumberland, MD-WV",2013,69,20,89,101229,0.879194697171759
19060,"Cumberland, MD-WV",2014,52,5,57,100545,0.566910338654334
19060,"Cumberland, MD-WV",2015,55,29,84,99846,0.841295595216634
19060,"Cumberland, MD-WV",2016,69,16,85,99401,0.855122181869398
19060,"Cumberland, MD-WV",2017,50,0,50,98566,0.507274313657854
19060,"Cumberland, MD-WV",2018,67,0,67,97915,0.684266966246234
19100,"Dallas-Fort Worth-Arlington, TX",1990,14705,5229,19934,4033854,4.94167612412348
19100,"Dallas-Fort Worth-Arlington, TX",1991,15531,4068,19599,4115915,4.76176014324883
19100,"Dallas-Fort Worth-Arlington, TX",1992,20110,1872,21982,4187793,5.24906555792037
19100,"Dallas-Fort Worth-Arlington, TX",1993,21848,4787,26635,4258204,6.25498449581091
19100,"Dallas-Fort Worth-Arlington, TX",1994,22384,11641,34025,4341602,7.83696893450851
19100,"Dallas-Fort Worth-Arlington, TX",1995,22125,14517,36642,4429963,8.27140091237782
19100,"Dallas-Fort Worth-Arlington, TX",1996,25540,13289,38829,4535091,8.56190096295752
19100,"Dallas-Fort Worth-Arlington, TX",1997,26580,17730,44310,4655023,9.51874996106356
19100,"Dallas-Fort Worth-Arlington, TX",1998,32063,22541,54604,4779033,11.4257424043734
19100,"Dallas-Fort Worth-Arlington, TX",1999,32596,15121,47717,4896974,9.74418079409856
19100,"Dallas-Fort Worth-Arlington, TX",2000,36164,8604,44768,5235385,8.55104256898012
19100,"Dallas-Fort Worth-Arlington, TX",2001,37873,11990,49863,5376413,9.27439912075207
19100,"Dallas-Fort Worth-Arlington, TX",2002,38357,13330,51687,5482944,9.42686994432188
19100,"Dallas-Fort Worth-Arlington, TX",2003,40664,12278,52942,5575785,9.49498590781388
19100,"Dallas-Fort Worth-Arlington, TX",2004,46011,8281,54292,5666333,9.58150535805079
19100,"Dallas-Fort Worth-Arlington, TX",2005,49639,10420,60059,5776543,10.3970488923912
19100,"Dallas-Fort Worth-Arlington, TX",2006,43771,12923,56694,5942755,9.54001973832002
19100,"Dallas-Fort Worth-Arlington, TX",2007,28306,15412,43718,6081907,7.18820593606578
19100,"Dallas-Fort Worth-Arlington, TX",2008,18056,18438,36494,6211115,5.87559560561993
19100,"Dallas-Fort Worth-Arlington, TX",2009,14201,6327,20528,6341740,3.23696651076834
19100,"Dallas-Fort Worth-Arlington, TX",2010,14501,5138,19639,6452028,3.04384915874513
19100,"Dallas-Fort Worth-Arlington, TX",2011,14139,10804,24943,6570598,3.79615371386288
19100,"Dallas-Fort Worth-Arlington, TX",2012,18204,16968,35172,6706434,5.24451593797837
19100,"Dallas-Fort Worth-Arlington, TX",2013,21361,16704,38065,6817518,5.58341026749031
19100,"Dallas-Fort Worth-Arlington, TX",2014,22550,18868,41418,6955259,5.95491842934965
19100,"Dallas-Fort Worth-Arlington, TX",2015,29038,28108,57146,7109280,8.038226093219
19100,"Dallas-Fort Worth-Arlington, TX",2016,29703,26097,55800,7262951,7.68282754489188
19100,"Dallas-Fort Worth-Arlington, TX",2017,34604,27920,62524,7407944,8.44012859708443
19100,"Dallas-Fort Worth-Arlington, TX",2018,36832,27061,63893,7539711,8.47419748581875
19140,"Dalton, GA",1990,416,26,442,98942,4.46726364941077
19140,"Dalton, GA",1991,426,34,460,100302,4.58614982752089
19140,"Dalton, GA",1992,521,28,549,101658,5.40046036711326
19140,"Dalton, GA",1993,370,51,421,103310,4.0751137353596
19140,"Dalton, GA",1994,561,34,595,105868,5.62020629463105
19140,"Dalton, GA",1995,597,143,740,108371,6.82839505033635
19140,"Dalton, GA",1996,582,138,720,110573,6.51153536577646
19140,"Dalton, GA",1997,513,171,684,113054,6.05020609620181
19140,"Dalton, GA",1998,522,144,666,114697,5.80660348570582
19140,"Dalton, GA",1999,523,195,718,117146,6.12910385331125
19140,"Dalton, GA",2000,567,532,1099,120959,9.08572326160104
19140,"Dalton, GA",2001,563,322,885,124015,7.13623352013869
19140,"Dalton, GA",2002,572,144,716,126208,5.67317444219067
19140,"Dalton, GA",2003,596,263,859,128476,6.68607366356362
19140,"Dalton, GA",2004,651,162,813,131307,6.19159679225022
19140,"Dalton, GA",2005,852,185,1037,133885,7.74545318743698
19140,"Dalton, GA",2006,715,218,933,136581,6.83111120873328
19140,"Dalton, GA",2007,522,148,670,138792,4.82736757161796
19140,"Dalton, GA",2008,208,94,302,140415,2.15076736815867
19140,"Dalton, GA",2009,129,9,138,140897,0.979438880884618
19140,"Dalton, GA",2010,90,11,101,142274,0.709897802831157
19140,"Dalton, GA",2011,63,0,63,142280,0.442788867022772
19140,"Dalton, GA",2012,63,0,63,142280,0.442788867022772
19140,"Dalton, GA",2013,69,0,69,141944,0.486107197204531
19140,"Dalton, GA",2014,115,6,121,142369,0.849904122386194
19140,"Dalton, GA",2015,149,10,159,143127,1.11090150705318
19140,"Dalton, GA",2016,164,9,173,143683,1.20403944795139
19140,"Dalton, GA",2017,227,116,343,143872,2.38406361209964
19140,"Dalton, GA",2018,288,33,321,143983,2.22942986324774
19180,"Danville, IL",1990,42,8,50,88146,0.567240714269507
19180,"Danville, IL",1991,39,10,49,87939,0.557204425795154
19180,"Danville, IL",1992,40,5,45,87858,0.51219012497439
19180,"Danville, IL",1993,42,6,48,87616,0.547845142439737
19180,"Danville, IL",1994,52,18,70,87762,0.797611722613432
19180,"Danville, IL",1995,42,93,135,86377,1.56291605404216
19180,"Danville, IL",1996,52,135,187,85072,2.1981380477713
19180,"Danville, IL",1997,50,9,59,85014,0.69400334062625
19180,"Danville, IL",1998,60,88,148,84704,1.74726105024556
19180,"Danville, IL",1999,68,125,193,83953,2.29890533989256
19180,"Danville, IL",2000,64,6,70,83821,0.83511291919686
19180,"Danville, IL",2001,58,2,60,83646,0.717308657915501
19180,"Danville, IL",2002,60,2,62,83299,0.744306654341589
19180,"Danville, IL",2003,66,4,70,82996,0.843414140440503
19180,"Danville, IL",2004,46,76,122,82955,1.47067687300344
19180,"Danville, IL",2005,45,0,45,82728,0.543951261966928
19180,"Danville, IL",2006,35,0,35,82715,0.423139696548389
19180,"Danville, IL",2007,23,24,47,82258,0.571372997155292
19180,"Danville, IL",2008,12,0,12,81930,0.146466495789088
19180,"Danville, IL",2009,10,0,10,81710,0.122384041121038
19180,"Danville, IL",2010,10,3,13,81639,0.159237619275101
19180,"Danville, IL",2011,10,2,12,81407,0.147407471101994
19180,"Danville, IL",2012,9,4,13,80864,0.160763751483973
19180,"Danville, IL",2013,2,19,21,80588,0.260584702437087
19180,"Danville, IL",2014,6,0,6,79786,0.0752011631113228
19180,"Danville, IL",2015,10,0,10,79173,0.126305685018883
19180,"Danville, IL",2016,10,0,10,78494,0.127398272479425
19180,"Danville, IL",2017,54,50,104,77776,1.33717342110677
19180,"Danville, IL",2018,11,54,65,76806,0.846288050412728
19220,"Danville, KY",1990,88,46,134,45800,2.92576419213974
19220,"Danville, KY",1991,117,64,181,46028,3.93238898062049
19220,"Danville, KY",1992,118,42,160,46364,3.45095332585627
19220,"Danville, KY",1993,125,105,230,47085,4.8847828395455
19220,"Danville, KY",1994,150,36,186,47613,3.90649612500788
19220,"Danville, KY",1995,128,86,214,48099,4.44915694712988
19220,"Danville, KY",1996,130,60,190,48677,3.90328081023892
19220,"Danville, KY",1997,131,60,191,49010,3.89716384411345
19220,"Danville, KY",1998,113,63,176,49504,3.55526826115061
19220,"Danville, KY",1999,117,56,173,49919,3.46561429515816
19220,"Danville, KY",2000,325,27,352,51083,6.89074643227688
19220,"Danville, KY",2001,304,28,332,51176,6.48741597623886
19220,"Danville, KY",2002,325,15,340,51300,6.62768031189084
19220,"Danville, KY",2003,295,35,330,51560,6.40031031807603
19220,"Danville, KY",2004,315,71,386,52141,7.40300339464145
19220,"Danville, KY",2005,250,37,287,52641,5.4520240876883
19220,"Danville, KY",2006,214,28,242,52869,4.5773515670809
19220,"Danville, KY",2007,185,50,235,52987,4.43505010662993
19220,"Danville, KY",2008,99,16,115,52952,2.17177821423176
19220,"Danville, KY",2009,61,29,90,53073,1.69577751399016
19220,"Danville, KY",2010,70,17,87,53389,1.62954915806627
19220,"Danville, KY",2011,45,19,64,53515,1.19592637578249
19220,"Danville, KY",2012,60,34,94,53427,1.75941003612406
19220,"Danville, KY",2013,57,8,65,54074,1.20205644117321
19220,"Danville, KY",2014,57,10,67,54239,1.23527351167979
19220,"Danville, KY",2015,52,72,124,54105,2.29183994085574
19220,"Danville, KY",2016,58,5,63,54309,1.1600287245208
19220,"Danville, KY",2017,80,7,87,54456,1.59762009695901
19220,"Danville, KY",2018,79,2,81,54744,1.47961420429636
19260,"Danville, VA",1990,301,97,398,108977,3.65214678326619
19260,"Danville, VA",1991,279,122,401,109157,3.67360773931127
19260,"Danville, VA",1992,353,18,371,109088,3.40092402464066
19260,"Danville, VA",1993,445,78,523,109222,4.78841259086997
19260,"Danville, VA",1994,335,65,400,109703,3.64620839904105
19260,"Danville, VA",1995,320,46,366,109483,3.34298475562416
19260,"Danville, VA",1996,319,45,364,109171,3.33421879436847
19260,"Danville, VA",1997,308,14,322,108806,2.95939562156499
19260,"Danville, VA",1998,300,61,361,108277,3.33404139383249
19260,"Danville, VA",1999,308,5,313,107762,2.90454891334608
19260,"Danville, VA",2000,290,68,358,109939,3.25635124932917
19260,"Danville, VA",2001,292,14,306,109452,2.79574608047363
19260,"Danville, VA",2002,244,18,262,108904,2.40578858444134
19260,"Danville, VA",2003,277,51,328,108622,3.01964611220563
19260,"Danville, VA",2004,283,95,378,108067,3.49783004987647
19260,"Danville, VA",2005,283,27,310,107553,2.88229988935688
19260,"Danville, VA",2006,277,23,300,107172,2.79923860709887
19260,"Danville, VA",2007,174,114,288,106965,2.69246949936895
19260,"Danville, VA",2008,137,15,152,107237,1.41742122588286
19260,"Danville, VA",2009,83,44,127,106882,1.18822626822103
19260,"Danville, VA",2010,135,25,160,106513,1.50216405509187
19260,"Danville, VA",2011,87,55,142,105902,1.34086230666088
19260,"Danville, VA",2012,112,49,161,105605,1.5245490270347
19260,"Danville, VA",2013,151,45,196,105191,1.86327727657309
19260,"Danville, VA",2014,85,0,85,104645,0.812270055903292
19260,"Danville, VA",2015,13,0,13,103937,0.125075767051194
19260,"Danville, VA",2016,57,0,57,103351,0.551518611334191
19260,"Danville, VA",2017,49,0,49,102363,0.478688588650196
19260,"Danville, VA",2018,53,0,53,101642,0.521437988233211
19300,"Daphne-Fairhope-Foley, AL",1990,316,12,328,98918,3.31587779777189
19300,"Daphne-Fairhope-Foley, AL",1991,1030,179,1209,102228,11.8265054583871
19300,"Daphne-Fairhope-Foley, AL",1992,1408,34,1442,106234,13.57380876179
19300,"Daphne-Fairhope-Foley, AL",1993,1964,600,2564,110872,23.1257666498304
19300,"Daphne-Fairhope-Foley, AL",1994,1932,1277,3209,115823,27.7060687428231
19300,"Daphne-Fairhope-Foley, AL",1995,1609,1494,3103,119947,25.8697591436218
19300,"Daphne-Fairhope-Foley, AL",1996,1900,791,2691,124243,21.6591679209291
19300,"Daphne-Fairhope-Foley, AL",1997,1640,666,2306,128760,17.9092885989438
19300,"Daphne-Fairhope-Foley, AL",1998,1639,1020,2659,132798,20.0228919110228
19300,"Daphne-Fairhope-Foley, AL",1999,1866,690,2556,135671,18.8396930810564
19300,"Daphne-Fairhope-Foley, AL",2000,1841,631,2472,141342,17.4894935687906
19300,"Daphne-Fairhope-Foley, AL",2001,1735,352,2087,144875,14.4055220017256
19300,"Daphne-Fairhope-Foley, AL",2002,2009,197,2206,147957,14.9097372885365
19300,"Daphne-Fairhope-Foley, AL",2003,2932,986,3918,151509,25.8598499099063
19300,"Daphne-Fairhope-Foley, AL",2004,3442,1317,4759,156266,30.4544814610984
19300,"Daphne-Fairhope-Foley, AL",2005,4145,2570,6715,162183,41.4038462724207
19300,"Daphne-Fairhope-Foley, AL",2006,2776,2910,5686,168121,33.8208790097608
19300,"Daphne-Fairhope-Foley, AL",2007,1992,279,2271,172404,13.1725482007378
19300,"Daphne-Fairhope-Foley, AL",2008,1268,898,2166,175827,12.318927127233
19300,"Daphne-Fairhope-Foley, AL",2009,788,195,983,179406,5.47919244618352
19300,"Daphne-Fairhope-Foley, AL",2010,682,14,696,183111,3.80097318020217
19300,"Daphne-Fairhope-Foley, AL",2011,738,18,756,186540,4.05275008041171
19300,"Daphne-Fairhope-Foley, AL",2012,1184,0,1184,190143,6.22689239151586
19300,"Daphne-Fairhope-Foley, AL",2013,1217,110,1327,194886,6.80910891495541
19300,"Daphne-Fairhope-Foley, AL",2014,1364,20,1384,199189,6.94817484901275
19300,"Daphne-Fairhope-Foley, AL",2015,1622,581,2203,202995,10.8524840513313
19300,"Daphne-Fairhope-Foley, AL",2016,2137,383,2520,207712,12.1321830226467
19300,"Daphne-Fairhope-Foley, AL",2017,2207,210,2417,212619,11.3677517061034
19300,"Daphne-Fairhope-Foley, AL",2018,2459,588,3047,218022,13.9756538330994
19340,"Davenport-Moline-Rock Island, IA-IL",1990,647,12,659,368312,1.78924390190925
19340,"Davenport-Moline-Rock Island, IA-IL",1991,754,46,800,370954,2.15660162715593
19340,"Davenport-Moline-Rock Island, IA-IL",1992,836,43,879,373523,2.35326874114847
19340,"Davenport-Moline-Rock Island, IA-IL",1993,936,109,1045,374139,2.79307957737632
19340,"Davenport-Moline-Rock Island, IA-IL",1994,803,45,848,374356,2.26522347711804
19340,"Davenport-Moline-Rock Island, IA-IL",1995,737,195,932,374905,2.4859631106547
19340,"Davenport-Moline-Rock Island, IA-IL",1996,803,501,1304,374634,3.48073052632703
19340,"Davenport-Moline-Rock Island, IA-IL",1997,810,712,1522,374929,4.05943525307458
19340,"Davenport-Moline-Rock Island, IA-IL",1998,910,392,1302,375472,3.46763540290621
19340,"Davenport-Moline-Rock Island, IA-IL",1999,962,260,1222,376613,3.2447100870124
19340,"Davenport-Moline-Rock Island, IA-IL",2000,813,256,1069,375763,2.84487828764407
19340,"Davenport-Moline-Rock Island, IA-IL",2001,812,266,1078,374561,2.87803588734545
19340,"Davenport-Moline-Rock Island, IA-IL",2002,924,377,1301,373740,3.48102959276502
19340,"Davenport-Moline-Rock Island, IA-IL",2003,927,352,1279,372975,3.42918426167974
19340,"Davenport-Moline-Rock Island, IA-IL",2004,929,341,1270,372740,3.40720072973118
19340,"Davenport-Moline-Rock Island, IA-IL",2005,1038,439,1477,372876,3.96110235037921
19340,"Davenport-Moline-Rock Island, IA-IL",2006,851,304,1155,373762,3.09020178616339
19340,"Davenport-Moline-Rock Island, IA-IL",2007,688,502,1190,375121,3.1723097347256
19340,"Davenport-Moline-Rock Island, IA-IL",2008,421,66,487,376467,1.29360607968295
19340,"Davenport-Moline-Rock Island, IA-IL",2009,371,356,727,378108,1.9227310715457
19340,"Davenport-Moline-Rock Island, IA-IL",2010,422,280,702,379753,1.84856999154714
19340,"Davenport-Moline-Rock Island, IA-IL",2011,577,58,635,380675,1.66808957772378
19340,"Davenport-Moline-Rock Island, IA-IL",2012,545,141,686,382455,1.79367507288439
19340,"Davenport-Moline-Rock Island, IA-IL",2013,510,107,617,383890,1.60723123811509
19340,"Davenport-Moline-Rock Island, IA-IL",2014,458,197,655,384137,1.70512082928747
19340,"Davenport-Moline-Rock Island, IA-IL",2015,431,320,751,383599,1.95777361254852
19340,"Davenport-Moline-Rock Island, IA-IL",2016,482,165,647,382563,1.69122471331519
19340,"Davenport-Moline-Rock Island, IA-IL",2017,443,307,750,381854,1.96410146286277
19340,"Davenport-Moline-Rock Island, IA-IL",2018,490,69,559,381451,1.46545690009988
19380,"Dayton, OH",1990,1780,461,2241,804500,2.78558110627719
19380,"Dayton, OH",1991,1727,562,2289,810640,2.8236948583835
19380,"Dayton, OH",1992,1899,537,2436,815979,2.98537094704643
19380,"Dayton, OH",1993,2024,707,2731,819103,3.33413502331209
19380,"Dayton, OH",1994,2028,1141,3169,817743,3.87530067515099
19380,"Dayton, OH",1995,1873,918,2791,819159,3.40715294588718
19380,"Dayton, OH",1996,1890,1706,3596,818417,4.39384812387817
19380,"Dayton, OH",1997,1657,1590,3247,816152,3.97842558739058
19380,"Dayton, OH",1998,2029,1266,3295,816776,4.03415379492052
19380,"Dayton, OH",1999,1945,1305,3250,814304,3.99113844461037
19380,"Dayton, OH",2000,1842,667,2509,805938,3.11314269832171
19380,"Dayton, OH",2001,2111,506,2617,804479,3.25303705876723
19380,"Dayton, OH",2002,2362,707,3069,804286,3.8158068149887
19380,"Dayton, OH",2003,2653,1265,3918,804926,4.86752819513843
19380,"Dayton, OH",2004,2479,556,3035,805930,3.76583574255829
19380,"Dayton, OH",2005,2630,416,3046,804766,3.78495115350301
19380,"Dayton, OH",2006,1769,281,2050,803498,2.55134424727877
19380,"Dayton, OH",2007,1438,76,1514,801852,1.88812898140804
19380,"Dayton, OH",2008,958,237,1195,800209,1.49335985973664
19380,"Dayton, OH",2009,749,30,779,798895,0.975096852527554
19380,"Dayton, OH",2010,649,82,731,799664,0.914133936253226
19380,"Dayton, OH",2011,712,15,727,800755,0.907893175815324
19380,"Dayton, OH",2012,889,225,1114,801539,1.3898263216138
19380,"Dayton, OH",2013,781,35,816,801341,1.01829308621423
19380,"Dayton, OH",2014,743,36,779,800998,0.972536760391412
19380,"Dayton, OH",2015,857,123,980,800198,1.22469688752034
19380,"Dayton, OH",2016,957,325,1282,801765,1.59897226743497
19380,"Dayton, OH",2017,1083,168,1251,803713,1.55652577474795
19380,"Dayton, OH",2018,1138,439,1577,806548,1.95524630896115
19420,"Dayton, TN",1990,28,0,28,24373,1.14881221023263
19420,"Dayton, TN",1991,17,5,22,24710,0.890327802509106
19420,"Dayton, TN",1992,16,0,16,25264,0.633312222925903
19420,"Dayton, TN",1993,19,0,19,25765,0.737434504172327
19420,"Dayton, TN",1994,13,0,13,26242,0.495389070954958
19420,"Dayton, TN",1995,14,2,16,26760,0.597907324364723
19420,"Dayton, TN",1996,149,4,153,27199,5.62520680907386
19420,"Dayton, TN",1997,112,2,114,27649,4.12311476002749
19420,"Dayton, TN",1998,144,4,148,27806,5.32259224627778
19420,"Dayton, TN",1999,146,0,146,28129,5.19037292473959
19420,"Dayton, TN",2000,122,0,122,28428,4.29154354861404
19420,"Dayton, TN",2001,133,0,133,28601,4.65018705639663
19420,"Dayton, TN",2002,145,0,145,28884,5.02008032128514
19420,"Dayton, TN",2003,197,0,197,29257,6.7334313155826
19420,"Dayton, TN",2004,178,0,178,29469,6.04024568190302
19420,"Dayton, TN",2005,129,0,129,29919,4.31164143186604
19420,"Dayton, TN",2006,160,0,160,30440,5.25624178712221
19420,"Dayton, TN",2007,134,7,141,30769,4.58253436900777
19420,"Dayton, TN",2008,98,16,114,31308,3.6412418551169
19420,"Dayton, TN",2009,57,6,63,31717,1.9863164864268399
19420,"Dayton, TN",2010,52,0,52,31854,1.63244804420167
19420,"Dayton, TN",2011,44,0,44,32076,1.37174211248285
19420,"Dayton, TN",2012,44,0,44,32332,1.36088086106644
19420,"Dayton, TN",2013,75,16,91,32491,2.80077559939676
19420,"Dayton, TN",2014,50,12,62,32558,1.90429387554518
19420,"Dayton, TN",2015,12,0,12,32372,0.370690720375633
19420,"Dayton, TN",2016,69,16,85,32425,2.62143407864302
19420,"Dayton, TN",2017,95,2,97,32742,2.96255573880643
19420,"Dayton, TN",2018,101,0,101,33044,3.05653068635758
19460,"Decatur, AL",1990,485,96,581,132076,4.39898240407038
19460,"Decatur, AL",1991,424,65,489,134006,3.64909033923854
19460,"Decatur, AL",1992,567,18,585,135571,4.31508213408472
19460,"Decatur, AL",1993,525,76,601,137449,4.37253090237106
19460,"Decatur, AL",1994,399,39,438,138206,3.1691822352141
19460,"Decatur, AL",1995,343,165,508,139480,3.64209922569544
19460,"Decatur, AL",1996,366,297,663,140478,4.71960022209883
19460,"Decatur, AL",1997,337,60,397,141665,2.80238591042248
19460,"Decatur, AL",1998,392,160,552,142713,3.86790271383826
19460,"Decatur, AL",1999,341,99,440,143538,3.06539034959384
19460,"Decatur, AL",2000,375,24,399,146095,2.73109962695506
19460,"Decatur, AL",2001,308,5,313,146552,2.13576068562694
19460,"Decatur, AL",2002,409,0,409,146464,2.79249508411623
19460,"Decatur, AL",2003,423,6,429,147386,2.91072422075367
19460,"Decatur, AL",2004,374,0,374,147324,2.53862235616736
19460,"Decatur, AL",2005,400,0,400,148399,2.69543595307246
19460,"Decatur, AL",2006,336,0,336,149519,2.24720604070386
19460,"Decatur, AL",2007,403,64,467,150690,3.09907757648152
19460,"Decatur, AL",2008,183,12,195,151890,1.28382381986964
19460,"Decatur, AL",2009,93,0,93,153269,0.606776321369618
19460,"Decatur, AL",2010,145,20,165,153948,1.07179047470574
19460,"Decatur, AL",2011,103,0,103,154062,0.668562007503473
19460,"Decatur, AL",2012,142,0,142,153899,0.92268305836945
19460,"Decatur, AL",2013,140,0,140,153151,0.914130498658187
19460,"Decatur, AL",2014,136,0,136,152906,0.889435339358822
19460,"Decatur, AL",2015,131,8,139,152419,0.911959795038676
19460,"Decatur, AL",2016,190,4,194,152203,1.27461350958917
19460,"Decatur, AL",2017,160,0,160,151888,1.05340777414937
19460,"Decatur, AL",2018,152,0,152,152046,0.999697459979217
19500,"Decatur, IL",1990,222,20,242,117216,2.06456456456456
19500,"Decatur, IL",1991,213,8,221,117709,1.87751149020041
19500,"Decatur, IL",1992,236,30,266,117800,2.25806451612903
19500,"Decatur, IL",1993,240,27,267,117219,2.277787730658
19500,"Decatur, IL",1994,204,115,319,116562,2.73674096189153
19500,"Decatur, IL",1995,180,222,402,116147,3.46113115276331
19500,"Decatur, IL",1996,242,96,338,115225,2.93339119114775
19500,"Decatur, IL",1997,199,179,378,114157,3.31122927196755
19500,"Decatur, IL",1998,279,62,341,113699,2.99914687024512
19500,"Decatur, IL",1999,249,16,265,113185,2.34129964217873
19500,"Decatur, IL",2000,241,120,361,114499,3.15286596389488
19500,"Decatur, IL",2001,215,10,225,113604,1.98056406464561
19500,"Decatur, IL",2002,174,219,393,112564,3.49134714473544
19500,"Decatur, IL",2003,438,88,526,111572,4.71444448427921
19500,"Decatur, IL",2004,324,33,357,111181,3.21098029339545
19500,"Decatur, IL",2005,226,80,306,111083,2.7546969383254
19500,"Decatur, IL",2006,325,86,411,110808,3.70911847520035
19500,"Decatur, IL",2007,134,12,146,110751,1.31827252124134
19500,"Decatur, IL",2008,174,279,453,110588,4.09628531124534
19500,"Decatur, IL",2009,93,0,93,110732,0.83986562150056
19500,"Decatur, IL",2010,95,6,101,110784,0.911683997689197
19500,"Decatur, IL",2011,70,14,84,110671,0.759006424447235
19500,"Decatur, IL",2012,61,18,79,110130,0.717334059747571
19500,"Decatur, IL",2013,67,12,79,109563,0.721046338636218
19500,"Decatur, IL",2014,41,12,53,108520,0.488389237007003
19500,"Decatur, IL",2015,45,2,47,107363,0.43776720099103
19500,"Decatur, IL",2016,56,0,56,106430,0.526167433994175
19500,"Decatur, IL",2017,39,0,39,105533,0.369552651777169
19500,"Decatur, IL",2018,35,2,37,104712,0.353350141340057
19540,"Decatur, IN",1990,80,40,120,31152,3.85208012326656
19540,"Decatur, IN",1991,116,8,124,31345,3.95597383952784
19540,"Decatur, IN",1992,119,54,173,31472,5.49694966954753
19540,"Decatur, IN",1993,77,4,81,31652,2.55907999494503
19540,"Decatur, IN",1994,98,84,182,32064,5.67614770459082
19540,"Decatur, IN",1995,103,28,131,32390,4.04445816610065
19540,"Decatur, IN",1996,118,20,138,32657,4.22574027007992
19540,"Decatur, IN",1997,107,10,117,32729,3.57481132940206
19540,"Decatur, IN",1998,128,116,244,33067,7.37895787340853
19540,"Decatur, IN",1999,120,76,196,33231,5.89810718907045
19540,"Decatur, IN",2000,103,18,121,33597,3.60151203976545
19540,"Decatur, IN",2001,94,2,96,33556,2.8608892597449
19540,"Decatur, IN",2002,136,4,140,33523,4.17623721027354
19540,"Decatur, IN",2003,98,0,98,33746,2.904047887157
19540,"Decatur, IN",2004,102,26,128,33822,3.78451895216131
19540,"Decatur, IN",2005,141,18,159,33867,4.69483568075117
19540,"Decatur, IN",2006,90,16,106,33887,3.128043202408
19540,"Decatur, IN",2007,96,57,153,33962,4.50503503916141
19540,"Decatur, IN",2008,53,12,65,34214,1.8998070965102
19540,"Decatur, IN",2009,46,0,46,34351,1.33911676515968
19540,"Decatur, IN",2010,44,0,44,34451,1.27717627935328
19540,"Decatur, IN",2011,38,0,38,34374,1.10548670506778
19540,"Decatur, IN",2012,48,18,66,34408,1.91815856777494
19540,"Decatur, IN",2013,56,0,56,34654,1.61597506781324
19540,"Decatur, IN",2014,63,16,79,34768,2.27220432581684
19540,"Decatur, IN",2015,69,0,69,34958,1.97379712798215
19540,"Decatur, IN",2016,12,12,24,35192,0.681973175721755
19540,"Decatur, IN",2017,71,14,85,35422,2.39963864265146
19540,"Decatur, IN",2018,83,8,91,35636,2.55359748568863
19580,"Defiance, OH",1990,103,2,105,39384,2.66605728214503
19580,"Defiance, OH",1991,97,2,99,39513,2.50550451750057
19580,"Defiance, OH",1992,119,3,122,39421,3.09479718931534
19580,"Defiance, OH",1993,118,8,126,39543,3.18640467339352
19580,"Defiance, OH",1994,169,90,259,39572,6.54503184069544
19580,"Defiance, OH",1995,172,8,180,39909,4.51026084341878
19580,"Defiance, OH",1996,179,19,198,40204,4.92488309620933
19580,"Defiance, OH",1997,128,26,154,40012,3.84884534639608
19580,"Defiance, OH",1998,149,19,168,39847,4.21612668456847
19580,"Defiance, OH",1999,126,28,154,39691,3.87997278980121
19580,"Defiance, OH",2000,134,8,142,39461,3.59848964800689
19580,"Defiance, OH",2001,114,10,124,39456,3.14274128142741
19580,"Defiance, OH",2002,128,14,142,39303,3.61295575401369
19580,"Defiance, OH",2003,126,20,146,39209,3.723634879747
19580,"Defiance, OH",2004,127,13,140,39115,3.57918956921897
19580,"Defiance, OH",2005,116,85,201,39049,5.14737893415965
19580,"Defiance, OH",2006,114,66,180,39154,4.59723144506308
19580,"Defiance, OH",2007,88,14,102,39123,2.60716202745188
19580,"Defiance, OH",2008,45,18,63,39250,1.60509554140127
19580,"Defiance, OH",2009,39,14,53,39060,1.35688684075781
19580,"Defiance, OH",2010,51,4,55,39086,1.40715345648058
19580,"Defiance, OH",2011,24,0,24,39003,0.615337281747558
19580,"Defiance, OH",2012,29,6,35,38826,0.901457786019678
19580,"Defiance, OH",2013,32,12,44,38565,1.14093089589006
19580,"Defiance, OH",2014,22,0,22,38524,0.571072578133112
19580,"Defiance, OH",2015,16,6,22,38328,0.573992903360467
19580,"Defiance, OH",2016,34,8,42,38156,1.10074431282105
19580,"Defiance, OH",2017,31,7,38,38224,0.994139807450816
19580,"Defiance, OH",2018,35,4,39,38165,1.02187868465872
19620,"Del Rio, TX",1990,58,0,58,38564,1.50399336168447
19620,"Del Rio, TX",1991,62,4,66,39516,1.67020953537807
19620,"Del Rio, TX",1992,73,14,87,40034,2.17315282010291
19620,"Del Rio, TX",1993,73,2,75,40462,1.85359102367654
19620,"Del Rio, TX",1994,92,16,108,41375,2.61027190332326
19620,"Del Rio, TX",1995,124,94,218,41991,5.19158867376343
19620,"Del Rio, TX",1996,148,8,156,42555,3.66584420162143
19620,"Del Rio, TX",1997,127,25,152,42841,3.54800308116057
19620,"Del Rio, TX",1998,135,7,142,43649,3.25322458704667
19620,"Del Rio, TX",1999,122,5,127,44435,2.85810734781141
19620,"Del Rio, TX",2000,117,10,127,45020,2.82096845846291
19620,"Del Rio, TX",2001,118,15,133,45144,2.94612794612795
19620,"Del Rio, TX",2002,122,5,127,45495,2.79151555115947
19620,"Del Rio, TX",2003,113,29,142,46184,3.07465789017842
19620,"Del Rio, TX",2004,127,3,130,46941,2.76943397030315
19620,"Del Rio, TX",2005,148,8,156,47108,3.31153944128386
19620,"Del Rio, TX",2006,155,128,283,47401,5.97033817851944
19620,"Del Rio, TX",2007,185,0,185,47676,3.88035909052773
19620,"Del Rio, TX",2008,89,0,89,47882,1.85873605947955
19620,"Del Rio, TX",2009,44,0,44,48463,0.907909126550152
19620,"Del Rio, TX",2010,30,8,38,48980,0.775826868109432
19620,"Del Rio, TX",2011,47,6,53,48980,1.08207431604737
19620,"Del Rio, TX",2012,29,48,77,48991,1.57171725418954
19620,"Del Rio, TX",2013,44,2,46,49069,0.93745541991889
19620,"Del Rio, TX",2014,55,8,63,48877,1.28894981279538
19620,"Del Rio, TX",2015,79,0,79,48951,1.6138587567159
19620,"Del Rio, TX",2016,93,0,93,49003,1.89784298920474
19620,"Del Rio, TX",2017,104,0,104,49096,2.11829884308294
19620,"Del Rio, TX",2018,81,0,81,49208,1.64607380913673
19660,"Deltona-Daytona Beach-Ormond Beach, FL",1990,4085,666,4751,403385,11.7778301126715
19660,"Deltona-Daytona Beach-Ormond Beach, FL",1991,3014,789,3803,414109,9.18357244107228
19660,"Deltona-Daytona Beach-Ormond Beach, FL",1992,3128,208,3336,423006,7.88641295868144
19660,"Deltona-Daytona Beach-Ormond Beach, FL",1993,3047,628,3675,431488,8.5170387125482
19660,"Deltona-Daytona Beach-Ormond Beach, FL",1994,3044,365,3409,440023,7.74732229906164
19660,"Deltona-Daytona Beach-Ormond Beach, FL",1995,2778,822,3600,446804,8.05722419673951
19660,"Deltona-Daytona Beach-Ormond Beach, FL",1996,3311,144,3455,452607,7.63355405462134
19660,"Deltona-Daytona Beach-Ormond Beach, FL",1997,3351,200,3551,461525,7.69405774335085
19660,"Deltona-Daytona Beach-Ormond Beach, FL",1998,4098,231,4329,468233,9.24539705659362
19660,"Deltona-Daytona Beach-Ormond Beach, FL",1999,4627,638,5265,474500,11.0958904109589
19660,"Deltona-Daytona Beach-Ormond Beach, FL",2000,4423,609,5032,495514,10.1551116618299
19660,"Deltona-Daytona Beach-Ormond Beach, FL",2001,4820,1373,6193,505047,12.2622250998422
19660,"Deltona-Daytona Beach-Ormond Beach, FL",2002,6231,1028,7259,516153,14.0636594188157
19660,"Deltona-Daytona Beach-Ormond Beach, FL",2003,8702,2019,10721,529021,20.2657361427996
19660,"Deltona-Daytona Beach-Ormond Beach, FL",2004,9095,2549,11644,546232,21.3169495745398
19660,"Deltona-Daytona Beach-Ormond Beach, FL",2005,8403,2466,10869,563305,19.2950533014974
19660,"Deltona-Daytona Beach-Ormond Beach, FL",2006,4405,1249,5654,579087,9.76364518630189
19660,"Deltona-Daytona Beach-Ormond Beach, FL",2007,2037,715,2752,589451,4.66875109211792
19660,"Deltona-Daytona Beach-Ormond Beach, FL",2008,1286,728,2014,590912,3.40829091302935
19660,"Deltona-Daytona Beach-Ormond Beach, FL",2009,754,80,834,589388,1.41502711286962
19660,"Deltona-Daytona Beach-Ormond Beach, FL",2010,811,182,993,590522,1.68156309163757
19660,"Deltona-Daytona Beach-Ormond Beach, FL",2011,665,511,1176,591886,1.98686909303481
19660,"Deltona-Daytona Beach-Ormond Beach, FL",2012,1003,0,1003,594984,1.68575961706533
19660,"Deltona-Daytona Beach-Ormond Beach, FL",2013,1729,422,2151,600290,3.58326808709124
19660,"Deltona-Daytona Beach-Ormond Beach, FL",2014,1749,172,1921,608708,3.15586455246194
19660,"Deltona-Daytona Beach-Ormond Beach, FL",2015,1903,144,2047,621338,3.29450315287332
19660,"Deltona-Daytona Beach-Ormond Beach, FL",2016,2280,416,2696,636098,4.23834063304711
19660,"Deltona-Daytona Beach-Ormond Beach, FL",2017,2908,146,3054,648117,4.71211216493318
19660,"Deltona-Daytona Beach-Ormond Beach, FL",2018,3382,477,3859,659605,5.8504711152887
19700,"Deming, NM",1990,21,0,21,18165,1.15606936416185
19700,"Deming, NM",1991,29,61,90,18983,4.74108412790391
19700,"Deming, NM",1992,16,0,16,19888,0.80450522928399
19700,"Deming, NM",1993,42,38,80,21030,3.80408939610081
19700,"Deming, NM",1994,43,2,45,21674,2.07622035618714
19700,"Deming, NM",1995,49,8,57,22377,2.54725834562274
19700,"Deming, NM",1996,49,0,49,22966,2.13358878341897
19700,"Deming, NM",1997,38,0,38,23544,1.61399932042134
19700,"Deming, NM",1998,41,0,41,23982,1.70961554499208
19700,"Deming, NM",1999,40,0,40,24309,1.64548109753589
19700,"Deming, NM",2000,25,0,25,24908,1.00369359242011
19700,"Deming, NM",2001,16,0,16,24593,0.650591631765136
19700,"Deming, NM",2002,36,0,36,24630,1.46163215590743
19700,"Deming, NM",2003,35,60,95,24762,3.83652370567806
19700,"Deming, NM",2004,62,0,62,24822,2.49778422367255
19700,"Deming, NM",2005,87,0,87,25102,3.46585929408015
19700,"Deming, NM",2006,118,2,120,25303,4.74252064972533
19700,"Deming, NM",2007,69,0,69,25328,2.72425773847126
19700,"Deming, NM",2008,44,0,44,25375,1.73399014778325
19700,"Deming, NM",2009,29,0,29,25119,1.15450455830248
19700,"Deming, NM",2010,25,0,25,25082,0.996730723227813
19700,"Deming, NM",2011,18,0,18,25105,0.716988647679745
19700,"Deming, NM",2012,5,24,29,24926,1.16344379362914
19700,"Deming, NM",2013,6,0,6,24607,0.243833055634576
19700,"Deming, NM",2014,7,0,7,24448,0.286321989528796
19700,"Deming, NM",2015,7,0,7,24382,0.287097038799114
19700,"Deming, NM",2016,17,0,17,24379,0.697321465195455
19700,"Deming, NM",2017,18,0,18,24148,0.745403346032798
19700,"Deming, NM",2018,19,0,19,23963,0.792889037265785
19740,"Denver-Aurora-Lakewood, CO",1990,4644,113,4757,1656007,2.87257239854662
19740,"Denver-Aurora-Lakewood, CO",1991,6227,234,6461,1692002,3.81855340596524
19740,"Denver-Aurora-Lakewood, CO",1992,9458,1553,11011,1741816,6.32156324204164
19740,"Denver-Aurora-Lakewood, CO",1993,11603,2140,13743,1790928,7.6736753236311
19740,"Denver-Aurora-Lakewood, CO",1994,13303,4618,17921,1825344,9.81787542512535
19740,"Denver-Aurora-Lakewood, CO",1995,12768,5196,17964,1863354,9.6406801928136
19740,"Denver-Aurora-Lakewood, CO",1996,13543,4621,18164,1902106,9.54941522712194
19740,"Denver-Aurora-Lakewood, CO",1997,14304,6019,20323,1944244,10.452906116722
19740,"Denver-Aurora-Lakewood, CO",1998,15565,8343,23908,1982542,12.0592653270397
19740,"Denver-Aurora-Lakewood, CO",1999,17481,6202,23683,2028672,11.6741395356174
19740,"Denver-Aurora-Lakewood, CO",2000,16156,11415,27571,2153161,12.8048947570572
19740,"Denver-Aurora-Lakewood, CO",2001,15319,12390,27709,2200326,12.5931339265182
19740,"Denver-Aurora-Lakewood, CO",2002,14318,8060,22378,2224981,10.0576139751306
19740,"Denver-Aurora-Lakewood, CO",2003,13757,2965,16722,2241071,7.46161098867461
19740,"Denver-Aurora-Lakewood, CO",2004,18032,3070,21102,2259951,9.33737058900835
19740,"Denver-Aurora-Lakewood, CO",2005,17119,2959,20078,2286436,8.78135228801506
19740,"Denver-Aurora-Lakewood, CO",2006,12250,4738,16988,2325465,7.30520562554156
19740,"Denver-Aurora-Lakewood, CO",2007,7275,5882,13157,2367160,5.55813717703915
19740,"Denver-Aurora-Lakewood, CO",2008,3813,4174,7987,2410790,3.31302187249823
19740,"Denver-Aurora-Lakewood, CO",2009,2563,1389,3952,2454628,1.61001992970014
19740,"Denver-Aurora-Lakewood, CO",2010,3428,1382,4810,2498595,1.92508189602557
19740,"Denver-Aurora-Lakewood, CO",2011,3401,3043,6444,2545491,2.53153517337127
19740,"Denver-Aurora-Lakewood, CO",2012,5446,6304,11750,2591493,4.53406588402901
19740,"Denver-Aurora-Lakewood, CO",2013,6627,7952,14579,2640625,5.52104142011834
19740,"Denver-Aurora-Lakewood, CO",2014,7625,7322,14947,2692872,5.55057945568895
19740,"Denver-Aurora-Lakewood, CO",2015,8921,8958,17879,2748658,6.50462880431105
19740,"Denver-Aurora-Lakewood, CO",2016,9724,11677,21401,2791075,7.66765493582222
19740,"Denver-Aurora-Lakewood, CO",2017,10580,11739,22319,2824747,7.90123858880105
19740,"Denver-Aurora-Lakewood, CO",2018,11221,9723,20944,2863148,7.31502527986678
19760,"DeRidder, LA",1990,18,0,18,30051,0.598981731057203
19760,"DeRidder, LA",1991,18,2,20,30739,0.650639253066137
19760,"DeRidder, LA",1992,24,0,24,31017,0.773769223329142
19760,"DeRidder, LA",1993,34,4,38,31186,1.21849547874046
19760,"DeRidder, LA",1994,45,0,45,31401,1.43307537976498
19760,"DeRidder, LA",1995,21,0,21,31538,0.665863402879067
19760,"DeRidder, LA",1996,11,80,91,31624,2.87756134581331
19760,"DeRidder, LA",1997,8,0,8,31831,0.251327322421539
19760,"DeRidder, LA",1998,8,0,8,31973,0.250211115628812
19760,"DeRidder, LA",1999,3,0,3,32241,0.0930492230389876
19760,"DeRidder, LA",2000,3,0,3,32979,0.0909669789866279
19760,"DeRidder, LA",2001,9,0,9,33001,0.272719008514894
19760,"DeRidder, LA",2002,10,0,10,33000,0.303030303030303
19760,"DeRidder, LA",2003,11,0,11,33221,0.331115860449716
19760,"DeRidder, LA",2004,29,0,29,33614,0.86273576485988
19760,"DeRidder, LA",2005,70,0,70,34130,2.05098154116613
19760,"DeRidder, LA",2006,88,0,88,34510,2.54998551144596
19760,"DeRidder, LA",2007,15,0,15,34623,0.43323802096872
19760,"DeRidder, LA",2008,40,0,40,34893,1.1463617344453
19760,"DeRidder, LA",2009,52,0,52,35142,1.47971088725741
19760,"DeRidder, LA",2010,28,0,28,35834,0.781380811519786
19760,"DeRidder, LA",2011,11,0,11,36090,0.304793571626489
19760,"DeRidder, LA",2012,32,0,32,36335,0.880693546167607
19760,"DeRidder, LA",2013,32,0,32,36267,0.882344831389417
19760,"DeRidder, LA",2014,27,0,27,36248,0.744868682410064
19760,"DeRidder, LA",2015,28,0,28,36530,0.766493293183685
19760,"DeRidder, LA",2016,146,0,146,36966,3.94957528539739
19760,"DeRidder, LA",2017,166,0,166,36847,4.50511574890765
19760,"DeRidder, LA",2018,174,0,174,37253,4.6707647706225
19780,"Des Moines-West Des Moines, IA",1990,1711,1003,2714,417902,6.49434556427105
19780,"Des Moines-West Des Moines, IA",1991,1941,403,2344,423551,5.53416235589103
19780,"Des Moines-West Des Moines, IA",1992,2354,1163,3517,430511,8.16936152618632
19780,"Des Moines-West Des Moines, IA",1993,2330,562,2892,436898,6.61939400043031
19780,"Des Moines-West Des Moines, IA",1994,2350,1630,3980,441751,9.00960043101204
19780,"Des Moines-West Des Moines, IA",1995,2263,1126,3389,447715,7.56954759165987
19780,"Des Moines-West Des Moines, IA",1996,2485,1003,3488,452877,7.7018704858052
19780,"Des Moines-West Des Moines, IA",1997,2153,338,2491,457079,5.44982377225819
19780,"Des Moines-West Des Moines, IA",1998,2958,702,3660,462193,7.91876986453711
19780,"Des Moines-West Des Moines, IA",1999,3287,569,3856,469099,8.22001325946122
19780,"Des Moines-West Des Moines, IA",2000,2578,601,3179,483243,6.57847087283209
19780,"Des Moines-West Des Moines, IA",2001,2883,1139,4022,489761,8.2121687925335
19780,"Des Moines-West Des Moines, IA",2002,3459,1405,4864,496276,9.80099783185163
19780,"Des Moines-West Des Moines, IA",2003,4452,1050,5502,503406,10.9295479195719
19780,"Des Moines-West Des Moines, IA",2004,4662,799,5461,511257,10.6815163410966
19780,"Des Moines-West Des Moines, IA",2005,5182,1118,6300,521578,12.0787303145455
19780,"Des Moines-West Des Moines, IA",2006,3854,1266,5120,532738,9.61072797510221
19780,"Des Moines-West Des Moines, IA",2007,3164,686,3850,543590,7.08254382898876
19780,"Des Moines-West Des Moines, IA",2008,1819,1094,2913,553644,5.26150378221384
19780,"Des Moines-West Des Moines, IA",2009,1799,679,2478,562601,4.40454247326258
19780,"Des Moines-West Des Moines, IA",2010,2206,609,2815,572125,4.92025344111864
19780,"Des Moines-West Des Moines, IA",2011,2249,391,2640,581642,4.5388744279127
19780,"Des Moines-West Des Moines, IA",2012,2809,1358,4167,590200,7.06031853608946
19780,"Des Moines-West Des Moines, IA",2013,3307,1614,4921,601147,8.18601772944055
19780,"Des Moines-West Des Moines, IA",2014,2952,1484,4436,612847,7.23834823373534
19780,"Des Moines-West Des Moines, IA",2015,3374,2333,5707,622992,9.16063127616406
19780,"Des Moines-West Des Moines, IA",2016,3760,2937,6697,634659,10.5521232661949
19780,"Des Moines-West Des Moines, IA",2017,3697,2670,6367,645100,9.86978762982483
19780,"Des Moines-West Des Moines, IA",2018,3233,1690,4923,655409,7.51134024708236
19820,"Detroit-Warren-Dearborn, MI",1990,10849,4636,15485,4251950,3.641858441421
19820,"Detroit-Warren-Dearborn, MI",1991,10575,2984,13559,4290471,3.16025909509702
19820,"Detroit-Warren-Dearborn, MI",1992,12100,2670,14770,4328434,3.41231955945268
19820,"Detroit-Warren-Dearborn, MI",1993,12807,2657,15464,4357222,3.54905028938163
19820,"Detroit-Warren-Dearborn, MI",1994,14743,3679,18422,4381798,4.20421023515917
19820,"Detroit-Warren-Dearborn, MI",1995,15510,3276,18786,4420072,4.25015701101701
19820,"Detroit-Warren-Dearborn, MI",1996,17157,3794,20951,4457420,4.70025261249781
19820,"Detroit-Warren-Dearborn, MI",1997,16322,2837,19159,4468532,4.28753783121616
19820,"Detroit-Warren-Dearborn, MI",1998,17950,4380,22330,4473603,4.99150237515488
19820,"Detroit-Warren-Dearborn, MI",1999,17224,3355,20579,4483278,4.59016817605333
19820,"Detroit-Warren-Dearborn, MI",2000,16065,3248,19313,4455503,4.33463965796903
19820,"Detroit-Warren-Dearborn, MI",2001,14009,3557,17566,4461855,3.93692757832785
19820,"Detroit-Warren-Dearborn, MI",2002,15208,3826,19034,4456433,4.27112894999207
19820,"Detroit-Warren-Dearborn, MI",2003,16334,3566,19900,4453371,4.46852507909177
19820,"Detroit-Warren-Dearborn, MI",2004,17399,4409,21808,4445887,4.90520789214841
19820,"Detroit-Warren-Dearborn, MI",2005,13631,2761,16392,4431048,3.69935058252585
19820,"Detroit-Warren-Dearborn, MI",2006,7468,1452,8920,4409697,2.02281471946939
19820,"Detroit-Warren-Dearborn, MI",2007,3833,492,4325,4377116,0.988093530077796
19820,"Detroit-Warren-Dearborn, MI",2008,1937,653,2590,4339504,0.596842404108857
19820,"Detroit-Warren-Dearborn, MI",2009,1261,72,1333,4311728,0.309156792821811
19820,"Detroit-Warren-Dearborn, MI",2010,2430,780,3210,4291593,0.747974004058633
19820,"Detroit-Warren-Dearborn, MI",2011,2862,504,3366,4291406,0.78435831986067
19820,"Detroit-Warren-Dearborn, MI",2012,4107,418,4525,4300902,1.05210488404525
19820,"Detroit-Warren-Dearborn, MI",2013,5442,910,6352,4305860,1.47519891496705
19820,"Detroit-Warren-Dearborn, MI",2014,4830,1465,6295,4311699,1.45998132058847
19820,"Detroit-Warren-Dearborn, MI",2015,5192,2112,7304,4309845,1.69472452025537
19820,"Detroit-Warren-Dearborn, MI",2016,5711,1948,7659,4316198,1.77447837193752
19820,"Detroit-Warren-Dearborn, MI",2017,6838,3251,10089,4321704,2.33449583775289
19820,"Detroit-Warren-Dearborn, MI",2018,6131,1032,7163,4326442,1.65563296584122
19860,"Dickinson, ND",1990,3,0,3,22767,0.131769666622743
19860,"Dickinson, ND",1991,7,0,7,22845,0.306412781790326
19860,"Dickinson, ND",1992,12,0,12,22815,0.525969756738987
19860,"Dickinson, ND",1993,14,0,14,22698,0.616794431227421
19860,"Dickinson, ND",1994,17,0,17,22823,0.744862638566358
19860,"Dickinson, ND",1995,17,46,63,22425,2.80936454849498
19860,"Dickinson, ND",1996,42,0,42,22622,1.8565997701352699
19860,"Dickinson, ND",1997,49,37,86,22674,3.79289053541501
19860,"Dickinson, ND",1998,47,32,79,22717,3.47757186248184
19860,"Dickinson, ND",1999,34,0,34,22526,1.50936695374234
19860,"Dickinson, ND",2000,34,0,34,22585,1.50542395395174
19860,"Dickinson, ND",2001,45,12,57,22494,2.53400906908509
19860,"Dickinson, ND",2002,47,7,54,22384,2.41243745532523
19860,"Dickinson, ND",2003,61,17,78,22431,3.47733048013909
19860,"Dickinson, ND",2004,66,14,80,22539,3.54940325657749
19860,"Dickinson, ND",2005,56,88,144,22671,6.35172687574434
19860,"Dickinson, ND",2006,79,21,100,22770,4.3917435221783
19860,"Dickinson, ND",2007,94,0,94,23176,4.05591991715568
19860,"Dickinson, ND",2008,103,0,103,23375,4.40641711229947
19860,"Dickinson, ND",2009,88,16,104,23786,4.37231985201379
19860,"Dickinson, ND",2010,162,148,310,24360,12.7257799671593
19860,"Dickinson, ND",2011,193,126,319,25185,12.6662696049236
19860,"Dickinson, ND",2012,672,884,1556,26902,57.8395658315367
19860,"Dickinson, ND",2013,325,404,729,28319,25.7424344079946
19860,"Dickinson, ND",2014,357,270,627,30318,20.6807836928557
19860,"Dickinson, ND",2015,162,44,206,31869,6.46396184379805
19860,"Dickinson, ND",2016,76,10,86,30881,2.78488390919983
19860,"Dickinson, ND",2017,90,0,90,30317,2.96863146089653
19860,"Dickinson, ND",2018,73,0,73,30997,2.35506661935026
19940,"Dixon, IL",1990,68,24,92,34469,2.66906495691781
19940,"Dixon, IL",1991,79,26,105,34673,3.02829290802642
19940,"Dixon, IL",1992,96,16,112,34860,3.21285140562249
19940,"Dixon, IL",1993,89,14,103,35245,2.92240034047383
19940,"Dixon, IL",1994,112,74,186,35482,5.24209458316893
19940,"Dixon, IL",1995,103,106,209,35876,5.82562158546103
19940,"Dixon, IL",1996,123,73,196,35834,5.4696656806385
19940,"Dixon, IL",1997,101,20,121,35995,3.36157799694402
19940,"Dixon, IL",1998,112,0,112,35957,3.11483160441639
19940,"Dixon, IL",1999,86,18,104,35794,2.90551489076382
19940,"Dixon, IL",2000,90,28,118,36092,3.26942258672282
19940,"Dixon, IL",2001,83,37,120,36100,3.32409972299169
19940,"Dixon, IL",2002,81,2,83,35825,2.31681786461968
19940,"Dixon, IL",2003,98,4,102,35586,2.86629573427753
19940,"Dixon, IL",2004,89,0,89,35704,2.49271790275599
19940,"Dixon, IL",2005,104,0,104,35635,2.91847902343202
19940,"Dixon, IL",2006,100,4,104,35905,2.89653251636262
19940,"Dixon, IL",2007,110,50,160,36191,4.42098864358542
19940,"Dixon, IL",2008,63,0,63,36272,1.73687692986326
19940,"Dixon, IL",2009,20,0,20,36189,0.55265412141811
19940,"Dixon, IL",2010,29,0,29,35976,0.806092950856126
19940,"Dixon, IL",2011,11,58,69,35597,1.93836559260612
19940,"Dixon, IL",2012,14,8,22,35207,0.624875734939075
19940,"Dixon, IL",2013,25,4,29,35116,0.825834377491742
19940,"Dixon, IL",2014,21,0,21,34904,0.601650240660096
19940,"Dixon, IL",2015,29,0,29,34515,0.840214399536433
19940,"Dixon, IL",2016,31,0,31,34482,0.899019778435126
19940,"Dixon, IL",2017,26,0,26,34511,0.75338297933992
19940,"Dixon, IL",2018,22,0,22,34223,0.642842532799579
19980,"Dodge City, KS",1990,31,2,33,27448,1.20227338968231
19980,"Dodge City, KS",1991,46,18,64,27547,2.32330199295749
19980,"Dodge City, KS",1992,37,10,47,27886,1.68543355088575
19980,"Dodge City, KS",1993,81,8,89,27836,3.19729846242276
19980,"Dodge City, KS",1994,42,83,125,28623,4.36711735317751
19980,"Dodge City, KS",1995,90,34,124,28988,4.27763212363737
19980,"Dodge City, KS",1996,59,111,170,29192,5.82351329131269
19980,"Dodge City, KS",1997,49,28,77,29108,2.64532087398653
19980,"Dodge City, KS",1998,76,11,87,29487,2.95045274188625
19980,"Dodge City, KS",1999,81,4,85,29625,2.86919831223629
19980,"Dodge City, KS",2000,60,6,66,32544,2.02802359882006
19980,"Dodge City, KS",2001,61,54,115,32182,3.57342613883537
19980,"Dodge City, KS",2002,64,24,88,31981,2.75163378255839
19980,"Dodge City, KS",2003,82,16,98,32285,3.03546538640235
19980,"Dodge City, KS",2004,62,6,68,32265,2.10754687742135
19980,"Dodge City, KS",2005,26,4,30,32354,0.927242381158435
19980,"Dodge City, KS",2006,38,3,41,32029,1.28008991851135
19980,"Dodge City, KS",2007,30,0,30,32168,0.932603829893061
19980,"Dodge City, KS",2008,18,0,18,32187,0.559231988069718
19980,"Dodge City, KS",2009,27,10,37,33158,1.11586947343024
19980,"Dodge City, KS",2010,46,6,52,34009,1.52900702755153
19980,"Dodge City, KS",2011,29,54,83,34381,2.41412408016055
19980,"Dodge City, KS",2012,53,32,85,34679,2.45105106836991
19980,"Dodge City, KS",2013,38,0,38,34900,1.08882521489971
19980,"Dodge City, KS",2014,41,2,43,34958,1.23004748555409
19980,"Dodge City, KS",2015,32,0,32,34693,0.922376271870406
19980,"Dodge City, KS",2016,22,0,22,34594,0.635948430363647
19980,"Dodge City, KS",2017,43,4,47,34288,1.37074195053663
19980,"Dodge City, KS",2018,36,4,40,33888,1.18035882908404
20020,"Dothan, AL",1990,346,12,358,120747,2.96487697416913
20020,"Dothan, AL",1991,315,187,502,122107,4.11114841900956
20020,"Dothan, AL",1992,379,0,379,122908,3.08360725095193
20020,"Dothan, AL",1993,399,24,423,123915,3.41363031110035
20020,"Dothan, AL",1994,408,32,440,123652,3.55837349982208
20020,"Dothan, AL",1995,403,106,509,124155,4.09971406709355
20020,"Dothan, AL",1996,377,16,393,124999,3.14402515220122
20020,"Dothan, AL",1997,370,81,451,125658,3.58910694106225
20020,"Dothan, AL",1998,371,140,511,126180,4.04977016959899
20020,"Dothan, AL",1999,404,98,502,126872,3.95674380477962
20020,"Dothan, AL",2000,379,320,699,131024,5.33490047624863
20020,"Dothan, AL",2001,359,39,398,131413,3.02861969515953
20020,"Dothan, AL",2002,408,0,408,131967,3.09168201141194
20020,"Dothan, AL",2003,445,10,455,133586,3.4060455436947
20020,"Dothan, AL",2004,502,229,731,135057,5.41252952457111
20020,"Dothan, AL",2005,589,112,701,136643,5.13015668566996
20020,"Dothan, AL",2006,698,4,702,139070,5.04781764578989
20020,"Dothan, AL",2007,351,0,351,141157,2.48659294261
20020,"Dothan, AL",2008,361,2,363,142958,2.53920731963234
20020,"Dothan, AL",2009,281,56,337,144396,2.3338596637026
20020,"Dothan, AL",2010,271,50,321,145870,2.20058956605196
20020,"Dothan, AL",2011,288,0,288,146606,1.96444893114879
20020,"Dothan, AL",2012,235,319,554,147448,3.75725679561608
20020,"Dothan, AL",2013,253,136,389,147452,2.63814665111358
20020,"Dothan, AL",2014,223,113,336,147835,2.2728041397504
20020,"Dothan, AL",2015,311,16,327,148010,2.20931018174448
20020,"Dothan, AL",2016,354,6,360,147820,2.43539439859288
20020,"Dothan, AL",2017,388,2,390,147923,2.6365068312568
20020,"Dothan, AL",2018,359,55,414,148245,2.79267428918345
20060,"Douglas, GA",1990,70,51,121,29719,4.07146943033076
20060,"Douglas, GA",1991,90,50,140,30023,4.66309162975052
20060,"Douglas, GA",1992,101,4,105,30716,3.41841385597083
20060,"Douglas, GA",1993,116,0,116,31228,3.71461508902267
20060,"Douglas, GA",1994,172,12,184,31936,5.76152304609218
20060,"Douglas, GA",1995,155,4,159,32577,4.88074408324892
20060,"Douglas, GA",1996,153,6,159,33077,4.80696556519636
20060,"Douglas, GA",1997,123,9,132,33790,3.90648120745783
20060,"Douglas, GA",1998,139,4,143,34214,4.17957561232244
20060,"Douglas, GA",1999,122,3,125,34972,3.57428800183004
20060,"Douglas, GA",2000,118,8,126,37592,3.35177697382422
20060,"Douglas, GA",2001,142,8,150,38350,3.91134289439374
20060,"Douglas, GA",2002,136,72,208,38791,5.3620685210487
20060,"Douglas, GA",2003,153,2,155,39183,3.9557971569303
20060,"Douglas, GA",2004,156,0,156,39383,3.96109996699083
20060,"Douglas, GA",2005,167,4,171,39829,4.29335408872932
20060,"Douglas, GA",2006,152,0,152,40702,3.73446022308486
20060,"Douglas, GA",2007,113,0,113,41299,2.73614373229376
20060,"Douglas, GA",2008,75,7,82,41813,1.96111257264487
20060,"Douglas, GA",2009,48,0,48,42089,1.14044049514125
20060,"Douglas, GA",2010,45,63,108,42735,2.52720252720253
20060,"Douglas, GA",2011,40,0,40,43004,0.93014603292717
20060,"Douglas, GA",2012,13,0,13,43135,0.30137939028631
20060,"Douglas, GA",2013,25,6,31,43092,0.719391070268263
20060,"Douglas, GA",2014,33,2,35,42899,0.81586983379566
20060,"Douglas, GA",2015,32,0,32,43000,0.744186046511628
20060,"Douglas, GA",2016,64,0,64,42929,1.49083370215938
20060,"Douglas, GA",2017,107,6,113,42885,2.63495394660138
20060,"Douglas, GA",2018,54,0,54,43093,1.25310375234957
20100,"Dover, DE",1990,528,294,822,111646,7.36255665227594
20100,"Dover, DE",1991,637,240,877,114327,7.67097885888723
20100,"Dover, DE",1992,674,82,756,115752,6.53120464441219
20100,"Dover, DE",1993,806,141,947,118092,8.01917149341192
20100,"Dover, DE",1994,740,236,976,119178,8.18943093523973
20100,"Dover, DE",1995,709,232,941,120891,7.78387142136305
20100,"Dover, DE",1996,613,46,659,121659,5.41677968748716
20100,"Dover, DE",1997,626,6,632,122670,5.15203391212195
20100,"Dover, DE",1998,675,88,763,124348,6.13600540418825
20100,"Dover, DE",1999,705,161,866,125945,6.87601730914288
20100,"Dover, DE",2000,853,5,858,127229,6.74374552971414
20100,"Dover, DE",2001,954,64,1018,129228,7.8775497570186
20100,"Dover, DE",2002,1442,10,1452,131824,11.0146862483311
20100,"Dover, DE",2003,1763,404,2167,134605,16.098956205193
20100,"Dover, DE",2004,2028,150,2178,139342,15.6306067086736
20100,"Dover, DE",2005,1946,236,2182,144585,15.0914686862399
20100,"Dover, DE",2006,1485,218,1703,149704,11.3757815422434
20100,"Dover, DE",2007,1317,167,1484,153969,9.6383038144042
20100,"Dover, DE",2008,824,164,988,157925,6.25613424093715
20100,"Dover, DE",2009,722,84,806,160081,5.03495105602789
20100,"Dover, DE",2010,674,139,813,162955,4.9891074222945
20100,"Dover, DE",2011,540,140,680,165097,4.11879077148585
20100,"Dover, DE",2012,695,170,865,167288,5.17072354263306
20100,"Dover, DE",2013,823,66,889,169029,5.25945251998178
20100,"Dover, DE",2014,912,86,998,171458,5.82066745208739
20100,"Dover, DE",2015,827,234,1061,173129,6.12837826129649
20100,"Dover, DE",2016,1124,152,1276,174528,7.31114778144481
20100,"Dover, DE",2017,1153,401,1554,176445,8.807277055173
20100,"Dover, DE",2018,1321,138,1459,178550,8.17138056566788
20140,"Dublin, GA",1990,35,8,43,48317,0.889955916137177
20140,"Dublin, GA",1991,40,57,97,48777,1.98864218791644
20140,"Dublin, GA",1992,43,19,62,49154,1.26134190503316
20140,"Dublin, GA",1993,57,34,91,49944,1.82204068556784
20140,"Dublin, GA",1994,36,36,72,50462,1.42681621814435
20140,"Dublin, GA",1995,52,72,124,50950,2.43375858684985
20140,"Dublin, GA",1996,35,20,55,51390,1.07024712979179
20140,"Dublin, GA",1997,22,5,27,51641,0.522840378768808
20140,"Dublin, GA",1998,46,85,131,51979,2.52024856191924
20140,"Dublin, GA",1999,96,0,96,52223,1.83827049384371
20140,"Dublin, GA",2000,45,0,45,53498,0.841152940296834
20140,"Dublin, GA",2001,40,0,40,53891,0.742238963834406
20140,"Dublin, GA",2002,47,0,47,55070,0.85345923370256
20140,"Dublin, GA",2003,40,0,40,55733,0.717707641792116
20140,"Dublin, GA",2004,48,64,112,55942,2.00207357620393
20140,"Dublin, GA",2005,45,0,45,56267,0.799758295270763
20140,"Dublin, GA",2006,39,0,39,56925,0.685111989459816
20140,"Dublin, GA",2007,40,0,40,57756,0.692568737447192
20140,"Dublin, GA",2008,26,8,34,58319,0.58300039438262
20140,"Dublin, GA",2009,21,0,21,58591,0.358416821696165
20140,"Dublin, GA",2010,60,0,60,58383,1.02769641847798
20140,"Dublin, GA",2011,25,0,25,57905,0.431741645799154
20140,"Dublin, GA",2012,33,0,33,57866,0.570283067777279
20140,"Dublin, GA",2013,13,0,13,57660,0.225459590704128
20140,"Dublin, GA",2014,9,0,9,57406,0.156778037138975
20140,"Dublin, GA",2015,11,0,11,57222,0.192233756247597
20140,"Dublin, GA",2016,15,2,17,56966,0.298423621107327
20140,"Dublin, GA",2017,17,16,33,57113,0.57780190149353
20140,"Dublin, GA",2018,11,10,21,57033,0.368207879648624
20180,"DuBois, PA",1990,105,0,105,78096,1.34449907805778
20180,"DuBois, PA",1991,129,15,144,78140,1.84284617353468
20180,"DuBois, PA",1992,165,32,197,78361,2.51400569160679
20180,"DuBois, PA",1993,187,14,201,78797,2.55085853522342
20180,"DuBois, PA",1994,228,0,228,79337,2.8738167563684
20180,"DuBois, PA",1995,195,40,235,79525,2.95504558314995
20180,"DuBois, PA",1996,223,108,331,80890,4.09197675856101
20180,"DuBois, PA",1997,220,0,220,80899,2.719440289744
20180,"DuBois, PA",1998,187,0,187,80803,2.3142705097583
20180,"DuBois, PA",1999,190,0,190,80983,2.34617141869281
20180,"DuBois, PA",2000,186,0,186,83465,2.22847900317498
20180,"DuBois, PA",2001,218,0,218,82987,2.62691746900117
20180,"DuBois, PA",2002,167,2,169,82925,2.03798613204703
20180,"DuBois, PA",2003,219,6,225,82422,2.72985367984276
20180,"DuBois, PA",2004,247,56,303,82040,3.69332033154559
20180,"DuBois, PA",2005,176,0,176,81816,2.15116847560379
20180,"DuBois, PA",2006,161,16,177,82461,2.14646924000437
20180,"DuBois, PA",2007,131,3,134,82558,1.62310133481916
20180,"DuBois, PA",2008,87,2,89,82130,1.08364787531962
20180,"DuBois, PA",2009,111,20,131,81942,1.59869175758463
20180,"DuBois, PA",2010,124,0,124,81553,1.5204836118843
20180,"DuBois, PA",2011,62,0,62,81430,0.761390151049982
20180,"DuBois, PA",2012,74,0,74,81406,0.909023904871877
20180,"DuBois, PA",2013,80,0,80,81435,0.982378584146866
20180,"DuBois, PA",2014,88,38,126,81020,1.55517156257714
20180,"DuBois, PA",2015,84,108,192,80717,2.37868107090204
20180,"DuBois, PA",2016,74,0,74,80178,0.92294644416174
20180,"DuBois, PA",2017,55,0,55,79775,0.689439047320589
20180,"DuBois, PA",2018,72,0,72,79388,0.906938076283569
20220,"Dubuque, IA",1990,247,99,346,86435,4.00300804072424
20220,"Dubuque, IA",1991,258,38,296,86851,3.40813577276024
20220,"Dubuque, IA",1992,344,118,462,87423,5.28465049243334
20220,"Dubuque, IA",1993,301,153,454,87900,5.16496018202503
20220,"Dubuque, IA",1994,284,157,441,88181,5.00107732958347
20220,"Dubuque, IA",1995,309,149,458,88354,5.1836928718564
20220,"Dubuque, IA",1996,250,81,331,88401,3.7443015350505102
20220,"Dubuque, IA",1997,219,84,303,88192,3.43568577648766
20220,"Dubuque, IA",1998,277,87,364,87865,4.14271894383429
20220,"Dubuque, IA",1999,287,33,320,87915,3.63987942899391
20220,"Dubuque, IA",2000,262,79,341,89201,3.82282709835092
20220,"Dubuque, IA",2001,326,115,441,88932,4.95884496019431
20220,"Dubuque, IA",2002,384,113,497,89132,5.57599964098191
20220,"Dubuque, IA",2003,399,142,541,90012,6.01030973647958
20220,"Dubuque, IA",2004,417,455,872,90462,9.639406601667
20220,"Dubuque, IA",2005,427,133,560,90769,6.16950721061155
20220,"Dubuque, IA",2006,363,48,411,91258,4.50371474281707
20220,"Dubuque, IA",2007,320,47,367,92130,3.98350157386302
20220,"Dubuque, IA",2008,202,12,214,92519,2.31303840292264
20220,"Dubuque, IA",2009,315,120,435,92948,4.68003614924474
20220,"Dubuque, IA",2010,324,224,548,93927,5.83431814068372
20220,"Dubuque, IA",2011,281,129,410,94580,4.33495453584267
20220,"Dubuque, IA",2012,296,99,395,95155,4.15112185381746
20220,"Dubuque, IA",2013,325,14,339,95942,3.53338475328845
20220,"Dubuque, IA",2014,248,28,276,96483,2.86060756817263
20220,"Dubuque, IA",2015,237,18,255,96884,2.63201354196771
20220,"Dubuque, IA",2016,266,102,368,96782,3.8023599429646
20220,"Dubuque, IA",2017,221,20,241,97009,2.48430557989465
20220,"Dubuque, IA",2018,228,94,322,96854,3.32459165341648
20260,"Duluth, MN-WI",1990,634,67,701,269573,2.60040879464932
20260,"Duluth, MN-WI",1991,696,206,902,270389,3.33593452396362
20260,"Duluth, MN-WI",1992,914,137,1051,271369,3.87295527492086
20260,"Duluth, MN-WI",1993,974,83,1057,271164,3.89801006033249
20260,"Duluth, MN-WI",1994,850,187,1037,270885,3.82819277553205
20260,"Duluth, MN-WI",1995,797,125,922,268180,3.4379894100977
20260,"Duluth, MN-WI",1996,770,84,854,268157,3.1847014994947
20260,"Duluth, MN-WI",1997,705,110,815,268644,3.033754708834
20260,"Duluth, MN-WI",1998,1018,187,1205,267931,4.49742657624538
20260,"Duluth, MN-WI",1999,925,244,1169,268366,4.3559914445198
20260,"Duluth, MN-WI",2000,950,186,1136,275775,4.11930015411114
20260,"Duluth, MN-WI",2001,981,31,1012,276946,3.65414196269309
20260,"Duluth, MN-WI",2002,1039,53,1092,276852,3.94434571540029
20260,"Duluth, MN-WI",2003,1207,142,1349,277209,4.86636436767926
20260,"Duluth, MN-WI",2004,1270,445,1715,277087,6.1893917794772
20260,"Duluth, MN-WI",2005,1165,312,1477,276682,5.33825836158478
20260,"Duluth, MN-WI",2006,938,254,1192,276710,4.30775902569477
20260,"Duluth, MN-WI",2007,829,172,1001,277209,3.61099387105036
20260,"Duluth, MN-WI",2008,627,158,785,278561,2.81805421433726
20260,"Duluth, MN-WI",2009,460,92,552,279465,1.97520261929043
20260,"Duluth, MN-WI",2010,399,87,486,279690,1.73763809932425
20260,"Duluth, MN-WI",2011,333,111,444,279784,1.58693849541075
20260,"Duluth, MN-WI",2012,340,134,474,279364,1.69671110092925
20260,"Duluth, MN-WI",2013,354,118,472,279465,1.6889413701179
20260,"Duluth, MN-WI",2014,436,162,598,279655,2.13834903720656
20260,"Duluth, MN-WI",2015,467,374,841,279166,3.01254450756897
20260,"Duluth, MN-WI",2016,526,95,621,278830,2.22716350464441
20260,"Duluth, MN-WI",2017,508,157,665,278659,2.38642929171496
20260,"Duluth, MN-WI",2018,535,201,736,278799,2.63989469115743
20300,"Dumas, TX",1990,2,0,2,17837,0.112126478667937
20300,"Dumas, TX",1991,3,0,3,18013,0.166546383167712
20300,"Dumas, TX",1992,13,0,13,18037,0.720740699672895
20300,"Dumas, TX",1993,27,4,31,18838,1.64560993736065
20300,"Dumas, TX",1994,16,32,48,18985,2.5283118251251
20300,"Dumas, TX",1995,16,0,16,19138,0.83603302330442
20300,"Dumas, TX",1996,18,0,18,19077,0.943544582481522
20300,"Dumas, TX",1997,6,3,9,19243,0.467702541183807
20300,"Dumas, TX",1998,10,8,18,19598,0.918461067455863
20300,"Dumas, TX",1999,13,5,18,19756,0.911115610447459
20300,"Dumas, TX",2000,14,0,14,20121,0.695790467670593
20300,"Dumas, TX",2001,12,0,12,20281,0.591686800453627
20300,"Dumas, TX",2002,32,0,32,20155,1.58769536095262
20300,"Dumas, TX",2003,28,6,34,20223,1.68125401770262
20300,"Dumas, TX",2004,33,0,33,20389,1.61851979008289
20300,"Dumas, TX",2005,26,0,26,20312,1.2800315084679
20300,"Dumas, TX",2006,28,0,28,20558,1.36200019457146
20300,"Dumas, TX",2007,31,56,87,20469,4.25032976696468
20300,"Dumas, TX",2008,12,0,12,20917,0.573696036716546
20300,"Dumas, TX",2009,9,0,9,21575,0.417149478563152
20300,"Dumas, TX",2010,12,0,12,22007,0.54528104693961
20300,"Dumas, TX",2011,10,24,34,22076,1.54013408226128
20300,"Dumas, TX",2012,5,72,77,22438,3.43167840270969
20300,"Dumas, TX",2013,15,2,17,22158,0.767217257875259
20300,"Dumas, TX",2014,16,0,16,22006,0.727074434245206
20300,"Dumas, TX",2015,12,2,14,21825,0.641466208476518
20300,"Dumas, TX",2016,10,0,10,21810,0.458505272810637
20300,"Dumas, TX",2017,4,0,4,21878,0.182832068744858
20300,"Dumas, TX",2018,9,0,9,21485,0.418896904817314
20340,"Duncan, OK",1990,27,0,27,42184,0.640053100701688
20340,"Duncan, OK",1991,30,0,30,42745,0.701836472102
20340,"Duncan, OK",1992,18,0,18,43016,0.418448949228194
20340,"Duncan, OK",1993,41,0,41,42988,0.953754536149623
20340,"Duncan, OK",1994,37,27,64,43145,1.48337003128984
20340,"Duncan, OK",1995,27,71,98,42811,2.28913129803088
20340,"Duncan, OK",1996,46,0,46,43157,1.06587575596079
20340,"Duncan, OK",1997,35,0,35,43320,0.807940904893813
20340,"Duncan, OK",1998,44,0,44,43509,1.01128502148981
20340,"Duncan, OK",1999,45,0,45,43013,1.04619533629368
20340,"Duncan, OK",2000,43,0,43,43116,0.9973095834493
20340,"Duncan, OK",2001,48,0,48,42796,1.12160014954669
20340,"Duncan, OK",2002,42,0,42,42771,0.981973767272217
20340,"Duncan, OK",2003,64,0,64,42725,1.4979520187244
20340,"Duncan, OK",2004,71,0,71,43061,1.64882376164046
20340,"Duncan, OK",2005,83,0,83,43318,1.91606260676855
20340,"Duncan, OK",2006,74,0,74,43670,1.69452713533318
20340,"Duncan, OK",2007,60,0,60,44196,1.3575889220744
20340,"Duncan, OK",2008,51,0,51,44508,1.14586141817201
20340,"Duncan, OK",2009,35,0,35,44799,0.781267439005335
20340,"Duncan, OK",2010,30,0,30,45103,0.665144225439549
20340,"Duncan, OK",2011,33,0,33,45117,0.731431611144358
20340,"Duncan, OK",2012,29,0,29,44904,0.645822198467843
20340,"Duncan, OK",2013,34,0,34,45006,0.755454828245123
20340,"Duncan, OK",2014,36,0,36,44593,0.807301594420649
20340,"Duncan, OK",2015,37,0,37,44607,0.829466227273746
20340,"Duncan, OK",2016,42,0,42,44037,0.953743443013829
20340,"Duncan, OK",2017,8,0,8,43411,0.184285089032734
20340,"Duncan, OK",2018,44,0,44,43265,1.0169883277476
20380,"Dunn, NC",1990,235,121,356,67930,5.24068894450169
20380,"Dunn, NC",1991,226,46,272,68683,3.96022305373964
20380,"Dunn, NC",1992,369,30,399,70436,5.66471690612755
20380,"Dunn, NC",1993,518,19,537,72279,7.42954385091105
20380,"Dunn, NC",1994,590,22,612,73728,8.30078125
20380,"Dunn, NC",1995,665,79,744,75977,9.79243718493755
20380,"Dunn, NC",1996,751,36,787,78712,9.9984754548226409
20380,"Dunn, NC",1997,571,101,672,80667,8.33054408866079
20380,"Dunn, NC",1998,694,71,765,82431,9.2804891363686
20380,"Dunn, NC",1999,647,178,825,84427,9.77175548106648
20380,"Dunn, NC",2000,612,80,692,91393,7.57169586292167
20380,"Dunn, NC",2001,633,84,717,93168,7.6957753735188
20380,"Dunn, NC",2002,727,30,757,95708,7.9094746520667
20380,"Dunn, NC",2003,961,26,987,96787,10.1976505109157
20380,"Dunn, NC",2004,980,13,993,98545,10.076614744533
20380,"Dunn, NC",2005,1180,10,1190,100728,11.8139941227861
20380,"Dunn, NC",2006,1383,0,1383,103036,13.4224931092046
20380,"Dunn, NC",2007,1148,50,1198,105770,11.3264630802685
20380,"Dunn, NC",2008,889,2,891,108752,8.19295277328233
20380,"Dunn, NC",2009,738,4,742,111866,6.63293583394418
20380,"Dunn, NC",2010,835,2,837,115742,7.23160132017764
20380,"Dunn, NC",2011,824,0,824,119158,6.91518823746622
20380,"Dunn, NC",2012,770,0,770,122197,6.30130035925596
20380,"Dunn, NC",2013,813,0,813,125032,6.50233540213705
20380,"Dunn, NC",2014,610,2,612,126704,4.83015532264175
20380,"Dunn, NC",2015,708,39,747,128027,5.83470674154671
20380,"Dunn, NC",2016,678,0,678,130631,5.19019222083579
20380,"Dunn, NC",2017,650,0,650,132229,4.91571440455573
20380,"Dunn, NC",2018,597,0,597,134214,4.44812016630158
20420,"Durango, CO",1990,216,33,249,32462,7.67050705440207
20420,"Durango, CO",1991,227,40,267,33459,7.9799157177441
20420,"Durango, CO",1992,380,14,394,34547,11.404752945263
20420,"Durango, CO",1993,423,45,468,35919,13.0293159609121
20420,"Durango, CO",1994,530,62,592,36991,16.0038928387986
20420,"Durango, CO",1995,499,144,643,38471,16.7138883834577
20420,"Durango, CO",1996,435,79,514,39420,13.039066463724
20420,"Durango, CO",1997,384,81,465,40070,11.6046917893686
20420,"Durango, CO",1998,373,141,514,40492,12.6938654549047
20420,"Durango, CO",1999,385,16,401,40973,9.78693285822371
20420,"Durango, CO",2000,393,40,433,44228,9.79017816767658
20420,"Durango, CO",2001,383,169,552,45044,12.254684308676
20420,"Durango, CO",2002,461,55,516,45869,11.2494277180667
20420,"Durango, CO",2003,644,112,756,46121,16.3916654018777
20420,"Durango, CO",2004,692,59,751,46728,16.0717342920733
20420,"Durango, CO",2005,792,115,907,47575,19.0646347871781
20420,"Durango, CO",2006,606,121,727,48574,14.9668546959279
20420,"Durango, CO",2007,527,202,729,49343,14.774132095738
20420,"Durango, CO",2008,290,60,350,50291,6.95949573482333
20420,"Durango, CO",2009,192,41,233,51105,4.55924077878877
20420,"Durango, CO",2010,170,52,222,51343,4.32386109109324
20420,"Durango, CO",2011,152,2,154,51794,2.97331737266865
20420,"Durango, CO",2012,159,13,172,52369,3.28438580075999
20420,"Durango, CO",2013,267,7,274,53287,5.14196708390414
20420,"Durango, CO",2014,228,50,278,53788,5.16843905703874
20420,"Durango, CO",2015,229,107,336,54609,6.15283195077734
20420,"Durango, CO",2016,211,49,260,55258,4.70520105686054
20420,"Durango, CO",2017,296,268,564,55541,10.1546605210565
20420,"Durango, CO",2018,238,44,282,56310,5.00799147575919
20460,"Durant, OK",1990,15,0,15,32110,0.467144191840548
20460,"Durant, OK",1991,26,0,26,32171,0.80818128127817
20460,"Durant, OK",1992,19,2,21,32463,0.646890305886702
20460,"Durant, OK",1993,15,2,17,33083,0.513859081703594
20460,"Durant, OK",1994,21,0,21,33211,0.632320616663154
20460,"Durant, OK",1995,30,2,32,33645,0.95110714816466
20460,"Durant, OK",1996,41,0,41,33806,1.21280246110158
20460,"Durant, OK",1997,27,2,29,34276,0.846073054031976
20460,"Durant, OK",1998,33,2,35,34707,1.00844210101709
20460,"Durant, OK",1999,23,6,29,34851,0.832113856130384
20460,"Durant, OK",2000,21,0,21,36604,0.573707791498197
20460,"Durant, OK",2001,37,8,45,36577,1.2302813243295
20460,"Durant, OK",2002,71,113,184,37003,4.97256979163852
20460,"Durant, OK",2003,66,15,81,37260,2.17391304347826
20460,"Durant, OK",2004,53,20,73,37887,1.92678227360308
20460,"Durant, OK",2005,63,45,108,38309,2.81918087133572
20460,"Durant, OK",2006,55,360,415,39739,10.4431414982763
20460,"Durant, OK",2007,54,116,170,40350,4.21313506815366
20460,"Durant, OK",2008,63,88,151,41453,3.64267966130316
20460,"Durant, OK",2009,46,18,64,41859,1.52894240187295
20460,"Durant, OK",2010,68,12,80,42583,1.8786839818707
20460,"Durant, OK",2011,66,36,102,43137,2.36455942694207
20460,"Durant, OK",2012,86,13,99,43451,2.27842857471635
20460,"Durant, OK",2013,55,30,85,44118,1.92665125345664
20460,"Durant, OK",2014,79,8,87,44495,1.95527587369367
20460,"Durant, OK",2015,41,12,53,45041,1.176705668169
20460,"Durant, OK",2016,59,14,73,45607,1.60063148200934
20460,"Durant, OK",2017,70,31,101,46460,2.17391304347826
20460,"Durant, OK",2018,102,92,194,47192,4.1108662485167
20500,"Durham-Chapel Hill, NC",1990,1719,778,2497,346348,7.20951182048113
20500,"Durham-Chapel Hill, NC",1991,1738,302,2040,351773,5.79919436682179
20500,"Durham-Chapel Hill, NC",1992,2212,284,2496,357516,6.9815057228208
20500,"Durham-Chapel Hill, NC",1993,2296,251,2547,364439,6.9888239184061
20500,"Durham-Chapel Hill, NC",1994,2389,1439,3828,369796,10.3516533440059
20500,"Durham-Chapel Hill, NC",1995,2431,1160,3591,375282,9.56880425919708
20500,"Durham-Chapel Hill, NC",1996,2539,1109,3648,380362,9.5908634406171
20500,"Durham-Chapel Hill, NC",1997,2836,2257,5093,386628,13.172869011039
20500,"Durham-Chapel Hill, NC",1998,3358,1454,4812,391621,12.2873901042079
20500,"Durham-Chapel Hill, NC",1999,3561,2008,5569,395977,14.0639481586052
20500,"Durham-Chapel Hill, NC",2000,3156,1375,4531,426116,10.6332547944691
20500,"Durham-Chapel Hill, NC",2001,3550,2226,5776,435229,13.2711744851561
20500,"Durham-Chapel Hill, NC",2002,3544,1152,4696,441780,10.6297252025895
20500,"Durham-Chapel Hill, NC",2003,3961,1142,5103,446402,11.4314003969516
20500,"Durham-Chapel Hill, NC",2004,4075,902,4977,451323,11.0275789179811
20500,"Durham-Chapel Hill, NC",2005,4177,216,4393,458287,9.58569629948046
20500,"Durham-Chapel Hill, NC",2006,3460,913,4373,468238,9.33926763739808
20500,"Durham-Chapel Hill, NC",2007,2845,409,3254,478699,6.79759097052636
20500,"Durham-Chapel Hill, NC",2008,2111,387,2498,489919,5.09880204686897
20500,"Durham-Chapel Hill, NC",2009,1324,1333,2657,499753,5.31662641344824
20500,"Durham-Chapel Hill, NC",2010,1530,383,1913,508593,3.76135731321509
20500,"Durham-Chapel Hill, NC",2011,1526,398,1924,514980,3.73606742009398
20500,"Durham-Chapel Hill, NC",2012,1595,1719,3314,524210,6.32189389748383
20500,"Durham-Chapel Hill, NC",2013,1969,2725,4694,532654,8.812474889891
20500,"Durham-Chapel Hill, NC",2014,2167,420,2587,541319,4.77906742604638
20500,"Durham-Chapel Hill, NC",2015,2616,1795,4411,549596,8.02589538497369
20500,"Durham-Chapel Hill, NC",2016,2951,1431,4382,559639,7.83004758424627
20500,"Durham-Chapel Hill, NC",2017,3268,1656,4924,566491,8.69210631766436
20500,"Durham-Chapel Hill, NC",2018,3289,2127,5416,575412,9.41238625541351
20540,"Dyersburg, TN",1990,129,23,152,34937,4.35068838194464
20540,"Dyersburg, TN",1991,116,16,132,34868,3.78570609154526
20540,"Dyersburg, TN",1992,169,4,173,34827,4.96741034255032
20540,"Dyersburg, TN",1993,176,6,182,35285,5.15799914978036
20540,"Dyersburg, TN",1994,171,41,212,35546,5.96410285264165
20540,"Dyersburg, TN",1995,195,33,228,35720,6.38297872340426
20540,"Dyersburg, TN",1996,238,54,292,36119,8.08438771837537
20540,"Dyersburg, TN",1997,202,8,210,36412,5.76732945182907
20540,"Dyersburg, TN",1998,227,37,264,36609,7.21134147340818
20540,"Dyersburg, TN",1999,228,7,235,36798,6.38621664220882
20540,"Dyersburg, TN",2000,149,125,274,37325,7.34092431346283
20540,"Dyersburg, TN",2001,114,6,120,37156,3.22962643987512
20540,"Dyersburg, TN",2002,136,2,138,37166,3.71307108647689
20540,"Dyersburg, TN",2003,118,7,125,37332,3.34833386906675
20540,"Dyersburg, TN",2004,133,7,140,37520,3.73134328358209
20540,"Dyersburg, TN",2005,90,0,90,37882,2.37579853228446
20540,"Dyersburg, TN",2006,133,2,135,38043,3.5486160397445
20540,"Dyersburg, TN",2007,89,0,89,38077,2.33736901541613
20540,"Dyersburg, TN",2008,68,0,68,38149,1.78248446879342
20540,"Dyersburg, TN",2009,47,0,47,38254,1.22862968578449
20540,"Dyersburg, TN",2010,58,0,58,38316,1.51372794654974
20540,"Dyersburg, TN",2011,48,0,48,38110,1.25951193912359
20540,"Dyersburg, TN",2012,56,0,56,38181,1.46669809591158
20540,"Dyersburg, TN",2013,54,0,54,38090,1.41769493305329
20540,"Dyersburg, TN",2014,56,0,56,37811,1.48105048795324
20540,"Dyersburg, TN",2015,58,6,64,37775,1.69424222369292
20540,"Dyersburg, TN",2016,70,6,76,37570,2.02289060420548
20540,"Dyersburg, TN",2017,58,6,64,37403,1.71109269309948
20540,"Dyersburg, TN",2018,73,6,79,37320,2.11682743837085
20580,"Eagle Pass, TX",1990,52,13,65,36748,1.76880374442147
20580,"Eagle Pass, TX",1991,51,12,63,38418,1.63985631735124
20580,"Eagle Pass, TX",1992,61,36,97,40102,2.41883197845494
20580,"Eagle Pass, TX",1993,87,13,100,41836,2.39028587819103
20580,"Eagle Pass, TX",1994,127,17,144,43155,3.33680917622523
20580,"Eagle Pass, TX",1995,122,154,276,44548,6.1955643350992204
20580,"Eagle Pass, TX",1996,101,36,137,45685,2.99879610375397
20580,"Eagle Pass, TX",1997,95,10,105,46741,2.24642177103614
20580,"Eagle Pass, TX",1998,130,54,184,47659,3.86076082167062
20580,"Eagle Pass, TX",1999,169,47,216,48680,4.43714050944947
20580,"Eagle Pass, TX",2000,148,31,179,47343,3.78091798153898
20580,"Eagle Pass, TX",2001,180,22,202,47594,4.24423246627726
20580,"Eagle Pass, TX",2002,178,25,203,48408,4.19352173194513
20580,"Eagle Pass, TX",2003,165,47,212,49123,4.31569733118906
20580,"Eagle Pass, TX",2004,203,23,226,49627,4.55397263586354
20580,"Eagle Pass, TX",2005,213,14,227,50140,4.52732349421619
20580,"Eagle Pass, TX",2006,168,0,168,50951,3.29728562736747
20580,"Eagle Pass, TX",2007,107,3,110,51367,2.14145268362957
20580,"Eagle Pass, TX",2008,81,14,95,52190,1.82027208277448
20580,"Eagle Pass, TX",2009,101,130,231,53434,4.3230901673092
20580,"Eagle Pass, TX",2010,156,49,205,54448,3.76506024096386
20580,"Eagle Pass, TX",2011,66,70,136,55292,2.45966866816176
20580,"Eagle Pass, TX",2012,75,4,79,55808,1.41556766055046
20580,"Eagle Pass, TX",2013,68,45,113,56593,1.9967133744456
20580,"Eagle Pass, TX",2014,70,29,99,57197,1.73086001014039
20580,"Eagle Pass, TX",2015,79,16,95,57806,1.64342801785282
20580,"Eagle Pass, TX",2016,64,12,76,58134,1.30732445728833
20580,"Eagle Pass, TX",2017,63,12,75,58227,1.2880622391674
20580,"Eagle Pass, TX",2018,68,4,72,58485,1.23108489356245
20660,"Easton, MD",1990,245,4,249,30655,8.12265535801664
20660,"Easton, MD",1991,170,8,178,31185,5.70787237453904
20660,"Easton, MD",1992,231,140,371,31272,11.8636479918138
20660,"Easton, MD",1993,244,3,247,31549,7.82909125487337
20660,"Easton, MD",1994,244,4,248,31972,7.75678718879019
20660,"Easton, MD",1995,253,9,262,32377,8.09216419062915
20660,"Easton, MD",1996,302,42,344,32414,10.6126982168199
20660,"Easton, MD",1997,266,86,352,32728,10.7553165485211
20660,"Easton, MD",1998,309,38,347,33131,10.4735745978087
20660,"Easton, MD",1999,290,0,290,33409,8.68029572869586
20660,"Easton, MD",2000,339,0,339,33895,10.0014751438265
20660,"Easton, MD",2001,365,0,365,34231,10.6628494639362
20660,"Easton, MD",2002,387,0,387,34628,11.175926995495
20660,"Easton, MD",2003,522,0,522,34994,14.9168428873521
20660,"Easton, MD",2004,625,0,625,35793,17.4615148213338
20660,"Easton, MD",2005,648,0,648,36423,17.7909562638992
20660,"Easton, MD",2006,578,0,578,37000,15.6216216216216
20660,"Easton, MD",2007,480,0,480,37167,12.9146823795302
20660,"Easton, MD",2008,315,0,315,37307,8.44345565175436
20660,"Easton, MD",2009,205,0,205,37496,5.46724983998293
20660,"Easton, MD",2010,173,0,173,37874,4.5677773670592
20660,"Easton, MD",2011,169,0,169,37941,4.45428428349279
20660,"Easton, MD",2012,176,0,176,37983,4.63365189690125
20660,"Easton, MD",2013,210,40,250,37898,6.59665417700142
20660,"Easton, MD",2014,43,0,43,37529,1.14578059633883
20660,"Easton, MD",2015,73,0,73,37414,1.95114128401133
20660,"Easton, MD",2016,50,0,50,37123,1.34687390566495
20660,"Easton, MD",2017,74,0,74,37020,1.99891950297137
20660,"Easton, MD",2018,89,18,107,36968,2.89439515256438
20700,"East Stroudsburg, PA",1990,1541,85,1626,96761,16.8042909850043
20700,"East Stroudsburg, PA",1991,1300,73,1373,100802,13.6207614928275
20700,"East Stroudsburg, PA",1992,1287,33,1320,104401,12.6435570540512
20700,"East Stroudsburg, PA",1993,1320,87,1407,108191,13.0047785860192
20700,"East Stroudsburg, PA",1994,1199,67,1266,112208,11.2826179951519
20700,"East Stroudsburg, PA",1995,1056,27,1083,115820,9.35071662925229
20700,"East Stroudsburg, PA",1996,980,54,1034,119311,8.66642639823654
20700,"East Stroudsburg, PA",1997,936,54,990,122694,8.06885422270038
20700,"East Stroudsburg, PA",1998,1130,192,1322,125439,10.5389870773842
20700,"East Stroudsburg, PA",1999,1367,7,1374,128525,10.6905271347987
20700,"East Stroudsburg, PA",2000,1481,149,1630,139710,11.6670245508553
20700,"East Stroudsburg, PA",2001,1510,12,1522,143775,10.5859850460789
20700,"East Stroudsburg, PA",2002,1573,47,1620,148833,10.8846828324364
20700,"East Stroudsburg, PA",2003,1679,45,1724,154027,11.192842813273
20700,"East Stroudsburg, PA",2004,1645,108,1753,158181,11.0822412299834
20700,"East Stroudsburg, PA",2005,1610,50,1660,162045,10.2440680058009
20700,"East Stroudsburg, PA",2006,1399,38,1437,165185,8.69933710688017
20700,"East Stroudsburg, PA",2007,900,64,964,167352,5.7603135905158
20700,"East Stroudsburg, PA",2008,462,81,543,168576,3.22109908883827
20700,"East Stroudsburg, PA",2009,235,25,260,169390,1.53491941673062
20700,"East Stroudsburg, PA",2010,240,23,263,169843,1.54848889857103
20700,"East Stroudsburg, PA",2011,197,0,197,169877,1.15966257939568
20700,"East Stroudsburg, PA",2012,154,2,156,168629,0.925107780986663
20700,"East Stroudsburg, PA",2013,160,4,164,167370,0.979864969827329
20700,"East Stroudsburg, PA",2014,153,0,153,167313,0.914453748363845
20700,"East Stroudsburg, PA",2015,152,0,152,166598,0.912375898870335
20700,"East Stroudsburg, PA",2016,246,0,246,166421,1.47817883560368
20700,"East Stroudsburg, PA",2017,248,0,248,168089,1.47540886078209
20700,"East Stroudsburg, PA",2018,186,0,186,169507,1.09729981652675
20740,"Eau Claire, WI",1990,381,129,510,137690,3.70397269227976
20740,"Eau Claire, WI",1991,355,124,479,138918,3.44807728300148
20740,"Eau Claire, WI",1992,492,267,759,139873,5.42635104702123
20740,"Eau Claire, WI",1993,497,196,693,140905,4.91820730279266
20740,"Eau Claire, WI",1994,467,279,746,141578,5.26918023986778
20740,"Eau Claire, WI",1995,496,313,809,142185,5.68977036958892
20740,"Eau Claire, WI",1996,549,416,965,142727,6.76115941622818
20740,"Eau Claire, WI",1997,680,398,1078,143367,7.51916410331527
20740,"Eau Claire, WI",1998,723,482,1205,143659,8.38791861282621
20740,"Eau Claire, WI",1999,775,323,1098,144210,7.61389640108175
20740,"Eau Claire, WI",2000,839,334,1173,148656,7.89070067807556
20740,"Eau Claire, WI",2001,864,558,1422,149655,9.50185426480906
20740,"Eau Claire, WI",2002,846,524,1370,150846,9.08211023162696
20740,"Eau Claire, WI",2003,893,269,1162,151816,7.65400221320546
20740,"Eau Claire, WI",2004,867,235,1102,153419,7.18294344246801
20740,"Eau Claire, WI",2005,708,262,970,154809,6.26578558094168
20740,"Eau Claire, WI",2006,615,167,782,156167,5.0074599627322
20740,"Eau Claire, WI",2007,504,147,651,157654,4.12929579966255
20740,"Eau Claire, WI",2008,327,153,480,158700,3.02457466918715
20740,"Eau Claire, WI",2009,311,110,421,160271,2.62680085605007
20740,"Eau Claire, WI",2010,292,65,357,161654,2.20842045356131
20740,"Eau Claire, WI",2011,245,119,364,162868,2.23493872338335
20740,"Eau Claire, WI",2012,301,304,605,163877,3.69179323517028
20740,"Eau Claire, WI",2013,335,321,656,164818,3.98014779939084
20740,"Eau Claire, WI",2014,343,120,463,165022,2.80568651452534
20740,"Eau Claire, WI",2015,400,277,677,165535,4.08976953514362
20740,"Eau Claire, WI",2016,439,324,763,166467,4.58349102224465
20740,"Eau Claire, WI",2017,422,146,568,167436,3.39234095415562
20740,"Eau Claire, WI",2018,486,276,762,168669,4.51772406310585
20780,"Edwards, CO",1990,312,331,643,22208,28.953530259366
20780,"Edwards, CO",1991,304,187,491,23469,20.9212152200775
20780,"Edwards, CO",1992,287,276,563,24617,22.8703741316976
20780,"Edwards, CO",1993,357,559,916,25936,35.3177051202961
20780,"Edwards, CO",1994,622,467,1089,27545,39.5353058631331
20780,"Edwards, CO",1995,574,454,1028,29059,35.376303382773
20780,"Edwards, CO",1996,496,483,979,30247,32.3668462988065
20780,"Edwards, CO",1997,614,873,1487,31965,46.5196308462381
20780,"Edwards, CO",1998,624,514,1138,33700,33.7685459940653
20780,"Edwards, CO",1999,535,346,881,34902,25.2421064695433
20780,"Edwards, CO",2000,448,253,701,41961,16.7059888944496
20780,"Edwards, CO",2001,404,162,566,43238,13.0903372033859
20780,"Edwards, CO",2002,352,338,690,44227,15.6013295046013
20780,"Edwards, CO",2003,466,50,516,44995,11.4679408823203
20780,"Edwards, CO",2004,690,65,755,45893,16.4513106573987
20780,"Edwards, CO",2005,645,139,784,47205,16.608410126046
20780,"Edwards, CO",2006,534,85,619,48476,12.7692053799818
20780,"Edwards, CO",2007,450,107,557,49803,11.1840652169548
20780,"Edwards, CO",2008,164,13,177,51049,3.46725694920567
20780,"Edwards, CO",2009,56,22,78,52513,1.48534648563213
20780,"Edwards, CO",2010,57,4,61,52104,1.17073545217258
20780,"Edwards, CO",2011,51,2,53,52072,1.0178214779536
20780,"Edwards, CO",2012,89,6,95,52366,1.81415422220525
20780,"Edwards, CO",2013,104,26,130,52857,2.45946610666515
20780,"Edwards, CO",2014,106,150,256,53323,4.80093018022242
20780,"Edwards, CO",2015,162,26,188,53896,3.48819949532433
20780,"Edwards, CO",2016,190,156,346,54579,6.33943458106598
20780,"Edwards, CO",2017,304,122,426,54992,7.74658132091941
20780,"Edwards, CO",2018,263,119,382,54993,6.9463386249159
20820,"Effingham, IL",1990,76,36,112,31748,3.52778127756079
20820,"Effingham, IL",1991,57,6,63,31892,1.97541703248464
20820,"Effingham, IL",1992,61,4,65,32043,2.02852417064569
20820,"Effingham, IL",1993,84,14,98,32278,3.0361236755685
20820,"Effingham, IL",1994,92,42,134,32641,4.10526638277014
20820,"Effingham, IL",1995,87,100,187,32889,5.6857916020554
20820,"Effingham, IL",1996,95,42,137,33220,4.12402167369055
20820,"Effingham, IL",1997,86,104,190,33381,5.69186063928582
20820,"Effingham, IL",1998,69,6,75,33541,2.23606928833368
20820,"Effingham, IL",1999,71,12,83,33748,2.45940500177788
20820,"Effingham, IL",2000,49,8,57,34248,1.66433076384022
20820,"Effingham, IL",2001,41,8,49,34334,1.42715675423778
20820,"Effingham, IL",2002,36,15,51,34281,1.48770455937691
20820,"Effingham, IL",2003,57,6,63,34408,1.83096954196698
20820,"Effingham, IL",2004,69,0,69,34497,2.00017392816767
20820,"Effingham, IL",2005,68,8,76,34365,2.21155245162229
20820,"Effingham, IL",2006,62,14,76,34289,2.21645425646709
20820,"Effingham, IL",2007,36,6,42,34191,1.22839343686935
20820,"Effingham, IL",2008,55,16,71,34173,2.07766365259123
20820,"Effingham, IL",2009,38,22,60,34275,1.75054704595186
20820,"Effingham, IL",2010,18,129,147,34223,4.29535692370628
20820,"Effingham, IL",2011,28,4,32,34265,0.933897563111046
20820,"Effingham, IL",2012,16,0,16,34270,0.466880653632915
20820,"Effingham, IL",2013,22,13,35,34215,1.02294315358761
20820,"Effingham, IL",2014,24,0,24,34119,0.703420381605557
20820,"Effingham, IL",2015,23,32,55,34209,1.60776403870327
20820,"Effingham, IL",2016,29,10,39,34186,1.14081787866378
20820,"Effingham, IL",2017,36,6,42,34147,1.2299762790289
20820,"Effingham, IL",2018,28,32,60,34208,1.75397567820393
20900,"El Campo, TX",1990,12,40,52,39835,1.30538471193674
20900,"El Campo, TX",1991,14,32,46,39695,1.15883612545661
20900,"El Campo, TX",1992,24,0,24,39934,0.60099163619973
20900,"El Campo, TX",1993,16,104,120,39918,3.00616263339847
20900,"El Campo, TX",1994,15,0,15,39944,0.375525736030443
20900,"El Campo, TX",1995,16,0,16,39907,0.400932167288947
20900,"El Campo, TX",1996,22,0,22,39917,0.551143623017762
20900,"El Campo, TX",1997,26,0,26,40007,0.649886269902767
20900,"El Campo, TX",1998,14,0,14,40053,0.349536863655656
20900,"El Campo, TX",1999,17,0,17,40191,0.422980269214501
20900,"El Campo, TX",2000,32,100,132,41220,3.20232896652111
20900,"El Campo, TX",2001,23,0,23,40991,0.561098777780488
20900,"El Campo, TX",2002,27,0,27,40915,0.659904680435048
20900,"El Campo, TX",2003,37,0,37,41026,0.901867108662799
20900,"El Campo, TX",2004,26,4,30,40992,0.731850117096019
20900,"El Campo, TX",2005,34,0,34,40987,0.829531314807134
20900,"El Campo, TX",2006,45,16,61,41073,1.48516056776958
20900,"El Campo, TX",2007,50,0,50,40845,1.22414004162076
20900,"El Campo, TX",2008,31,0,31,40893,0.75807595431981
20900,"El Campo, TX",2009,13,0,13,40998,0.317088638470169
20900,"El Campo, TX",2010,12,0,12,41281,0.290690632494368
20900,"El Campo, TX",2011,10,0,10,41289,0.242195257816852
20900,"El Campo, TX",2012,15,0,15,41149,0.364528907142336
20900,"El Campo, TX",2013,87,0,87,41142,2.11462738807058
20900,"El Campo, TX",2014,19,0,19,41124,0.462017313490906
20900,"El Campo, TX",2015,69,2,71,41426,1.71389948341621
20900,"El Campo, TX",2016,82,0,82,41668,1.96793702601517
20900,"El Campo, TX",2017,78,0,78,41916,1.86086458631549
20900,"El Campo, TX",2018,96,4,100,41619,2.40274874456378
20940,"El Centro, CA",1990,500,587,1087,110931,9.79888399094933
20940,"El Centro, CA",1991,672,165,837,117630,7.11553175210406
20940,"El Centro, CA",1992,837,164,1001,124750,8.02404809619238
20940,"El Centro, CA",1993,528,99,627,134198,4.67220077795496
20940,"El Centro, CA",1994,657,177,834,136225,6.12222426133235
20940,"El Centro, CA",1995,342,150,492,139397,3.52948772211741
20940,"El Centro, CA",1996,315,37,352,140885,2.4984916776094
20940,"El Centro, CA",1997,276,66,342,142010,2.4082811069643
20940,"El Centro, CA",1998,356,77,433,143505,3.01731646980941
20940,"El Centro, CA",1999,333,6,339,145473,2.33032933946506
20940,"El Centro, CA",2000,594,179,773,142410,5.42798960747139
20940,"El Centro, CA",2001,551,506,1057,143707,7.35524365549347
20940,"El Centro, CA",2002,827,194,1021,145640,7.01043669321615
20940,"El Centro, CA",2003,1025,176,1201,148984,8.0612683241153391
20940,"El Centro, CA",2004,1417,361,1778,152259,11.6774706257101
20940,"El Centro, CA",2005,1940,251,2191,156113,14.0347056298963
20940,"El Centro, CA",2006,1934,269,2203,160505,13.7254291143578
20940,"El Centro, CA",2007,648,321,969,164596,5.88714185034873
20940,"El Centro, CA",2008,259,252,511,167917,3.04317013762752
20940,"El Centro, CA",2009,184,12,196,172008,1.13948188456351
20940,"El Centro, CA",2010,102,0,102,174730,0.583757797745093
20940,"El Centro, CA",2011,129,128,257,175813,1.46178041441759
20940,"El Centro, CA",2012,211,76,287,176678,1.62442409354872
20940,"El Centro, CA",2013,297,6,303,176605,1.71569321366892
20940,"El Centro, CA",2014,185,61,246,178233,1.38021578495565
20940,"El Centro, CA",2015,112,181,293,179179,1.63523627210778
20940,"El Centro, CA",2016,213,2,215,180268,1.1926686932789
20940,"El Centro, CA",2017,179,12,191,181574,1.05191271878132
20940,"El Centro, CA",2018,274,126,400,181827,2.1998933051747
20980,"El Dorado, AR",1990,16,8,24,46766,0.513193345592952
20980,"El Dorado, AR",1991,14,18,32,46555,0.687359037697347
20980,"El Dorado, AR",1992,22,8,30,46605,0.643707756678468
20980,"El Dorado, AR",1993,14,24,38,46435,0.818348228706794
20980,"El Dorado, AR",1994,7,24,31,46178,0.671315344969466
20980,"El Dorado, AR",1995,13,0,13,46139,0.281757298597716
20980,"El Dorado, AR",1996,12,2,14,45806,0.305636816137624
20980,"El Dorado, AR",1997,10,27,37,45345,0.815966479214908
20980,"El Dorado, AR",1998,17,5,22,45302,0.485629773519933
20980,"El Dorado, AR",1999,17,0,17,45032,0.377509326701013
20980,"El Dorado, AR",2000,7,0,7,45532,0.153738030396205
20980,"El Dorado, AR",2001,13,0,13,44894,0.289570989441796
20980,"El Dorado, AR",2002,16,0,16,44769,0.357390158368514
20980,"El Dorado, AR",2003,31,0,31,44281,0.700074524062239
20980,"El Dorado, AR",2004,24,0,24,43747,0.548609047477541
20980,"El Dorado, AR",2005,20,0,20,43134,0.463671349747299
20980,"El Dorado, AR",2006,15,0,15,42914,0.349536281866058
20980,"El Dorado, AR",2007,14,0,14,42267,0.331227671706059
20980,"El Dorado, AR",2008,15,0,15,42222,0.355265027710672
20980,"El Dorado, AR",2009,6,0,6,41944,0.143047873354949
20980,"El Dorado, AR",2010,3,0,3,41573,0.0721622206720708
20980,"El Dorado, AR",2011,6,0,6,41398,0.144934537900382
20980,"El Dorado, AR",2012,3,72,75,40862,1.83544613577407
20980,"El Dorado, AR",2013,4,71,75,40606,1.84701768211594
20980,"El Dorado, AR",2014,9,78,87,40140,2.16741405082212
20980,"El Dorado, AR",2015,8,75,83,40093,2.07018681565361
20980,"El Dorado, AR",2016,8,78,86,39883,2.15630719855578
20980,"El Dorado, AR",2017,10,80,90,39420,2.28310502283105
20980,"El Dorado, AR",2018,6,0,6,39126,0.153350713080816
21020,"Elizabeth City, NC",1990,219,35,254,47834,5.31003052222269
21020,"Elizabeth City, NC",1991,262,33,295,48234,6.1160177468176
21020,"Elizabeth City, NC",1992,278,13,291,49128,5.92330239374695
21020,"Elizabeth City, NC",1993,305,18,323,50000,6.46
21020,"Elizabeth City, NC",1994,298,29,327,50445,6.48230746357419
21020,"Elizabeth City, NC",1995,299,6,305,50738,6.0112736016398
21020,"Elizabeth City, NC",1996,302,60,362,51812,6.98679842507527
21020,"Elizabeth City, NC",1997,291,92,383,52992,7.22750603864734
21020,"Elizabeth City, NC",1998,303,8,311,53608,5.80137292941352
21020,"Elizabeth City, NC",1999,269,2,271,53690,5.04749487800335
21020,"Elizabeth City, NC",2000,234,0,234,53212,4.39750432233331
21020,"Elizabeth City, NC",2001,289,0,289,53420,5.4099588169225
21020,"Elizabeth City, NC",2002,456,6,462,54291,8.5096977399569
21020,"Elizabeth City, NC",2003,468,4,472,55263,8.54097678374319
21020,"Elizabeth City, NC",2004,693,0,693,56765,12.2082269003788
21020,"Elizabeth City, NC",2005,750,100,850,58834,14.4474283577523
21020,"Elizabeth City, NC",2006,582,2,584,60771,9.60984680192855
21020,"Elizabeth City, NC",2007,332,0,332,62520,5.31030070377479
21020,"Elizabeth City, NC",2008,300,216,516,63648,8.10708898944193
21020,"Elizabeth City, NC",2009,127,97,224,63713,3.51576601321551
21020,"Elizabeth City, NC",2010,114,0,114,64119,1.77794413512375
21020,"Elizabeth City, NC",2011,107,0,107,63780,1.67764189401066
21020,"Elizabeth City, NC",2012,112,0,112,63967,1.75090280926103
21020,"Elizabeth City, NC",2013,148,0,148,63300,2.33807266982622
21020,"Elizabeth City, NC",2014,109,0,109,63255,1.72318393802861
21020,"Elizabeth City, NC",2015,132,0,132,63158,2.08999651667247
21020,"Elizabeth City, NC",2016,173,0,173,63241,2.73556711626951
21020,"Elizabeth City, NC",2017,204,0,204,63497,3.21275020867128
21020,"Elizabeth City, NC",2018,255,0,255,63771,3.99868278684669
21060,"Elizabethtown-Fort Knox, KY",1990,151,148,299,125483,2.38279288827969
21060,"Elizabethtown-Fort Knox, KY",1991,362,101,463,121581,3.80816081460097
21060,"Elizabethtown-Fort Knox, KY",1992,552,75,627,120229,5.21504795016177
21060,"Elizabethtown-Fort Knox, KY",1993,454,77,531,126753,4.18924995858086
21060,"Elizabethtown-Fort Knox, KY",1994,475,92,567,128657,4.40706685217283
21060,"Elizabethtown-Fort Knox, KY",1995,399,207,606,129887,4.66559393934728
21060,"Elizabethtown-Fort Knox, KY",1996,583,97,680,129493,5.25124910226808
21060,"Elizabethtown-Fort Knox, KY",1997,616,263,879,130908,6.71463928866074
21060,"Elizabethtown-Fort Knox, KY",1998,651,237,888,132277,6.71318520982484
21060,"Elizabethtown-Fort Knox, KY",1999,711,122,833,133527,6.23843866783497
21060,"Elizabethtown-Fort Knox, KY",2000,521,55,576,134506,4.28233684742688
21060,"Elizabethtown-Fort Knox, KY",2001,620,156,776,135657,5.72030930950854
21060,"Elizabethtown-Fort Knox, KY",2002,592,213,805,136591,5.89350689284067
21060,"Elizabethtown-Fort Knox, KY",2003,819,144,963,136333,7.06358695253534
21060,"Elizabethtown-Fort Knox, KY",2004,1120,189,1309,138230,9.46972437242277
21060,"Elizabethtown-Fort Knox, KY",2005,1147,349,1496,140177,10.6722215484709
21060,"Elizabethtown-Fort Knox, KY",2006,1001,303,1304,140870,9.25676155320508
21060,"Elizabethtown-Fort Knox, KY",2007,823,399,1222,141844,8.61509827698034
21060,"Elizabethtown-Fort Knox, KY",2008,503,263,766,142988,5.35709290290094
21060,"Elizabethtown-Fort Knox, KY",2009,467,99,566,143829,3.93522863956504
21060,"Elizabethtown-Fort Knox, KY",2010,842,616,1458,149847,9.72992452301347
21060,"Elizabethtown-Fort Knox, KY",2011,352,464,816,151338,5.39190421440749
21060,"Elizabethtown-Fort Knox, KY",2012,358,233,591,151567,3.89926567128729
21060,"Elizabethtown-Fort Knox, KY",2013,398,122,520,152291,3.41451563125858
21060,"Elizabethtown-Fort Knox, KY",2014,292,200,492,151745,3.24228145902666
21060,"Elizabethtown-Fort Knox, KY",2015,280,28,308,148184,2.0784970037251
21060,"Elizabethtown-Fort Knox, KY",2016,318,149,467,149050,3.13317678631332
21060,"Elizabethtown-Fort Knox, KY",2017,415,92,507,150531,3.36807700739383
21060,"Elizabethtown-Fort Knox, KY",2018,390,68,458,153378,2.98608666171159
21120,"Elk City, OK",1990,2,0,2,18786,0.106462259129139
21120,"Elk City, OK",1991,6,2,8,18867,0.424020777018074
21120,"Elk City, OK",1992,7,0,7,18825,0.371845949535193
21120,"Elk City, OK",1993,22,0,22,18780,1.17145899893504
21120,"Elk City, OK",1994,15,0,15,19066,0.786740795132697
21120,"Elk City, OK",1995,25,0,25,19302,1.2952025696819
21120,"Elk City, OK",1996,28,0,28,19369,1.44560896277557
21120,"Elk City, OK",1997,30,0,30,19345,1.55078831739468
21120,"Elk City, OK",1998,40,0,40,19983,2.0017014462293
21120,"Elk City, OK",1999,35,0,35,20581,1.70059763859871
21120,"Elk City, OK",2000,36,60,96,19777,4.85412347676594
21120,"Elk City, OK",2001,29,0,29,19937,1.45458193308923
21120,"Elk City, OK",2002,21,0,21,20142,1.04259755734287
21120,"Elk City, OK",2003,29,0,29,19663,1.47485124345217
21120,"Elk City, OK",2004,26,0,26,18580,1.39935414424112
21120,"Elk City, OK",2005,70,2,72,19151,3.75959479922719
21120,"Elk City, OK",2006,68,0,68,20040,3.39321357285429
21120,"Elk City, OK",2007,49,2,51,21855,2.33356211393274
21120,"Elk City, OK",2008,37,2,39,22817,1.70925187360302
21120,"Elk City, OK",2009,11,0,11,22369,0.491751978184094
21120,"Elk City, OK",2010,20,0,20,22060,0.906618313689937
21120,"Elk City, OK",2011,30,10,40,22306,1.79323948713351
21120,"Elk City, OK",2012,63,30,93,23069,4.03138410854393
21120,"Elk City, OK",2013,53,222,275,23469,11.7175848992288
21120,"Elk City, OK",2014,29,0,29,23599,1.22886562989957
21120,"Elk City, OK",2015,10,0,10,23561,0.424430202453207
21120,"Elk City, OK",2016,5,0,5,22433,0.22288592698257
21120,"Elk City, OK",2017,28,0,28,21804,1.284168042561
21120,"Elk City, OK",2018,9,0,9,21709,0.414574600396149
21140,"Elkhart-Goshen, IN",1990,668,76,744,156379,4.75767206594236
21140,"Elkhart-Goshen, IN",1991,593,36,629,157442,3.99512201318581
21140,"Elkhart-Goshen, IN",1992,664,228,892,159178,5.60378946839387
21140,"Elkhart-Goshen, IN",1993,777,255,1032,161636,6.38471627607711
21140,"Elkhart-Goshen, IN",1994,848,140,988,164009,6.02405965526282
21140,"Elkhart-Goshen, IN",1995,829,214,1043,166739,6.2552852062205
21140,"Elkhart-Goshen, IN",1996,994,183,1177,168804,6.97258358806663
21140,"Elkhart-Goshen, IN",1997,875,211,1086,170835,6.35701115111072
21140,"Elkhart-Goshen, IN",1998,957,455,1412,172772,8.17262056351724
21140,"Elkhart-Goshen, IN",1999,976,151,1127,174837,6.44600399228996
21140,"Elkhart-Goshen, IN",2000,896,400,1296,183412,7.06605892744204
21140,"Elkhart-Goshen, IN",2001,884,170,1054,184708,5.70630400415791
21140,"Elkhart-Goshen, IN",2002,989,617,1606,184543,8.70257880277225
21140,"Elkhart-Goshen, IN",2003,1036,139,1175,187149,6.2784198686608
21140,"Elkhart-Goshen, IN",2004,1083,80,1163,189316,6.14316803651038
21140,"Elkhart-Goshen, IN",2005,1014,10,1024,192242,5.32661957324622
21140,"Elkhart-Goshen, IN",2006,889,34,923,195047,4.73219275354145
21140,"Elkhart-Goshen, IN",2007,613,68,681,196304,3.46910913684897
21140,"Elkhart-Goshen, IN",2008,339,150,489,197762,2.47266916798981
21140,"Elkhart-Goshen, IN",2009,137,48,185,197514,0.936642465850522
21140,"Elkhart-Goshen, IN",2010,174,60,234,197444,1.18514616802739
21140,"Elkhart-Goshen, IN",2011,146,0,146,198267,0.736380739104339
21140,"Elkhart-Goshen, IN",2012,221,0,221,198980,1.11066438838074
21140,"Elkhart-Goshen, IN",2013,283,20,303,200231,1.51325219371626
21140,"Elkhart-Goshen, IN",2014,270,0,270,201476,1.34010998828645
21140,"Elkhart-Goshen, IN",2015,307,2,309,203024,1.52198754827016
21140,"Elkhart-Goshen, IN",2016,348,6,354,203652,1.73825938365447
21140,"Elkhart-Goshen, IN",2017,366,194,560,204310,2.74093289608928
21140,"Elkhart-Goshen, IN",2018,351,0,351,205560,1.70753064798599
21180,"Elkins, WV",1990,11,0,11,27804,0.395626528557042
21180,"Elkins, WV",1991,11,4,15,28172,0.532443560982536
21180,"Elkins, WV",1992,20,0,20,28256,0.707814269535674
21180,"Elkins, WV",1993,11,4,15,28559,0.525228474386358
21180,"Elkins, WV",1994,5,18,23,28517,0.806536451940947
21180,"Elkins, WV",1995,8,0,8,28743,0.278328636537592
21180,"Elkins, WV",1996,15,6,21,28878,0.727197174319551
21180,"Elkins, WV",1997,10,0,10,28643,0.349125440770869
21180,"Elkins, WV",1998,14,0,14,28653,0.488605032631836
21180,"Elkins, WV",1999,11,28,39,28651,1.36120903284353
21180,"Elkins, WV",2000,15,14,29,28259,1.0262217346686
21180,"Elkins, WV",2001,10,13,23,28373,0.810629824128573
21180,"Elkins, WV",2002,25,0,25,28487,0.877593288166532
21180,"Elkins, WV",2003,34,0,34,28422,1.19625642108226
21180,"Elkins, WV",2004,20,0,20,28648,0.698129014241832
21180,"Elkins, WV",2005,2,8,10,28807,0.347137848439615
21180,"Elkins, WV",2006,4,4,8,29049,0.275396743433509
21180,"Elkins, WV",2007,11,0,11,29113,0.377838079208601
21180,"Elkins, WV",2008,3,6,9,29236,0.307839649746887
21180,"Elkins, WV",2009,1,8,9,29381,0.306320411150063
21180,"Elkins, WV",2010,12,0,12,29363,0.408677587439976
21180,"Elkins, WV",2011,4,6,10,29430,0.339789330615019
21180,"Elkins, WV",2012,8,5,13,29390,0.442327322218442
21180,"Elkins, WV",2013,5,8,13,29522,0.440349569812343
21180,"Elkins, WV",2014,2,8,10,29374,0.340437121263703
21180,"Elkins, WV",2015,2,4,6,29206,0.205437238923509
21180,"Elkins, WV",2016,3,0,3,29028,0.10334849111203
21180,"Elkins, WV",2017,1,2,3,28894,0.103827784315083
21180,"Elkins, WV",2018,2,11,13,28823,0.451028692363737
21220,"Elko, NV",1990,244,68,312,34144,9.1377694470478
21220,"Elko, NV",1991,182,6,188,35772,5.25550710052555
21220,"Elko, NV",1992,157,2,159,37081,4.28791025053262
21220,"Elko, NV",1993,160,27,187,38749,4.82593099176753
21220,"Elko, NV",1994,277,12,289,40238,7.18226552015508
21220,"Elko, NV",1995,291,48,339,41420,8.18445195557702
21220,"Elko, NV",1996,466,27,493,43419,11.3544761509938
21220,"Elko, NV",1997,249,46,295,45448,6.49093469459602
21220,"Elko, NV",1998,188,46,234,45951,5.09238101455899
21220,"Elko, NV",1999,114,5,119,45248,2.6299504950495
21220,"Elko, NV",2000,102,42,144,45233,3.18351645922225
21220,"Elko, NV",2001,100,24,124,45063,2.75170317111599
21220,"Elko, NV",2002,52,18,70,44173,1.58467842347135
21220,"Elko, NV",2003,96,0,96,43693,2.19714828462225
21220,"Elko, NV",2004,298,11,309,43830,7.04996577686516
21220,"Elko, NV",2005,198,0,198,44760,4.42359249329759
21220,"Elko, NV",2006,172,76,248,46108,5.37867615164397
21220,"Elko, NV",2007,152,12,164,47423,3.4582375640512
21220,"Elko, NV",2008,71,34,105,47634,2.20430784733594
21220,"Elko, NV",2009,101,0,101,48445,2.08483847662297
21220,"Elko, NV",2010,125,11,136,49085,2.77070388102272
21220,"Elko, NV",2011,177,102,279,49436,5.64366049033093
21220,"Elko, NV",2012,287,187,474,50980,9.29776382895253
21220,"Elko, NV",2013,283,116,399,52356,7.62090304836122
21220,"Elko, NV",2014,166,184,350,52557,6.65943642140914
21220,"Elko, NV",2015,200,36,236,51747,4.56065085898699
21220,"Elko, NV",2016,172,2,174,52123,3.33825758302477
21220,"Elko, NV",2017,161,0,161,52371,3.07422046552481
21220,"Elko, NV",2018,170,0,170,52460,3.24056423942051
21260,"Ellensburg, WA",1990,172,8,180,26833,6.7081578653151
21260,"Ellensburg, WA",1991,244,56,300,27658,10.8467712777497
21260,"Ellensburg, WA",1992,168,85,253,27961,9.04831729909517
21260,"Ellensburg, WA",1993,182,187,369,28867,12.7827623237607
21260,"Ellensburg, WA",1994,237,116,353,29784,11.8520010744024
21260,"Ellensburg, WA",1995,184,167,351,30157,11.6390887687767
21260,"Ellensburg, WA",1996,258,260,518,30733,16.8548465818501
21260,"Ellensburg, WA",1997,170,344,514,31351,16.3950113234028
21260,"Ellensburg, WA",1998,216,51,267,31456,8.48804679552391
21260,"Ellensburg, WA",1999,225,2,227,31777,7.14353148503635
21260,"Ellensburg, WA",2000,216,99,315,33537,9.39261114589856
21260,"Ellensburg, WA",2001,281,40,321,34000,9.44117647058824
21260,"Ellensburg, WA",2002,318,47,365,34977,10.4354289961975
21260,"Ellensburg, WA",2003,351,80,431,35726,12.064042993898
21260,"Ellensburg, WA",2004,461,6,467,36921,12.6486281520002
21260,"Ellensburg, WA",2005,547,12,559,37537,14.891973253057
21260,"Ellensburg, WA",2006,543,45,588,38680,15.2016546018614
21260,"Ellensburg, WA",2007,508,41,549,39158,14.0201236018183
21260,"Ellensburg, WA",2008,258,24,282,40015,7.04735724103461
21260,"Ellensburg, WA",2009,175,2,177,40466,4.37404240597044
21260,"Ellensburg, WA",2010,177,6,183,40989,4.46461245700066
21260,"Ellensburg, WA",2011,169,5,174,41549,4.18782642181521
21260,"Ellensburg, WA",2012,180,15,195,41624,4.68479723236594
21260,"Ellensburg, WA",2013,285,59,344,41830,8.22376284962945
21260,"Ellensburg, WA",2014,265,18,283,42597,6.64366035166796
21260,"Ellensburg, WA",2015,285,10,295,43092,6.84581824932702
21260,"Ellensburg, WA",2016,304,19,323,44913,7.19168169572284
21260,"Ellensburg, WA",2017,364,167,531,46157,11.5042138787183
21260,"Ellensburg, WA",2018,435,194,629,47364,13.2801283675365
21300,"Elmira, NY",1990,103,10,113,95306,1.18565462825006
21300,"Elmira, NY",1991,112,20,132,95068,1.38847982496739
21300,"Elmira, NY",1992,114,38,152,95073,1.59877147034384
21300,"Elmira, NY",1993,101,35,136,94884,1.43332911765946
21300,"Elmira, NY",1994,96,28,124,94358,1.31414400474787
21300,"Elmira, NY",1995,96,29,125,93953,1.33045246027269
21300,"Elmira, NY",1996,82,32,114,93302,1.22183876015519
21300,"Elmira, NY",1997,83,31,114,92543,1.23185978410036
21300,"Elmira, NY",1998,111,25,136,92226,1.47463838830699
21300,"Elmira, NY",1999,115,181,296,91771,3.22541979492432
21300,"Elmira, NY",2000,142,36,178,91094,1.95402551210837
21300,"Elmira, NY",2001,144,35,179,90780,1.97179995593743
21300,"Elmira, NY",2002,109,32,141,90613,1.5560681138468
21300,"Elmira, NY",2003,106,39,145,90154,1.60835903010404
21300,"Elmira, NY",2004,91,4,95,89777,1.05817748421088
21300,"Elmira, NY",2005,107,0,107,88860,1.20414134593743
21300,"Elmira, NY",2006,72,19,91,88732,1.0255601136005
21300,"Elmira, NY",2007,74,18,92,88634,1.03797639731931
21300,"Elmira, NY",2008,60,3,63,88503,0.711840276600793
21300,"Elmira, NY",2009,40,32,72,88849,0.810363650688246
21300,"Elmira, NY",2010,68,8,76,88898,0.854912371481923
21300,"Elmira, NY",2011,34,104,138,88893,1.55242820019574
21300,"Elmira, NY",2012,53,86,139,89136,1.55941482678155
21300,"Elmira, NY",2013,52,29,81,88192,0.918450653120464
21300,"Elmira, NY",2014,55,6,61,87179,0.699709792495899
21300,"Elmira, NY",2015,46,32,78,86718,0.899467238635577
21300,"Elmira, NY",2016,41,0,41,85676,0.478547084364349
21300,"Elmira, NY",2017,27,74,101,84874,1.18999929306973
21300,"Elmira, NY",2018,25,161,186,84254,2.20761032117169
21340,"El Paso, TX",1990,1851,260,2111,595987,3.54202356762815
21340,"El Paso, TX",1991,1631,278,1909,611461,3.12203067734492
21340,"El Paso, TX",1992,2270,491,2761,625109,4.41682970489946
21340,"El Paso, TX",1993,2296,385,2681,642902,4.17015346040299
21340,"El Paso, TX",1994,2323,1474,3797,658018,5.77035886556295
21340,"El Paso, TX",1995,2259,370,2629,669094,3.9291938053547
21340,"El Paso, TX",1996,2347,986,3333,674258,4.94321164895337
21340,"El Paso, TX",1997,2316,397,2713,686016,3.95471825730012
21340,"El Paso, TX",1998,3039,251,3290,695380,4.73122609220858
21340,"El Paso, TX",1999,3472,724,4196,702693,5.97131321928637
21340,"El Paso, TX",2000,2879,324,3203,681729,4.69834787723568
21340,"El Paso, TX",2001,3317,121,3438,689163,4.98866015732127
21340,"El Paso, TX",2002,3459,251,3710,696446,5.3270461744342
21340,"El Paso, TX",2003,4829,442,5271,705200,7.47447532614861
21340,"El Paso, TX",2004,3407,535,3942,717652,5.49291299961541
21340,"El Paso, TX",2005,4333,1072,5405,728095,7.42348182586064
21340,"El Paso, TX",2006,3877,263,4140,744795,5.55857652105613
21340,"El Paso, TX",2007,3190,1189,4379,755578,5.79556313180109
21340,"El Paso, TX",2008,2897,1084,3981,769930,5.17059992466848
21340,"El Paso, TX",2009,2640,551,3191,786759,4.05587988189522
21340,"El Paso, TX",2010,2961,1588,4549,803655,5.66038909731166
21340,"El Paso, TX",2011,3280,873,4153,820216,5.06330039891931
21340,"El Paso, TX",2012,3176,1179,4355,832915,5.22862476963436
21340,"El Paso, TX",2013,2613,1484,4097,831746,4.92578263075506
21340,"El Paso, TX",2014,2260,783,3043,834992,3.64434629313814
21340,"El Paso, TX",2015,2518,1973,4491,833961,5.38514390960728
21340,"El Paso, TX",2016,2219,835,3054,838014,3.64433052431105
21340,"El Paso, TX",2017,2373,904,3277,840545,3.89866098781148
21340,"El Paso, TX",2018,1751,665,2416,840758,2.87359739663494
21380,"Emporia, KS",1990,19,0,19,34723,0.547187742994557
21380,"Emporia, KS",1991,24,0,24,34487,0.695914402528489
21380,"Emporia, KS",1992,14,0,14,34478,0.406056035732931
21380,"Emporia, KS",1993,45,60,105,34783,3.01871603944456
21380,"Emporia, KS",1994,32,20,52,34567,1.50432493418578
21380,"Emporia, KS",1995,20,46,66,34560,1.90972222222222
21380,"Emporia, KS",1996,30,92,122,34314,3.55540012822755
21380,"Emporia, KS",1997,25,4,29,33994,0.8530917220686
21380,"Emporia, KS",1998,25,0,25,33801,0.739623088074317
21380,"Emporia, KS",1999,30,134,164,33835,4.84705186936604
21380,"Emporia, KS",2000,24,10,34,35967,0.945310979508994
21380,"Emporia, KS",2001,35,18,53,36049,1.47022108796361
21380,"Emporia, KS",2002,23,9,32,35826,0.893206051470999
21380,"Emporia, KS",2003,32,59,91,35868,2.53708040593286
21380,"Emporia, KS",2004,62,114,176,36034,4.88427596159183
21380,"Emporia, KS",2005,90,82,172,35936,4.78628673196794
21380,"Emporia, KS",2006,55,28,83,35832,2.3163652601027
21380,"Emporia, KS",2007,73,25,98,36018,2.72086179132656
21380,"Emporia, KS",2008,16,31,47,35591,1.32055856817735
21380,"Emporia, KS",2009,24,58,82,33777,2.42768747964591
21380,"Emporia, KS",2010,23,4,27,33649,0.802401260067164
21380,"Emporia, KS",2011,15,11,26,33650,0.772659732540862
21380,"Emporia, KS",2012,16,0,16,33557,0.476800667520934
21380,"Emporia, KS",2013,17,0,17,33489,0.507629370838186
21380,"Emporia, KS",2014,17,0,17,33154,0.512758641491223
21380,"Emporia, KS",2015,18,74,92,33165,2.774008744158
21380,"Emporia, KS",2016,31,12,43,33425,1.28646222887061
21380,"Emporia, KS",2017,37,50,87,33344,2.6091650671785
21380,"Emporia, KS",2018,33,0,33,33406,0.987846494641681
21420,"Enid, OK",1990,31,0,31,56649,0.547229430351816
21420,"Enid, OK",1991,30,0,30,56301,0.532850215804337
21420,"Enid, OK",1992,41,0,41,56446,0.726357935017539
21420,"Enid, OK",1993,68,12,80,56397,1.41851516924659
21420,"Enid, OK",1994,94,8,102,56662,1.80014824750274
21420,"Enid, OK",1995,102,10,112,57149,1.95978932264782
21420,"Enid, OK",1996,135,21,156,56858,2.74367723099652
21420,"Enid, OK",1997,84,7,91,56747,1.6036090013569
21420,"Enid, OK",1998,67,14,81,56885,1.42392546365474
21420,"Enid, OK",1999,69,16,85,56811,1.49618911830455
21420,"Enid, OK",2000,55,4,59,57721,1.02215831326554
21420,"Enid, OK",2001,49,106,155,57279,2.70605282913459
21420,"Enid, OK",2002,84,83,167,57249,2.9170815210746
21420,"Enid, OK",2003,61,118,179,57230,3.12773021142757
21420,"Enid, OK",2004,89,140,229,57459,3.98545049513566
21420,"Enid, OK",2005,74,74,148,57358,2.58028522612364
21420,"Enid, OK",2006,97,36,133,57723,2.30410754811773
21420,"Enid, OK",2007,92,3,95,58153,1.63362165322511
21420,"Enid, OK",2008,61,8,69,58845,1.17257201121591
21420,"Enid, OK",2009,39,0,39,59989,0.650119188517895
21420,"Enid, OK",2010,74,0,74,60736,1.21838777660695
21420,"Enid, OK",2011,26,2,28,60755,0.46086741831948
21420,"Enid, OK",2012,29,0,29,61410,0.472235792216251
21420,"Enid, OK",2013,54,0,54,62387,0.865564941414077
21420,"Enid, OK",2014,69,0,69,62814,1.09848123029898
21420,"Enid, OK",2015,74,0,74,63285,1.16931342340207
21420,"Enid, OK",2016,70,0,70,62446,1.12096851679851
21420,"Enid, OK",2017,59,36,95,61492,1.54491641189098
21420,"Enid, OK",2018,43,0,43,60913,0.705924843629439
21460,"Enterprise, AL",1990,79,0,79,40255,1.96248913178487
21460,"Enterprise, AL",1991,63,0,63,40386,1.55994651611945
21460,"Enterprise, AL",1992,124,0,124,41118,3.01571088087942
21460,"Enterprise, AL",1993,131,0,131,41398,3.16440407749167
21460,"Enterprise, AL",1994,132,0,132,41987,3.14383023316741
21460,"Enterprise, AL",1995,165,56,221,42327,5.22125357336924
21460,"Enterprise, AL",1996,126,128,254,42123,6.0299598794008
21460,"Enterprise, AL",1997,129,2,131,42036,3.11637643924255
21460,"Enterprise, AL",1998,115,0,115,42178,2.72653990231874
21460,"Enterprise, AL",1999,123,57,180,42173,4.26813364000664
21460,"Enterprise, AL",2000,108,0,108,43580,2.47820100963745
21460,"Enterprise, AL",2001,128,0,128,43716,2.92798975203587
21460,"Enterprise, AL",2002,164,2,166,43930,3.77873890279991
21460,"Enterprise, AL",2003,204,0,204,44315,4.60340742412276
21460,"Enterprise, AL",2004,283,86,369,45053,8.19035358355714
21460,"Enterprise, AL",2005,365,160,525,45604,11.512148057188
21460,"Enterprise, AL",2006,344,0,344,46228,7.44137752011768
21460,"Enterprise, AL",2007,336,112,448,47458,9.4399258291542
21460,"Enterprise, AL",2008,255,10,265,48516,5.46211559073295
21460,"Enterprise, AL",2009,169,0,169,49440,3.41828478964401
21460,"Enterprise, AL",2010,127,112,239,50205,4.76048202370282
21460,"Enterprise, AL",2011,96,120,216,50435,4.28274016060276
21460,"Enterprise, AL",2012,91,0,91,51136,1.77956821026283
21460,"Enterprise, AL",2013,83,0,83,50677,1.63782386486966
21460,"Enterprise, AL",2014,58,0,58,50655,1.1450004935347
21460,"Enterprise, AL",2015,57,0,57,50952,1.11869995289684
21460,"Enterprise, AL",2016,67,0,67,51145,1.31000097761267
21460,"Enterprise, AL",2017,92,9,101,51777,1.95067307878015
21460,"Enterprise, AL",2018,107,5,112,51909,2.15762199233274
21500,"Erie, PA",1990,593,85,678,275786,2.4584279114966
21500,"Erie, PA",1991,580,363,943,277342,3.40013413042381
21500,"Erie, PA",1992,663,57,720,278404,2.58616973894053
21500,"Erie, PA",1993,699,283,982,279140,3.51794798309092
21500,"Erie, PA",1994,738,135,873,279482,3.12363586921519
21500,"Erie, PA",1995,638,219,857,279451,3.06672726166662
21500,"Erie, PA",1996,631,177,808,279396,2.89195264069636
21500,"Erie, PA",1997,616,183,799,278923,2.86458986888855
21500,"Erie, PA",1998,559,189,748,277592,2.69460214991787
21500,"Erie, PA",1999,660,115,775,276634,2.80153560299891
21500,"Erie, PA",2000,574,130,704,280803,2.5070957219118
21500,"Erie, PA",2001,600,115,715,280647,2.54768445769953
21500,"Erie, PA",2002,593,50,643,280379,2.29332439305369
21500,"Erie, PA",2003,600,169,769,280153,2.74492866398004
21500,"Erie, PA",2004,758,140,898,277864,3.23179685025768
21500,"Erie, PA",2005,530,194,724,277211,2.61172897179405
21500,"Erie, PA",2006,604,96,700,278389,2.51446716644695
21500,"Erie, PA",2007,583,227,810,278573,2.90767590541797
21500,"Erie, PA",2008,251,167,418,278686,1.49989594023381
21500,"Erie, PA",2009,383,90,473,279838,1.69026365254183
21500,"Erie, PA",2010,369,217,586,280797,2.08691688301513
21500,"Erie, PA",2011,140,171,311,281296,1.10559695125419
21500,"Erie, PA",2012,216,272,488,281523,1.73342852981817
21500,"Erie, PA",2013,258,209,467,280724,1.66355566321369
21500,"Erie, PA",2014,166,155,321,279437,1.14873835605163
21500,"Erie, PA",2015,192,75,267,278182,0.959803294246213
21500,"Erie, PA",2016,176,162,338,276289,1.22335670258316
21500,"Erie, PA",2017,215,50,265,273892,0.967534648693646
21500,"Erie, PA",2018,176,129,305,272061,1.12107211250418
21540,"Escanaba, MI",1990,107,9,116,37859,3.06400063393117
21540,"Escanaba, MI",1991,119,0,119,38114,3.12221231043711
21540,"Escanaba, MI",1992,162,32,194,38268,5.06950977317863
21540,"Escanaba, MI",1993,134,0,134,38507,3.47988677383333
21540,"Escanaba, MI",1994,165,6,171,38635,4.42603856606704
21540,"Escanaba, MI",1995,193,4,197,38733,5.08610229003692
21540,"Escanaba, MI",1996,180,8,188,38854,4.8386266536264
21540,"Escanaba, MI",1997,182,2,184,38894,4.73080680824806
21540,"Escanaba, MI",1998,184,0,184,38940,4.72521828454032
21540,"Escanaba, MI",1999,195,0,195,38832,5.02163164400494
21540,"Escanaba, MI",2000,180,57,237,38542,6.14913600747237
21540,"Escanaba, MI",2001,181,88,269,38356,7.01324434247575
21540,"Escanaba, MI",2002,33,4,37,38300,0.966057441253264
21540,"Escanaba, MI",2003,164,0,164,38157,4.29803181591844
21540,"Escanaba, MI",2004,167,42,209,38123,5.48225480680954
21540,"Escanaba, MI",2005,149,0,149,37982,3.92291085250908
21540,"Escanaba, MI",2006,90,0,90,37898,2.37479550372051
21540,"Escanaba, MI",2007,89,0,89,37584,2.36802894848872
21540,"Escanaba, MI",2008,55,0,55,37409,1.47023443556363
21540,"Escanaba, MI",2009,54,0,54,37059,1.45713591840039
21540,"Escanaba, MI",2010,58,2,60,37049,1.61947690895841
21540,"Escanaba, MI",2011,43,0,43,36941,1.16401829945048
21540,"Escanaba, MI",2012,32,0,32,36835,0.868738971087281
21540,"Escanaba, MI",2013,60,0,60,36802,1.63034617683822
21540,"Escanaba, MI",2014,47,0,47,36581,1.28481998851863
21540,"Escanaba, MI",2015,52,0,52,36417,1.42790455007277
21540,"Escanaba, MI",2016,36,0,36,36200,0.994475138121547
21540,"Escanaba, MI",2017,32,0,32,35896,0.891464229997771
21540,"Escanaba, MI",2018,44,0,44,35857,1.2270965222969
21580,"EspaÃ±ola, NM",1990,11,0,11,34508,0.318766662802828
21580,"EspaÃ±ola, NM",1991,7,0,7,34390,0.203547542890375
21580,"EspaÃ±ola, NM",1992,10,0,10,34743,0.287827763866102
21580,"EspaÃ±ola, NM",1993,11,3,14,35461,0.394799921040016
21580,"EspaÃ±ola, NM",1994,12,0,12,36084,0.33255736614566
21580,"EspaÃ±ola, NM",1995,36,0,36,36810,0.97799511002445
21580,"EspaÃ±ola, NM",1996,18,0,18,37474,0.480333030901425
21580,"EspaÃ±ola, NM",1997,17,0,17,37571,0.452476644220276
21580,"EspaÃ±ola, NM",1998,15,0,15,37844,0.396364020716626
21580,"EspaÃ±ola, NM",1999,13,0,13,38229,0.340055978445683
21580,"EspaÃ±ola, NM",2000,9,0,9,41197,0.218462509406025
21580,"EspaÃ±ola, NM",2001,11,0,11,40870,0.269146072914118
21580,"EspaÃ±ola, NM",2002,6,0,6,40717,0.147358597146155
21580,"EspaÃ±ola, NM",2003,10,0,10,40416,0.247426761678543
21580,"EspaÃ±ola, NM",2004,14,0,14,40342,0.347032868970304
21580,"EspaÃ±ola, NM",2005,13,0,13,40198,0.323399174088263
21580,"EspaÃ±ola, NM",2006,13,0,13,40335,0.322300731374737
21580,"EspaÃ±ola, NM",2007,4,0,4,40268,0.0993344591238701
21580,"EspaÃ±ola, NM",2008,0,0,0,40008,0
21580,"EspaÃ±ola, NM",2009,0,0,0,40023,0
21580,"EspaÃ±ola, NM",2010,3,0,3,40289,0.0744620119635633
21580,"EspaÃ±ola, NM",2011,0,0,0,40246,0
21580,"EspaÃ±ola, NM",2012,0,0,0,40197,0
21580,"EspaÃ±ola, NM",2013,0,0,0,40069,0
21580,"EspaÃ±ola, NM",2014,0,0,0,39739,0
21580,"EspaÃ±ola, NM",2015,0,0,0,39364,0
21580,"EspaÃ±ola, NM",2016,0,0,0,39233,0
21580,"EspaÃ±ola, NM",2017,0,0,0,39191,0
21660,"Eugene, OR",1990,884,988,1872,284092,6.58941469664757
21660,"Eugene, OR",1991,923,102,1025,287631,3.56359363211893
21660,"Eugene, OR",1992,994,244,1238,290914,4.25555318753996
21660,"Eugene, OR",1993,1244,234,1478,294985,5.01042425886062
21660,"Eugene, OR",1994,1421,576,1997,298777,6.68391475916821
21660,"Eugene, OR",1995,1136,1633,2769,302893,9.14184216868663
21660,"Eugene, OR",1996,1541,628,2169,306412,7.07870448938031
21660,"Eugene, OR",1997,1296,1299,2595,311170,8.33949288170453
21660,"Eugene, OR",1998,1303,900,2203,313446,7.02832385801701
21660,"Eugene, OR",1999,1161,669,1830,314796,5.81328860595433
21660,"Eugene, OR",2000,1153,177,1330,323492,4.11138451646409
21660,"Eugene, OR",2001,1207,178,1385,324855,4.26344061196534
21660,"Eugene, OR",2002,1400,225,1625,327506,4.9617411589406
21660,"Eugene, OR",2003,1310,224,1534,330845,4.63661231090087
21660,"Eugene, OR",2004,1350,400,1750,332327,5.2658977452930404
21660,"Eugene, OR",2005,1537,819,2356,335831,7.01543335784963
21660,"Eugene, OR",2006,1299,409,1708,339926,5.0246230061837
21660,"Eugene, OR",2007,1045,445,1490,344844,4.32079433018988
21660,"Eugene, OR",2008,607,164,771,348176,2.2143973162998
21660,"Eugene, OR",2009,428,188,616,350850,1.75573606954539
21660,"Eugene, OR",2010,464,86,550,351923,1.56284187165943
21660,"Eugene, OR",2011,351,319,670,354005,1.89262863518877
21660,"Eugene, OR",2012,417,385,802,355081,2.25863957801178
21660,"Eugene, OR",2013,506,743,1249,355506,3.51330216648945
21660,"Eugene, OR",2014,506,810,1316,358076,3.67519744411801
21660,"Eugene, OR",2015,578,143,721,362047,1.99145414821833
21660,"Eugene, OR",2016,736,438,1174,369061,3.18104595175323
21660,"Eugene, OR",2017,821,21,842,375617,2.24164507996177
21660,"Eugene, OR",2018,814,575,1389,379611,3.65900882745758
21700,"Eureka-Arcata-Fortuna, CA",1990,604,271,875,119602,7.31593117171954
21700,"Eureka-Arcata-Fortuna, CA",1991,467,220,687,120646,5.69434544037929
21700,"Eureka-Arcata-Fortuna, CA",1992,488,162,650,121703,5.34087080844351
21700,"Eureka-Arcata-Fortuna, CA",1993,525,153,678,122216,5.54755514826209
21700,"Eureka-Arcata-Fortuna, CA",1994,526,163,689,121476,5.67190226876091
21700,"Eureka-Arcata-Fortuna, CA",1995,471,94,565,122782,4.60165170790507
21700,"Eureka-Arcata-Fortuna, CA",1996,424,95,519,122421,4.2394687186022
21700,"Eureka-Arcata-Fortuna, CA",1997,404,137,541,122728,4.40812202594355
21700,"Eureka-Arcata-Fortuna, CA",1998,403,126,529,122142,4.33102454520149
21700,"Eureka-Arcata-Fortuna, CA",1999,385,112,497,121165,4.10184459208517
21700,"Eureka-Arcata-Fortuna, CA",2000,390,142,532,126462,4.20679729879331
21700,"Eureka-Arcata-Fortuna, CA",2001,381,160,541,127520,4.24247176913425
21700,"Eureka-Arcata-Fortuna, CA",2002,399,134,533,128780,4.13884143500544
21700,"Eureka-Arcata-Fortuna, CA",2003,379,46,425,129754,3.27542888851211
21700,"Eureka-Arcata-Fortuna, CA",2004,499,113,612,130702,4.68240730822788
21700,"Eureka-Arcata-Fortuna, CA",2005,460,50,510,131497,3.87841547715917
21700,"Eureka-Arcata-Fortuna, CA",2006,324,165,489,132093,3.70193727146783
21700,"Eureka-Arcata-Fortuna, CA",2007,302,95,397,132001,3.00755297308354
21700,"Eureka-Arcata-Fortuna, CA",2008,211,120,331,132657,2.49515668227082
21700,"Eureka-Arcata-Fortuna, CA",2009,159,22,181,133744,1.3533317382462
21700,"Eureka-Arcata-Fortuna, CA",2010,167,24,191,135000,1.41481481481481
21700,"Eureka-Arcata-Fortuna, CA",2011,146,117,263,135215,1.94505047516918
21700,"Eureka-Arcata-Fortuna, CA",2012,93,84,177,134560,1.3153983353151
21700,"Eureka-Arcata-Fortuna, CA",2013,113,57,170,134407,1.26481507659571
21700,"Eureka-Arcata-Fortuna, CA",2014,148,86,234,134514,1.73959587849592
21700,"Eureka-Arcata-Fortuna, CA",2015,138,77,215,135114,1.59124887132347
21700,"Eureka-Arcata-Fortuna, CA",2016,152,77,229,136314,1.67994483325264
21700,"Eureka-Arcata-Fortuna, CA",2017,155,138,293,136527,2.14609564408505
21700,"Eureka-Arcata-Fortuna, CA",2018,178,201,379,136373,2.77914249888174
21740,"Evanston, WY",1990,4,0,4,18649,0.214488712531503
21740,"Evanston, WY",1991,24,0,24,19157,1.25280576290651
21740,"Evanston, WY",1992,35,0,35,19578,1.78772091122689
21740,"Evanston, WY",1993,49,0,49,19729,2.48365350499265
21740,"Evanston, WY",1994,70,0,70,20125,3.47826086956522
21740,"Evanston, WY",1995,71,0,71,20128,3.52742448330684
21740,"Evanston, WY",1996,62,0,62,20228,3.06505833498121
21740,"Evanston, WY",1997,60,0,60,20275,2.95930949445129
21740,"Evanston, WY",1998,63,0,63,20419,3.08536167295166
21740,"Evanston, WY",1999,63,0,63,20336,3.09795436664044
21740,"Evanston, WY",2000,72,0,72,19666,3.661141055629
21740,"Evanston, WY",2001,58,0,58,19413,2.98768866223665
21740,"Evanston, WY",2002,58,0,58,19587,2.96114770000511
21740,"Evanston, WY",2003,56,0,56,19480,2.87474332648871
21740,"Evanston, WY",2004,63,0,63,19470,3.23574730354391
21740,"Evanston, WY",2005,95,0,95,19494,4.87329434697856
21740,"Evanston, WY",2006,106,0,106,19709,5.37825358973058
21740,"Evanston, WY",2007,328,0,328,20171,16.2609687174657
21740,"Evanston, WY",2008,71,16,87,20613,4.22063746179595
21740,"Evanston, WY",2009,51,4,55,21054,2.6123301985371
21740,"Evanston, WY",2010,45,0,45,21089,2.13381383659728
21740,"Evanston, WY",2011,34,0,34,20893,1.6273393002441
21740,"Evanston, WY",2012,38,0,38,20994,1.81004096408498
21740,"Evanston, WY",2013,31,4,35,20953,1.67040519257386
21740,"Evanston, WY",2014,34,6,40,20827,1.92058385749268
21740,"Evanston, WY",2015,35,0,35,20770,1.68512277323062
21740,"Evanston, WY",2016,34,12,46,20691,2.22318882605964
21740,"Evanston, WY",2017,42,0,42,20456,2.05318732890106
21740,"Evanston, WY",2018,29,0,29,20299,1.42864180501503
21780,"Evansville, IN-KY",1990,814,353,1167,279257,4.1789462752948
21780,"Evansville, IN-KY",1991,846,37,883,280634,3.14644697363826
21780,"Evansville, IN-KY",1992,1105,76,1181,283023,4.17280574370281
21780,"Evansville, IN-KY",1993,1221,179,1400,285049,4.91143627937653
21780,"Evansville, IN-KY",1994,1104,237,1341,286491,4.68077531231348
21780,"Evansville, IN-KY",1995,1137,261,1398,287249,4.86685767400409
21780,"Evansville, IN-KY",1996,1151,266,1417,288910,4.90464158388425
21780,"Evansville, IN-KY",1997,1228,98,1326,290155,4.56997122227775
21780,"Evansville, IN-KY",1998,1367,414,1781,290282,6.13541314997141
21780,"Evansville, IN-KY",1999,1454,262,1716,290875,5.89944134078212
21780,"Evansville, IN-KY",2000,1168,579,1747,296480,5.89247166756611
21780,"Evansville, IN-KY",2001,1125,41,1166,297027,3.92556905601174
21780,"Evansville, IN-KY",2002,1360,380,1740,298383,5.83143141532862
21780,"Evansville, IN-KY",2003,1525,329,1854,300628,6.16709022446346
21780,"Evansville, IN-KY",2004,1399,551,1950,302310,6.45033244021038
21780,"Evansville, IN-KY",2005,1305,700,2005,303844,6.59878095338397
21780,"Evansville, IN-KY",2006,1147,252,1399,305549,4.57864368726456
21780,"Evansville, IN-KY",2007,818,424,1242,307468,4.03944475522656
21780,"Evansville, IN-KY",2008,519,249,768,308614,2.48854556176972
21780,"Evansville, IN-KY",2009,454,188,642,310170,2.06983267240545
21780,"Evansville, IN-KY",2010,500,97,597,311802,1.91467662170223
21780,"Evansville, IN-KY",2011,461,48,509,312676,1.62788317619517
21780,"Evansville, IN-KY",2012,511,177,688,313431,2.19506047583041
21780,"Evansville, IN-KY",2013,545,196,741,314360,2.35717012342537
21780,"Evansville, IN-KY",2014,568,159,727,314897,2.30869141338279
21780,"Evansville, IN-KY",2015,579,184,763,315001,2.42221453265228
21780,"Evansville, IN-KY",2016,633,314,947,315307,3.00342206167323
21780,"Evansville, IN-KY",2017,618,303,921,314960,2.9241808483617
21780,"Evansville, IN-KY",2018,536,60,596,314672,1.89403569431027
21820,"Fairbanks, AK",1990,20,6,26,78094,0.33293210746024
21820,"Fairbanks, AK",1991,49,52,101,80615,1.25286857284624
21820,"Fairbanks, AK",1992,76,6,82,82757,0.990852737532777
21820,"Fairbanks, AK",1993,93,28,121,83345,1.45179674845522
21820,"Fairbanks, AK",1994,127,59,186,83994,2.2144438888492
21820,"Fairbanks, AK",1995,46,16,62,82527,0.751269281568456
21820,"Fairbanks, AK",1996,117,74,191,83587,2.28504432507447
21820,"Fairbanks, AK",1997,135,19,154,83301,1.8487173023133
21820,"Fairbanks, AK",1998,148,40,188,84242,2.23166591486432
21820,"Fairbanks, AK",1999,166,13,179,84451,2.1195722963612
21820,"Fairbanks, AK",2000,124,0,124,83005,1.49388591048732
21820,"Fairbanks, AK",2001,169,14,183,84814,2.1576626500341902
21820,"Fairbanks, AK",2002,160,10,170,86095,1.97456298275161
21820,"Fairbanks, AK",2003,197,60,257,86885,2.95793289981009
21820,"Fairbanks, AK",2004,208,129,337,89043,3.78468829666566
21820,"Fairbanks, AK",2005,152,30,182,90431,2.01258418020369
21820,"Fairbanks, AK",2006,300,60,360,90545,3.97592357391352
21820,"Fairbanks, AK",2007,88,25,113,93545,1.20797477150035
21820,"Fairbanks, AK",2008,54,6,60,94552,0.634571452745579
21820,"Fairbanks, AK",2009,34,0,34,95238,0.357000357000357
21820,"Fairbanks, AK",2010,42,0,42,98260,0.427437410950539
21820,"Fairbanks, AK",2011,35,4,39,98104,0.397537307347305
21820,"Fairbanks, AK",2012,46,0,46,100305,0.458601266138278
21820,"Fairbanks, AK",2013,56,0,56,100928,0.554850982878884
21820,"Fairbanks, AK",2014,54,0,54,99256,0.544047714999597
21820,"Fairbanks, AK",2015,7,0,7,99630,0.0702599618588779
21820,"Fairbanks, AK",2016,11,0,11,100683,0.109253796569431
21820,"Fairbanks, AK",2017,7,8,15,99725,0.150413637503134
21820,"Fairbanks, AK",2018,13,0,13,98971,0.131351608046802
21840,"Fairfield, IA",1990,7,4,11,16328,0.67368936795688406
21840,"Fairfield, IA",1991,16,4,20,16390,1.2202562538133
21840,"Fairfield, IA",1992,20,18,38,16498,2.30330949205964
21840,"Fairfield, IA",1993,29,2,31,16756,1.85008355216042
21840,"Fairfield, IA",1994,24,2,26,16821,1.54568693894537
21840,"Fairfield, IA",1995,16,10,26,16786,1.54890980579054
21840,"Fairfield, IA",1996,19,0,19,16897,1.1244599633071
21840,"Fairfield, IA",1997,19,36,55,17073,3.22146078603643
21840,"Fairfield, IA",1998,27,34,61,17059,3.57582507767161
21840,"Fairfield, IA",1999,36,96,132,16841,7.83801436969301
21840,"Fairfield, IA",2000,6,12,18,16189,1.11186608190747
21840,"Fairfield, IA",2001,9,76,85,16207,5.24464737459123
21840,"Fairfield, IA",2002,14,0,14,16131,0.867894116917736
21840,"Fairfield, IA",2003,15,0,15,16194,0.926268988514265
21840,"Fairfield, IA",2004,23,0,23,16298,1.41121610013499
21840,"Fairfield, IA",2005,18,21,39,16315,2.39043824701195
21840,"Fairfield, IA",2006,24,3,27,16401,1.6462410828608
21840,"Fairfield, IA",2007,14,9,23,16600,1.3855421686747
21840,"Fairfield, IA",2008,14,0,14,16607,0.843018004455952
21840,"Fairfield, IA",2009,5,2,7,16782,0.417113574067453
21840,"Fairfield, IA",2010,9,0,9,16836,0.534568781183179
21840,"Fairfield, IA",2011,2,0,2,17092,0.1170138076293
21840,"Fairfield, IA",2012,7,0,7,17274,0.405233298599051
21840,"Fairfield, IA",2013,10,0,10,17629,0.567247149583073
21840,"Fairfield, IA",2014,8,6,14,17792,0.786870503597122
21840,"Fairfield, IA",2015,4,10,14,17916,0.781424425094887
21840,"Fairfield, IA",2016,18,0,18,18064,0.996457041629761
21840,"Fairfield, IA",2017,19,3,22,18233,1.20660341139692
21840,"Fairfield, IA",2018,15,69,84,18381,4.56993634731516
21900,"Fairmont, WV",1990,11,3,14,57180,0.244840853445261
21900,"Fairmont, WV",1991,8,0,8,57356,0.139479740567683
21900,"Fairmont, WV",1992,9,0,9,57606,0.156233725653578
21900,"Fairmont, WV",1993,9,0,9,58057,0.155020066486384
21900,"Fairmont, WV",1994,15,0,15,57876,0.259174787476674
21900,"Fairmont, WV",1995,13,4,17,57712,0.294566121430552
21900,"Fairmont, WV",1996,9,0,9,57308,0.157046136665038
21900,"Fairmont, WV",1997,16,0,16,56890,0.281244506943224
21900,"Fairmont, WV",1998,16,0,16,56440,0.283486888731396
21900,"Fairmont, WV",1999,20,0,20,55953,0.357442853823745
21900,"Fairmont, WV",2000,21,0,21,56474,0.37185253390941
21900,"Fairmont, WV",2001,16,0,16,56060,0.285408490902604
21900,"Fairmont, WV",2002,19,0,19,55997,0.33930389127989
21900,"Fairmont, WV",2003,22,0,22,56081,0.392289723792372
21900,"Fairmont, WV",2004,25,0,25,55957,0.446771628214522
21900,"Fairmont, WV",2005,28,0,28,56068,0.499393593493615
21900,"Fairmont, WV",2006,16,0,16,56284,0.284272617440125
21900,"Fairmont, WV",2007,13,0,13,56445,0.230312693772699
21900,"Fairmont, WV",2008,9,0,9,56141,0.160310646408151
21900,"Fairmont, WV",2009,7,0,7,56426,0.12405628610924
21900,"Fairmont, WV",2010,5,0,5,56533,0.088443917711779
21900,"Fairmont, WV",2011,5,0,5,56670,0.0882301041115229
21900,"Fairmont, WV",2012,5,0,5,56745,0.0881134901753459
21900,"Fairmont, WV",2013,9,8,17,56710,0.299770763533768
21900,"Fairmont, WV",2014,8,5,13,56780,0.228953856991899
21900,"Fairmont, WV",2015,17,18,35,56744,0.616805301000987
21900,"Fairmont, WV",2016,18,63,81,56497,1.43370444448378
21900,"Fairmont, WV",2017,20,71,91,56369,1.61436250421331
21900,"Fairmont, WV",2018,10,11,21,56097,0.374351569602653
21980,"Fallon, NV",1990,79,15,94,18029,5.2138221753841
21980,"Fallon, NV",1991,86,65,151,18584,8.12526904864399
21980,"Fallon, NV",1992,124,44,168,18865,8.90538033395176
21980,"Fallon, NV",1993,152,26,178,19577,9.09230219134699
21980,"Fallon, NV",1994,197,30,227,20320,11.1712598425197
21980,"Fallon, NV",1995,150,67,217,20944,10.3609625668449
21980,"Fallon, NV",1996,165,5,170,21648,7.85291943828529
21980,"Fallon, NV",1997,149,4,153,22798,6.71111501008861
21980,"Fallon, NV",1998,163,10,173,23065,7.50054194667245
21980,"Fallon, NV",1999,147,6,153,23361,6.54937716707333
21980,"Fallon, NV",2000,110,7,117,24024,4.87012987012987
21980,"Fallon, NV",2001,68,0,68,24342,2.79352559362419
21980,"Fallon, NV",2002,77,7,84,24155,3.47754088180501
21980,"Fallon, NV",2003,121,0,121,24026,5.03621077166403
21980,"Fallon, NV",2004,239,38,277,24226,11.4339965326509
21980,"Fallon, NV",2005,268,44,312,24593,12.6865368194202
21980,"Fallon, NV",2006,222,37,259,24842,10.425891635134
21980,"Fallon, NV",2007,105,2,107,24961,4.28668723208205
21980,"Fallon, NV",2008,59,3,62,25049,2.47514870853128
21980,"Fallon, NV",2009,15,0,15,25067,0.59839629792157
21980,"Fallon, NV",2010,3,0,3,24819,0.120875135984528
21980,"Fallon, NV",2011,3,0,3,24591,0.121995852141027
21980,"Fallon, NV",2012,8,0,8,24243,0.329992162686136
21980,"Fallon, NV",2013,10,0,10,23923,0.418007774944614
21980,"Fallon, NV",2014,34,4,38,23819,1.5953650447122
21980,"Fallon, NV",2015,24,0,24,23934,1.00275758335422
21980,"Fallon, NV",2016,30,0,30,23869,1.25686036281369
21980,"Fallon, NV",2017,32,0,32,23989,1.33394472466547
21980,"Fallon, NV",2018,73,0,73,24440,2.98690671031097
22020,"Fargo, ND-MN",1990,417,573,990,153691,6.44149624896708
22020,"Fargo, ND-MN",1991,451,932,1383,155221,8.90987688521527
22020,"Fargo, ND-MN",1992,667,843,1510,157605,9.58091431109419
22020,"Fargo, ND-MN",1993,835,1058,1893,159622,11.8592675195149
22020,"Fargo, ND-MN",1994,634,1007,1641,161783,10.1432165307851
22020,"Fargo, ND-MN",1995,716,932,1648,163652,10.070148852443
22020,"Fargo, ND-MN",1996,679,526,1205,164959,7.30484544644427
22020,"Fargo, ND-MN",1997,484,826,1310,166697,7.85856974030726
22020,"Fargo, ND-MN",1998,858,718,1576,168508,9.35267168324352
22020,"Fargo, ND-MN",1999,797,590,1387,170173,8.15052916737673
22020,"Fargo, ND-MN",2000,648,656,1304,174970,7.45270617820198
22020,"Fargo, ND-MN",2001,818,711,1529,177033,8.63680782678936
22020,"Fargo, ND-MN",2002,1063,1097,2160,178891,12.0743916686697
22020,"Fargo, ND-MN",2003,1411,855,2266,181539,12.4821663664557
22020,"Fargo, ND-MN",2004,1636,1185,2821,186448,15.1302239766584
22020,"Fargo, ND-MN",2005,1465,1255,2720,189303,14.3684991785656
22020,"Fargo, ND-MN",2006,1283,644,1927,193412,9.96318739271607
22020,"Fargo, ND-MN",2007,1109,694,1803,197121,9.14666626082457
22020,"Fargo, ND-MN",2008,864,442,1306,201346,6.48634688546085
22020,"Fargo, ND-MN",2009,803,875,1678,206223,8.13682275982795
22020,"Fargo, ND-MN",2010,760,558,1318,209450,6.29267128192886
22020,"Fargo, ND-MN",2011,609,927,1536,213197,7.20460419236668
22020,"Fargo, ND-MN",2012,1037,1174,2211,217592,10.1612191624692
22020,"Fargo, ND-MN",2013,1395,1698,3093,223354,13.8479722771923
22020,"Fargo, ND-MN",2014,1242,2524,3766,227791,16.5326988335799
22020,"Fargo, ND-MN",2015,1359,1360,2719,232880,11.6755410511852
22020,"Fargo, ND-MN",2016,1192,1287,2479,237254,10.4487174083472
22020,"Fargo, ND-MN",2017,1065,826,1891,241619,7.82637127047128
22020,"Fargo, ND-MN",2018,1080,1233,2313,245471,9.42270166333294
22060,"Faribault-Northfield, MN",1990,224,30,254,49318,5.15024940184111
22060,"Faribault-Northfield, MN",1991,191,131,322,49910,6.45161290322581
22060,"Faribault-Northfield, MN",1992,229,98,327,50468,6.4793532535468
22060,"Faribault-Northfield, MN",1993,233,46,279,51002,5.47037371083487
22060,"Faribault-Northfield, MN",1994,263,42,305,51567,5.91463532879555
22060,"Faribault-Northfield, MN",1995,268,8,276,52097,5.29780985469413
22060,"Faribault-Northfield, MN",1996,251,98,349,52763,6.61448363436499
22060,"Faribault-Northfield, MN",1997,272,37,309,53567,5.76847686075382
22060,"Faribault-Northfield, MN",1998,302,110,412,54185,7.60358032665867
22060,"Faribault-Northfield, MN",1999,297,16,313,54928,5.69836877366735
22060,"Faribault-Northfield, MN",2000,363,64,427,56811,7.51615004136523
22060,"Faribault-Northfield, MN",2001,418,29,447,57731,7.74280715733315
22060,"Faribault-Northfield, MN",2002,593,86,679,58452,11.6163689865189
22060,"Faribault-Northfield, MN",2003,513,54,567,59395,9.54625810253388
22060,"Faribault-Northfield, MN",2004,579,86,665,60146,11.0564293552356
22060,"Faribault-Northfield, MN",2005,504,96,600,60832,9.86322987901105
22060,"Faribault-Northfield, MN",2006,412,115,527,61899,8.51386936784116
22060,"Faribault-Northfield, MN",2007,196,30,226,62387,3.62254956962188
22060,"Faribault-Northfield, MN",2008,77,0,77,63061,1.22103994544964
22060,"Faribault-Northfield, MN",2009,89,45,134,63859,2.09837297796708
22060,"Faribault-Northfield, MN",2010,61,24,85,64242,1.32312194514492
22060,"Faribault-Northfield, MN",2011,54,0,54,64454,0.837806807956062
22060,"Faribault-Northfield, MN",2012,57,0,57,64436,0.884598671550065
22060,"Faribault-Northfield, MN",2013,71,65,136,64642,2.10389530026917
22060,"Faribault-Northfield, MN",2014,105,8,113,64997,1.73854177885133
22060,"Faribault-Northfield, MN",2015,127,10,137,65307,2.09778431102332
22060,"Faribault-Northfield, MN",2016,147,10,157,65825,2.38511203949867
22060,"Faribault-Northfield, MN",2017,166,6,172,66173,2.5992474271984
22060,"Faribault-Northfield, MN",2018,179,8,187,66523,2.81105782962284
22100,"Farmington, MO",1990,58,78,136,49026,2.77403826541019
22100,"Farmington, MO",1991,146,30,176,49593,3.54888794789587
22100,"Farmington, MO",1992,165,117,282,50047,5.63470337882391
22100,"Farmington, MO",1993,181,5,186,51075,3.6417033773862
22100,"Farmington, MO",1994,171,50,221,52057,4.24534644716369
22100,"Farmington, MO",1995,187,30,217,53119,4.08516726595004
22100,"Farmington, MO",1996,177,200,377,53946,6.98846995143291
22100,"Farmington, MO",1997,137,85,222,54649,4.062288422478
22100,"Farmington, MO",1998,174,85,259,55381,4.67669417309185
22100,"Farmington, MO",1999,164,88,252,55889,4.50893735797742
22100,"Farmington, MO",2000,122,118,240,55773,4.3031574417729
22100,"Farmington, MO",2001,154,46,200,56242,3.55606130649692
22100,"Farmington, MO",2002,159,97,256,56823,4.5052179575172
22100,"Farmington, MO",2003,213,152,365,58118,6.28032623283664
22100,"Farmington, MO",2004,208,118,326,60829,5.35928586693847
22100,"Farmington, MO",2005,186,144,330,62298,5.29712029278629
22100,"Farmington, MO",2006,160,226,386,62917,6.135066834083
22100,"Farmington, MO",2007,144,24,168,63636,2.64001508580049
22100,"Farmington, MO",2008,90,92,182,64280,2.83136278780336
22100,"Farmington, MO",2009,101,225,326,64864,5.02590034533794
22100,"Farmington, MO",2010,65,287,352,65529,5.37166750598971
22100,"Farmington, MO",2011,49,282,331,65574,5.04773233293683
22100,"Farmington, MO",2012,51,301,352,65799,5.34962537424581
22100,"Farmington, MO",2013,57,64,121,66102,1.8305043720311
22100,"Farmington, MO",2014,57,73,130,65785,1.97613437713765
22100,"Farmington, MO",2015,68,122,190,66228,2.86887721205532
22100,"Farmington, MO",2016,81,154,235,66350,3.54182366239638
22100,"Farmington, MO",2017,84,205,289,66653,4.33588885721573
22100,"Farmington, MO",2018,75,106,181,66692,2.71396869189708
22140,"Farmington, NM",1990,95,0,95,91504,1.03820598006645
22140,"Farmington, NM",1991,128,4,132,93432,1.41279219111225
22140,"Farmington, NM",1992,172,2,174,94643,1.83848779096182
22140,"Farmington, NM",1993,229,2,231,96947,2.38274521130102
22140,"Farmington, NM",1994,283,2,285,98940,2.88053365676167
22140,"Farmington, NM",1995,213,109,322,99934,3.22212660355835
22140,"Farmington, NM",1996,240,6,246,102138,2.40850613875345
22140,"Farmington, NM",1997,187,0,187,103418,1.80819586532325
22140,"Farmington, NM",1998,189,60,249,106131,2.34615710772536
22140,"Farmington, NM",1999,170,6,176,109751,1.60363003526164
22140,"Farmington, NM",2000,169,3,172,114131,1.50704015561066
22140,"Farmington, NM",2001,170,0,170,115745,1.46874595014903
22140,"Farmington, NM",2002,280,0,280,119430,2.3444695637612
22140,"Farmington, NM",2003,305,62,367,121553,3.01925908862801
22140,"Farmington, NM",2004,340,11,351,123179,2.84951168624522
22140,"Farmington, NM",2005,429,10,439,124809,3.51737454830982
22140,"Farmington, NM",2006,435,8,443,125028,3.54320632178392
22140,"Farmington, NM",2007,371,0,371,126149,2.94096663469389
22140,"Farmington, NM",2008,289,27,316,126905,2.49005161341161
22140,"Farmington, NM",2009,208,26,234,129359,1.80891936394066
22140,"Farmington, NM",2010,201,72,273,130202,2.09674198553018
22140,"Farmington, NM",2011,153,60,213,129694,1.64232732431724
22140,"Farmington, NM",2012,176,0,176,129748,1.35647562968215
22140,"Farmington, NM",2013,155,0,155,129468,1.19720703185343
22140,"Farmington, NM",2014,173,0,173,129094,1.34010875795932
22140,"Farmington, NM",2015,118,0,118,128261,0.919999064407731
22140,"Farmington, NM",2016,102,2,104,127973,0.812671422878263
22140,"Farmington, NM",2017,91,0,91,126902,0.717088777166633
22140,"Farmington, NM",2018,67,4,71,125043,0.567804675191734
22180,"Fayetteville, NC",1990,1076,200,1276,298332,4.27711408766073
22180,"Fayetteville, NC",1991,1639,266,1905,300670,6.33584993514484
22180,"Fayetteville, NC",1992,2652,507,3159,301042,10.4935523946825
22180,"Fayetteville, NC",1993,2885,914,3799,308778,12.3033376730207
22180,"Fayetteville, NC",1994,2106,353,2459,310606,7.91678203254284
22180,"Fayetteville, NC",1995,1918,222,2140,312475,6.84854788383071
22180,"Fayetteville, NC",1996,1572,336,1908,312844,6.09888634591042
22180,"Fayetteville, NC",1997,1360,556,1916,315560,6.07174546837368
22180,"Fayetteville, NC",1998,1611,937,2548,315039,8.087887531385
22180,"Fayetteville, NC",1999,1126,199,1325,316340,4.18853132705317
22180,"Fayetteville, NC",2000,1075,730,1805,337678,5.34532898204799
22180,"Fayetteville, NC",2001,1281,333,1614,339038,4.76052831835959
22180,"Fayetteville, NC",2002,1869,967,2836,341482,8.30497654341957
22180,"Fayetteville, NC",2003,1855,412,2267,339823,6.67111996539375
22180,"Fayetteville, NC",2004,2321,1207,3528,345748,10.2039635804112
22180,"Fayetteville, NC",2005,2935,1390,4325,343493,12.5912318446082
22180,"Fayetteville, NC",2006,3187,928,4115,348725,11.8001290415084
22180,"Fayetteville, NC",2007,2083,581,2664,350780,7.59450367751867
22180,"Fayetteville, NC",2008,1464,842,2306,355712,6.48277258006477
22180,"Fayetteville, NC",2009,1798,866,2664,362658,7.34576377744321
22180,"Fayetteville, NC",2010,1610,1999,3609,374691,9.63193671585386
22180,"Fayetteville, NC",2011,1465,1342,2807,379931,7.38818364387218
22180,"Fayetteville, NC",2012,1376,1664,3040,380443,7.99068454407099
22180,"Fayetteville, NC",2013,1269,621,1890,384140,4.9200812203884
22180,"Fayetteville, NC",2014,1012,77,1089,383971,2.83615168853898
22180,"Fayetteville, NC",2015,889,497,1386,384006,3.60931860439681
22180,"Fayetteville, NC",2016,833,120,953,386273,2.46716700364768
22180,"Fayetteville, NC",2017,874,61,935,385380,2.42617676059993
22180,"Fayetteville, NC",2018,803,16,819,387094,2.11576516298367
22220,"Fayetteville-Springdale-Rogers, AR-MO",1990,1033,335,1368,241068,5.67474737418488
22220,"Fayetteville-Springdale-Rogers, AR-MO",1991,1243,994,2237,248543,9.00045464969844
22220,"Fayetteville-Springdale-Rogers, AR-MO",1992,1557,1071,2628,256189,10.2580516727884
22220,"Fayetteville-Springdale-Rogers, AR-MO",1993,1813,1682,3495,267095,13.0852318463468
22220,"Fayetteville-Springdale-Rogers, AR-MO",1994,1938,2420,4358,277419,15.7090898604638
22220,"Fayetteville-Springdale-Rogers, AR-MO",1995,2015,1825,3840,289133,13.2810851753345
22220,"Fayetteville-Springdale-Rogers, AR-MO",1996,2256,821,3077,299008,10.2906945633562
22220,"Fayetteville-Springdale-Rogers, AR-MO",1997,1921,799,2720,306143,8.88473687133137
22220,"Fayetteville-Springdale-Rogers, AR-MO",1998,1839,297,2136,311424,6.85881627620222
22220,"Fayetteville-Springdale-Rogers, AR-MO",1999,2120,803,2923,318112,9.1885876672367
22220,"Fayetteville-Springdale-Rogers, AR-MO",2000,2011,843,2854,349532,8.16520375816807
22220,"Fayetteville-Springdale-Rogers, AR-MO",2001,2499,1480,3979,358350,11.1036695967629
22220,"Fayetteville-Springdale-Rogers, AR-MO",2002,2409,1592,4001,367634,10.8831065679453
22220,"Fayetteville-Springdale-Rogers, AR-MO",2003,3328,2959,6287,379457,16.5684122311619
22220,"Fayetteville-Springdale-Rogers, AR-MO",2004,3806,2608,6414,392694,16.3333282403092
22220,"Fayetteville-Springdale-Rogers, AR-MO",2005,5264,2329,7593,407987,18.6108871115991
22220,"Fayetteville-Springdale-Rogers, AR-MO",2006,4029,2064,6093,424016,14.3697407644995
22220,"Fayetteville-Springdale-Rogers, AR-MO",2007,2259,1114,3373,436539,7.72668650452766
22220,"Fayetteville-Springdale-Rogers, AR-MO",2008,1221,1545,2766,446592,6.19357265692175
22220,"Fayetteville-Springdale-Rogers, AR-MO",2009,1067,684,1751,455143,3.84714254640849
22220,"Fayetteville-Springdale-Rogers, AR-MO",2010,1081,140,1221,465374,2.62369620993008
22220,"Fayetteville-Springdale-Rogers, AR-MO",2011,1158,48,1206,475749,2.53495015228618
22220,"Fayetteville-Springdale-Rogers, AR-MO",2012,1763,160,1923,485274,3.96270972687595
22220,"Fayetteville-Springdale-Rogers, AR-MO",2013,2252,133,2385,493819,4.829704810872
22220,"Fayetteville-Springdale-Rogers, AR-MO",2014,2388,965,3353,503423,6.66040288187071
22220,"Fayetteville-Springdale-Rogers, AR-MO",2015,2817,976,3793,514579,7.37107421795293
22220,"Fayetteville-Springdale-Rogers, AR-MO",2016,3508,913,4421,526522,8.39661020812046
22220,"Fayetteville-Springdale-Rogers, AR-MO",2017,3528,1201,4729,538412,8.78323662919846
22220,"Fayetteville-Springdale-Rogers, AR-MO",2018,3836,1734,5570,549128,10.1433545548579
22260,"Fergus Falls, MN",1990,84,34,118,50722,2.32640668743346
22260,"Fergus Falls, MN",1991,83,27,110,51153,2.15041151056634
22260,"Fergus Falls, MN",1992,76,32,108,51543,2.0953378732320602
22260,"Fergus Falls, MN",1993,103,18,121,51955,2.32893850447503
22260,"Fergus Falls, MN",1994,121,51,172,52407,3.28200431240102
22260,"Fergus Falls, MN",1995,124,92,216,52933,4.08063023066896
22260,"Fergus Falls, MN",1996,122,60,182,53847,3.37994688654893
22260,"Fergus Falls, MN",1997,86,48,134,54347,2.46563747768966
22260,"Fergus Falls, MN",1998,107,28,135,54820,2.46260488872674
22260,"Fergus Falls, MN",1999,110,73,183,55650,3.28840970350404
22260,"Fergus Falls, MN",2000,112,15,127,57073,2.22522033185569
22260,"Fergus Falls, MN",2001,103,41,144,57076,2.52295185366879
22260,"Fergus Falls, MN",2002,137,8,145,57245,2.53297231199231
22260,"Fergus Falls, MN",2003,139,64,203,57515,3.5295140398157
22260,"Fergus Falls, MN",2004,158,59,217,57576,3.76893149923579
22260,"Fergus Falls, MN",2005,124,70,194,57420,3.37861372344131
22260,"Fergus Falls, MN",2006,119,24,143,57732,2.47696251645535
22260,"Fergus Falls, MN",2007,70,0,70,57677,1.21365535655461
22260,"Fergus Falls, MN",2008,46,30,76,57691,1.31736319356572
22260,"Fergus Falls, MN",2009,40,0,40,57333,0.697678474874854
22260,"Fergus Falls, MN",2010,36,0,36,57294,0.628338045868677
22260,"Fergus Falls, MN",2011,34,81,115,57278,2.00775166730682
22260,"Fergus Falls, MN",2012,51,64,115,57221,2.00975166459866
22260,"Fergus Falls, MN",2013,54,64,118,57498,2.05224529548854
22260,"Fergus Falls, MN",2014,27,44,71,57488,1.23504035624826
22260,"Fergus Falls, MN",2015,62,49,111,57544,1.92895870985681
22260,"Fergus Falls, MN",2016,85,112,197,57865,3.4044759353668
22260,"Fergus Falls, MN",2017,91,55,146,58251,2.50639474000446
22260,"Fergus Falls, MN",2018,80,47,127,58812,2.1594232469564
22280,"Fernley, NV",1990,72,4,76,20239,3.75512624141509
22280,"Fernley, NV",1991,79,4,83,21341,3.88922730893585
22280,"Fernley, NV",1992,160,2,162,22096,7.33164373642288
22280,"Fernley, NV",1993,165,8,173,23149,7.47332498164068
22280,"Fernley, NV",1994,193,2,195,24312,8.02073050345508
22280,"Fernley, NV",1995,151,23,174,25803,6.74340193000814
22280,"Fernley, NV",1996,190,26,216,27264,7.92253521126761
22280,"Fernley, NV",1997,169,32,201,28821,6.97408139897991
22280,"Fernley, NV",1998,170,78,248,30138,8.22881412170682
22280,"Fernley, NV",1999,169,31,200,31521,6.34497636496304
22280,"Fernley, NV",2000,172,55,227,34809,6.52130196213623
22280,"Fernley, NV",2001,169,59,228,36012,6.33122292569144
22280,"Fernley, NV",2002,538,0,538,37573,14.3187927501131
22280,"Fernley, NV",2003,465,22,487,39646,12.2837108409423
22280,"Fernley, NV",2004,872,59,931,42534,21.8883716556167
22280,"Fernley, NV",2005,681,52,733,46228,15.8561910530414
22280,"Fernley, NV",2006,562,62,624,49827,12.5233307243061
22280,"Fernley, NV",2007,357,0,357,51725,6.90188496858386
22280,"Fernley, NV",2008,72,29,101,52156,1.93649819771455
22280,"Fernley, NV",2009,39,0,39,51819,0.752619695478492
22280,"Fernley, NV",2010,53,0,53,52043,1.01838864016294
22280,"Fernley, NV",2011,48,0,48,51380,0.934215648112106
22280,"Fernley, NV",2012,52,0,52,50969,1.02022798171438
22280,"Fernley, NV",2013,105,0,105,51094,2.05503581633851
22280,"Fernley, NV",2014,140,0,140,51339,2.72697169792945
22280,"Fernley, NV",2015,179,0,179,51986,3.4432347170392
22280,"Fernley, NV",2016,224,0,224,52726,4.24837840913401
22280,"Fernley, NV",2017,346,0,346,53915,6.41750904201057
22280,"Fernley, NV",2018,331,0,331,55808,5.93104931192661
22300,"Findlay, OH",1990,142,57,199,65551,3.03580418300255
22300,"Findlay, OH",1991,139,15,154,66114,2.32930997973198
22300,"Findlay, OH",1992,163,52,215,66775,3.21976787719955
22300,"Findlay, OH",1993,208,40,248,67206,3.69014671309109
22300,"Findlay, OH",1994,189,20,209,67726,3.08596403153885
22300,"Findlay, OH",1995,219,35,254,68223,3.72308459024083
22300,"Findlay, OH",1996,215,33,248,68480,3.6214953271028
22300,"Findlay, OH",1997,202,54,256,68602,3.73166963062301
22300,"Findlay, OH",1998,221,35,256,68994,3.71046757689074
22300,"Findlay, OH",1999,232,43,275,69342,3.96585042254334
22300,"Findlay, OH",2000,243,62,305,71321,4.2764403191206
22300,"Findlay, OH",2001,198,58,256,71972,3.55693880953704
22300,"Findlay, OH",2002,255,34,289,72617,3.97978434801768
22300,"Findlay, OH",2003,199,22,221,73118,3.02251155666183
22300,"Findlay, OH",2004,989,2,991,73532,13.4771256051787
22300,"Findlay, OH",2005,981,0,981,73585,13.3315213698444
22300,"Findlay, OH",2006,828,33,861,74167,11.608936589049
22300,"Findlay, OH",2007,638,19,657,74712,8.79376806938644
22300,"Findlay, OH",2008,440,8,448,74781,5.99082654685014
22300,"Findlay, OH",2009,75,0,75,74964,1.00048023051065
22300,"Findlay, OH",2010,83,3,86,74690,1.15142589369393
22300,"Findlay, OH",2011,78,0,78,74904,1.04133290611983
22300,"Findlay, OH",2012,87,0,87,75454,1.15302038327988
22300,"Findlay, OH",2013,94,0,94,75576,1.24378109452736
22300,"Findlay, OH",2014,90,2,92,75275,1.22218532049153
22300,"Findlay, OH",2015,93,6,99,75635,1.3089178290474
22300,"Findlay, OH",2016,91,112,203,75742,2.68015103905363
22300,"Findlay, OH",2017,102,2,104,75869,1.37078385111178
22300,"Findlay, OH",2018,110,16,126,75930,1.65942315290399
22340,"Fitzgerald, GA",1990,35,0,35,16215,2.15849522047487
22340,"Fitzgerald, GA",1991,33,2,35,16565,2.11288862058557
22340,"Fitzgerald, GA",1992,42,0,42,16625,2.52631578947368
22340,"Fitzgerald, GA",1993,39,8,47,16755,2.80513279618024
22340,"Fitzgerald, GA",1994,71,93,164,17066,9.60975038087425
22340,"Fitzgerald, GA",1995,31,6,37,17301,2.13860470493035
22340,"Fitzgerald, GA",1996,41,13,54,17320,3.11778290993072
22340,"Fitzgerald, GA",1997,39,6,45,17368,2.59097190234915
22340,"Fitzgerald, GA",1998,60,4,64,17423,3.67330540090685
22340,"Fitzgerald, GA",1999,46,0,46,17432,2.63882514915099
22340,"Fitzgerald, GA",2000,27,2,29,17483,1.65875421838357
22340,"Fitzgerald, GA",2001,29,4,33,17315,1.9058619693907
22340,"Fitzgerald, GA",2002,44,6,50,17178,2.91069973221562
22340,"Fitzgerald, GA",2003,68,2,70,17095,4.09476455103832
22340,"Fitzgerald, GA",2004,74,12,86,17106,5.02747573950661
22340,"Fitzgerald, GA",2005,74,4,78,17243,4.52357478397031
22340,"Fitzgerald, GA",2006,39,2,41,17525,2.339514978602
22340,"Fitzgerald, GA",2007,46,48,94,17719,5.30503978779841
22340,"Fitzgerald, GA",2008,30,0,30,17675,1.6973125884017
22340,"Fitzgerald, GA",2009,28,0,28,17581,1.59262840566521
22340,"Fitzgerald, GA",2010,36,0,36,17623,2.04278499687908
22340,"Fitzgerald, GA",2011,16,0,16,17566,0.910850506660594
22340,"Fitzgerald, GA",2012,15,0,15,17580,0.853242320819113
22340,"Fitzgerald, GA",2013,6,0,6,17429,0.344253829823857
22340,"Fitzgerald, GA",2014,11,0,11,17430,0.631095811818703
22340,"Fitzgerald, GA",2015,9,0,9,17334,0.519210799584631
22340,"Fitzgerald, GA",2016,7,0,7,17216,0.406598513011152
22340,"Fitzgerald, GA",2017,7,50,57,17001,3.35274395623787
22340,"Fitzgerald, GA",2018,12,46,58,16787,3.45505450646333
22380,"Flagstaff, AZ",1990,410,181,591,97084,6.08751184541222
22380,"Flagstaff, AZ",1991,406,240,646,99535,6.49017933390265
22380,"Flagstaff, AZ",1992,558,53,611,102290,5.97321341284583
22380,"Flagstaff, AZ",1993,581,167,748,105262,7.10607816685984
22380,"Flagstaff, AZ",1994,675,52,727,108267,6.71488080393841
22380,"Flagstaff, AZ",1995,645,687,1332,110434,12.0615027980513
22380,"Flagstaff, AZ",1996,644,715,1359,112059,12.12753995663
22380,"Flagstaff, AZ",1997,589,127,716,113708,6.29683047806663
22380,"Flagstaff, AZ",1998,567,153,720,114037,6.31374027727843
22380,"Flagstaff, AZ",1999,672,277,949,114368,8.29777560156687
22380,"Flagstaff, AZ",2000,581,102,683,116773,5.84895480975911
22380,"Flagstaff, AZ",2001,851,26,877,118283,7.41442134541735
22380,"Flagstaff, AZ",2002,827,38,865,121308,7.130609687737
22380,"Flagstaff, AZ",2003,847,342,1189,122882,9.67594928467961
22380,"Flagstaff, AZ",2004,893,17,910,125117,7.27319229201467
22380,"Flagstaff, AZ",2005,800,280,1080,127025,8.50226333398937
22380,"Flagstaff, AZ",2006,820,260,1080,128695,8.39193441858658
22380,"Flagstaff, AZ",2007,471,6,477,130442,3.6567976571963
22380,"Flagstaff, AZ",2008,277,6,283,131853,2.14632962465776
22380,"Flagstaff, AZ",2009,128,354,482,133477,3.61110903002015
22380,"Flagstaff, AZ",2010,186,129,315,134618,2.33995453802612
22380,"Flagstaff, AZ",2011,98,2,100,134269,0.744773551601635
22380,"Flagstaff, AZ",2012,206,612,818,136152,6.00799106880545
22380,"Flagstaff, AZ",2013,294,65,359,136713,2.62593901092069
22380,"Flagstaff, AZ",2014,290,270,560,137583,4.07027030955859
22380,"Flagstaff, AZ",2015,333,233,566,139024,4.07123949821614
22380,"Flagstaff, AZ",2016,401,246,647,140515,4.60449062377682
22380,"Flagstaff, AZ",2017,434,263,697,141107,4.93951398584053
22380,"Flagstaff, AZ",2018,657,8,665,142854,4.65510241225307
22420,"Flint, MI",1990,845,436,1281,431017,2.97204054596454
22420,"Flint, MI",1991,776,61,837,431577,1.93939899484912
22420,"Flint, MI",1992,895,240,1135,431646,2.629469519004
22420,"Flint, MI",1993,1022,201,1223,431720,2.83285462799963
22420,"Flint, MI",1994,1439,280,1719,432079,3.97843912802983
22420,"Flint, MI",1995,1515,397,1912,433923,4.40631171889944
22420,"Flint, MI",1996,1646,474,2120,435290,4.87031634083025
22420,"Flint, MI",1997,1437,517,1954,435293,4.48893044455114
22420,"Flint, MI",1998,1638,308,1946,435807,4.46527935531095
22420,"Flint, MI",1999,1903,903,2806,437396,6.41523927973735
22420,"Flint, MI",2000,1746,578,2324,436965,5.31850377032485
22420,"Flint, MI",2001,1864,1589,3453,438584,7.87306422486912
22420,"Flint, MI",2002,1900,503,2403,440062,5.46059418900064
22420,"Flint, MI",2003,2029,211,2240,441689,5.07144167049666
22420,"Flint, MI",2004,2158,240,2398,442534,5.41879268033643
22420,"Flint, MI",2005,1756,98,1854,442508,4.18975476149584
22420,"Flint, MI",2006,777,203,980,441164,2.22139612479713
22420,"Flint, MI",2007,434,42,476,438109,1.08648760924793
22420,"Flint, MI",2008,146,73,219,433082,0.505677908571587
22420,"Flint, MI",2009,83,66,149,427989,0.348139788639428
22420,"Flint, MI",2010,78,0,78,424951,0.183550574066186
22420,"Flint, MI",2011,66,0,66,421976,0.156406999450206
22420,"Flint, MI",2012,122,0,122,418167,0.291749468513776
22420,"Flint, MI",2013,227,0,227,415634,0.546153587050145
22420,"Flint, MI",2014,271,72,343,412868,0.83077400040691
22420,"Flint, MI",2015,345,68,413,410470,1.00616366604137
22420,"Flint, MI",2016,322,52,374,408901,0.914646821602295
22420,"Flint, MI",2017,404,30,434,407673,1.064578718728
22420,"Flint, MI",2018,435,195,630,406892,1.5483224049625
22500,"Florence, SC",1990,662,271,933,176688,5.28049443086118
22500,"Florence, SC",1991,666,208,874,179425,4.8711160652083
22500,"Florence, SC",1992,669,64,733,181872,4.03030702911938
22500,"Florence, SC",1993,654,173,827,183936,4.49612908837857
22500,"Florence, SC",1994,670,223,893,185418,4.81614514232707
22500,"Florence, SC",1995,669,62,731,187374,3.90128833242606
22500,"Florence, SC",1996,773,141,914,188446,4.85019581206287
22500,"Florence, SC",1997,757,189,946,190114,4.97596179134624
22500,"Florence, SC",1998,691,172,863,191042,4.51733126746998
22500,"Florence, SC",1999,721,112,833,191928,4.34016923012797
22500,"Florence, SC",2000,685,129,814,193290,4.21128873713074
22500,"Florence, SC",2001,226,6,232,194240,1.19439868204283
22500,"Florence, SC",2002,659,42,701,195590,3.58402781328289
22500,"Florence, SC",2003,251,0,251,197053,1.27376898600884
22500,"Florence, SC",2004,405,2,407,198010,2.05545174486137
22500,"Florence, SC",2005,906,0,906,199167,4.54894636159605
22500,"Florence, SC",2006,902,0,902,200913,4.48950540781333
22500,"Florence, SC",2007,777,272,1049,202246,5.18675276643296
22500,"Florence, SC",2008,430,143,573,203805,2.81151100316479
22500,"Florence, SC",2009,301,48,349,204825,1.70389356767973
22500,"Florence, SC",2010,353,123,476,205661,2.3144884056773
22500,"Florence, SC",2011,332,57,389,205790,1.89027649545653
22500,"Florence, SC",2012,285,28,313,206051,1.51904140237126
22500,"Florence, SC",2013,362,50,412,205995,2.00004854486759
22500,"Florence, SC",2014,331,48,379,206445,1.83584005425174
22500,"Florence, SC",2015,418,6,424,206259,2.05566787388672
22500,"Florence, SC",2016,432,63,495,205859,2.40455845991674
22500,"Florence, SC",2017,511,510,1021,205546,4.96725793739601
22500,"Florence, SC",2018,521,41,562,204961,2.7419850605725
22520,"Florence-Muscle Shoals, AL",1990,197,169,366,131696,2.77912768800875
22520,"Florence-Muscle Shoals, AL",1991,203,77,280,133014,2.1050415745711
22520,"Florence-Muscle Shoals, AL",1992,292,259,551,133867,4.11602560750596
22520,"Florence-Muscle Shoals, AL",1993,270,210,480,135063,3.5538970702561
22520,"Florence-Muscle Shoals, AL",1994,336,275,611,135284,4.51642470654327
22520,"Florence-Muscle Shoals, AL",1995,313,109,422,135853,3.10629871993994
22520,"Florence-Muscle Shoals, AL",1996,302,179,481,136591,3.52146188255449
22520,"Florence-Muscle Shoals, AL",1997,251,91,342,136995,2.49644147596628
22520,"Florence-Muscle Shoals, AL",1998,256,87,343,137088,2.50204248366013
22520,"Florence-Muscle Shoals, AL",1999,261,52,313,136758,2.28871437137133
22520,"Florence-Muscle Shoals, AL",2000,220,104,324,143036,2.26516401465365
22520,"Florence-Muscle Shoals, AL",2001,180,69,249,142584,1.74633900016832
22520,"Florence-Muscle Shoals, AL",2002,213,113,326,142163,2.29314237881868
22520,"Florence-Muscle Shoals, AL",2003,241,201,442,142382,3.10432498489978
22520,"Florence-Muscle Shoals, AL",2004,279,26,305,143112,2.13119794286992
22520,"Florence-Muscle Shoals, AL",2005,277,49,326,143717,2.26834682048749
22520,"Florence-Muscle Shoals, AL",2006,367,8,375,144707,2.5914433994209
22520,"Florence-Muscle Shoals, AL",2007,310,138,448,145593,3.07707101302947
22520,"Florence-Muscle Shoals, AL",2008,252,93,345,146675,2.35213908300665
22520,"Florence-Muscle Shoals, AL",2009,133,48,181,146952,1.23169470303228
22520,"Florence-Muscle Shoals, AL",2010,155,77,232,147261,1.57543409320866
22520,"Florence-Muscle Shoals, AL",2011,137,103,240,147141,1.63108854771953
22520,"Florence-Muscle Shoals, AL",2012,162,294,456,147236,3.09706865168845
22520,"Florence-Muscle Shoals, AL",2013,208,125,333,147239,2.26162905208539
22520,"Florence-Muscle Shoals, AL",2014,174,23,197,147481,1.33576528501977
22520,"Florence-Muscle Shoals, AL",2015,206,132,338,146847,2.30171539084898
22520,"Florence-Muscle Shoals, AL",2016,237,78,315,146824,2.1454258159429
22520,"Florence-Muscle Shoals, AL",2017,257,518,775,147100,5.26852481305235
22520,"Florence-Muscle Shoals, AL",2018,254,81,335,147149,2.27660398643552
22540,"Fond du Lac, WI",1990,193,204,397,90242,4.39928193080827
22540,"Fond du Lac, WI",1991,252,88,340,90991,3.73663329340264
22540,"Fond du Lac, WI",1992,340,176,516,91552,5.63614120936735
22540,"Fond du Lac, WI",1993,348,168,516,92153,5.59938363373954
22540,"Fond du Lac, WI",1994,365,216,581,92765,6.26313803697515
22540,"Fond du Lac, WI",1995,376,136,512,93326,5.486145339991
22540,"Fond du Lac, WI",1996,414,205,619,94108,6.57754919879288
22540,"Fond du Lac, WI",1997,325,244,569,94345,6.0310562297949
22540,"Fond du Lac, WI",1998,354,98,452,94626,4.77669984993554
22540,"Fond du Lac, WI",1999,338,132,470,94864,4.95446112329229
22540,"Fond du Lac, WI",2000,347,68,415,97390,4.26121778416675
22540,"Fond du Lac, WI",2001,328,237,565,97856,5.773790058862
22540,"Fond du Lac, WI",2002,370,159,529,98097,5.39262158883554
22540,"Fond du Lac, WI",2003,398,86,484,98470,4.91520259977658
22540,"Fond du Lac, WI",2004,378,126,504,98929,5.09456276723711
22540,"Fond du Lac, WI",2005,398,220,618,99297,6.22375298347382
22540,"Fond du Lac, WI",2006,306,136,442,99920,4.42353883106485
22540,"Fond du Lac, WI",2007,243,30,273,100520,2.71587743732591
22540,"Fond du Lac, WI",2008,149,161,310,101122,3.06560392397302
22540,"Fond du Lac, WI",2009,118,86,204,101370,2.01242971293282
22540,"Fond du Lac, WI",2010,113,116,229,101581,2.25435859068133
22540,"Fond du Lac, WI",2011,86,151,237,101811,2.32784276748092
22540,"Fond du Lac, WI",2012,83,166,249,101785,2.4463329567225
22540,"Fond du Lac, WI",2013,114,144,258,101792,2.53458032065388
22540,"Fond du Lac, WI",2014,106,134,240,101986,2.35326417351401
22540,"Fond du Lac, WI",2015,140,55,195,101951,1.91268354405548
22540,"Fond du Lac, WI",2016,152,213,365,102201,3.57139362628546
22540,"Fond du Lac, WI",2017,185,0,185,102371,1.80715241621162
22540,"Fond du Lac, WI",2018,149,126,275,103066,2.66819319659247
22580,"Forest City, NC",1990,209,34,243,57169,4.25055537091781
22580,"Forest City, NC",1991,179,20,199,57705,3.44857464691101
22580,"Forest City, NC",1992,187,6,193,58070,3.32357499569485
22580,"Forest City, NC",1993,232,56,288,58540,4.91971301674069
22580,"Forest City, NC",1994,206,17,223,58948,3.78299518219448
22580,"Forest City, NC",1995,216,12,228,59502,3.8318039729757
22580,"Forest City, NC",1996,239,28,267,59692,4.47296120083093
22580,"Forest City, NC",1997,254,13,267,60255,4.43116753796365
22580,"Forest City, NC",1998,284,10,294,60909,4.82687287592967
22580,"Forest City, NC",1999,315,31,346,61420,5.63334418756105
22580,"Forest City, NC",2000,280,10,290,63064,4.59850310795382
22580,"Forest City, NC",2001,293,14,307,63671,4.82166135289221
22580,"Forest City, NC",2002,318,18,336,63924,5.25624178712221
22580,"Forest City, NC",2003,292,11,303,64475,4.69949592865452
22580,"Forest City, NC",2004,332,12,344,64692,5.31750448277994
22580,"Forest City, NC",2005,399,38,437,65126,6.71006971102171
22580,"Forest City, NC",2006,441,0,441,65855,6.69653025586516
22580,"Forest City, NC",2007,358,2,360,66305,5.42945479224794
22580,"Forest City, NC",2008,237,2,239,67145,3.55946086827016
22580,"Forest City, NC",2009,113,0,113,67561,1.6725625730821
22580,"Forest City, NC",2010,111,0,111,67737,1.63869081890252
22580,"Forest City, NC",2011,93,0,93,67408,1.37965820080703
22580,"Forest City, NC",2012,100,6,106,67214,1.57705239979766
22580,"Forest City, NC",2013,148,0,148,66848,2.21397797989469
22580,"Forest City, NC",2014,83,56,139,66567,2.0881217420043
22580,"Forest City, NC",2015,106,4,110,66388,1.65692595047298
22580,"Forest City, NC",2016,122,0,122,66311,1.83981541524031
22580,"Forest City, NC",2017,131,2,133,66568,1.99795697632496
22580,"Forest City, NC",2018,150,0,150,66826,2.24463532158142
22620,"Forrest City, AR",1990,27,0,27,28441,0.949333708378749
22620,"Forrest City, AR",1991,12,0,12,28306,0.423938387620999
22620,"Forrest City, AR",1992,15,10,25,28162,0.887721042539592
22620,"Forrest City, AR",1993,19,15,34,28029,1.21302936244604
22620,"Forrest City, AR",1994,26,28,54,28097,1.92191337153433
22620,"Forrest City, AR",1995,19,18,37,28352,1.30502257336343
22620,"Forrest City, AR",1996,19,8,27,28441,0.949333708378749
22620,"Forrest City, AR",1997,15,20,35,28464,1.22962338392355
22620,"Forrest City, AR",1998,21,4,25,28177,0.887248465060155
22620,"Forrest City, AR",1999,24,0,24,27867,0.861233717300032
22620,"Forrest City, AR",2000,16,64,80,29325,2.72804774083546
22620,"Forrest City, AR",2001,8,0,8,29072,0.275178866263071
22620,"Forrest City, AR",2002,18,18,36,29023,1.2403955483582
22620,"Forrest City, AR",2003,12,2,14,29170,0.479945149125814
22620,"Forrest City, AR",2004,20,21,41,28905,1.41843971631206
22620,"Forrest City, AR",2005,16,24,40,28639,1.39669681203953
22620,"Forrest City, AR",2006,17,0,17,28496,0.596574957888827
22620,"Forrest City, AR",2007,13,2,15,28394,0.528280622666761
22620,"Forrest City, AR",2008,7,0,7,28110,0.249021700462469
22620,"Forrest City, AR",2009,3,0,3,28336,0.105872388481084
22620,"Forrest City, AR",2010,0,0,0,28195,0
22620,"Forrest City, AR",2011,3,40,43,27989,1.53631783915109
22620,"Forrest City, AR",2012,45,0,45,27993,1.60754474332869
22620,"Forrest City, AR",2013,5,0,5,27510,0.181752090149037
22620,"Forrest City, AR",2014,0,0,0,27096,0
22620,"Forrest City, AR",2015,0,0,0,26654,0
22620,"Forrest City, AR",2016,3,0,3,26344,0.113877922866687
22620,"Forrest City, AR",2017,1,0,1,25938,0.0385534736679775
22620,"Forrest City, AR",2018,2,0,2,25439,0.0786194425881521
22660,"Fort Collins, CO",1990,1017,219,1236,187070,6.60715240284386
22660,"Fort Collins, CO",1991,1266,277,1543,191973,8.03758861923291
22660,"Fort Collins, CO",1992,1740,188,1928,198012,9.73678362927499
22660,"Fort Collins, CO",1993,2274,344,2618,204850,12.7800829875519
22660,"Fort Collins, CO",1994,2514,688,3202,212394,15.0757554356526
22660,"Fort Collins, CO",1995,2186,611,2797,217090,12.8840573034225
22660,"Fort Collins, CO",1996,2426,1065,3491,221461,15.763497861926
22660,"Fort Collins, CO",1997,2293,484,2777,225591,12.309888249088
22660,"Fort Collins, CO",1998,2647,575,3222,231235,13.9338767920081
22660,"Fort Collins, CO",1999,2583,1008,3591,235959,15.2187456295373
22660,"Fort Collins, CO",2000,2724,800,3524,253072,13.9248909401277
22660,"Fort Collins, CO",2001,2640,1024,3664,260541,14.0630457394422
22660,"Fort Collins, CO",2002,2530,506,3036,265372,11.4405438403449
22660,"Fort Collins, CO",2003,2284,719,3003,268448,11.1865240195494
22660,"Fort Collins, CO",2004,2718,534,3252,271510,11.9774593937608
22660,"Fort Collins, CO",2005,2271,616,2887,275116,10.4937553613748
22660,"Fort Collins, CO",2006,1432,808,2240,280713,7.97968031405742
22660,"Fort Collins, CO",2007,1116,225,1341,286112,4.68697572978414
22660,"Fort Collins, CO",2008,649,616,1265,291650,4.33739070804046
22660,"Fort Collins, CO",2009,361,90,451,296696,1.52007441960795
22660,"Fort Collins, CO",2010,477,676,1153,300450,3.83757696788151
22660,"Fort Collins, CO",2011,702,490,1192,305237,3.90516221821077
22660,"Fort Collins, CO",2012,1139,729,1868,310856,6.00921326916643
22660,"Fort Collins, CO",2013,1489,888,2377,316258,7.5160154051439
22660,"Fort Collins, CO",2014,1627,871,2498,324061,7.70842526561357
22660,"Fort Collins, CO",2015,1720,714,2434,333309,7.3025330849152
22660,"Fort Collins, CO",2016,1622,1910,3532,338926,10.421153880198
22660,"Fort Collins, CO",2017,2027,908,2935,343993,8.53215036352484
22660,"Fort Collins, CO",2018,1679,1265,2944,350518,8.3989980543082
22700,"Fort Dodge, IA",1990,28,0,28,40324,0.694375557980359
22700,"Fort Dodge, IA",1991,37,0,37,40231,0.919688797196192
22700,"Fort Dodge, IA",1992,54,0,54,40095,1.34680134680135
22700,"Fort Dodge, IA",1993,26,2,28,39868,0.702317648239189
22700,"Fort Dodge, IA",1994,33,2,35,39432,0.887603976465815
22700,"Fort Dodge, IA",1995,38,52,90,39269,2.2918841834526
22700,"Fort Dodge, IA",1996,38,74,112,38955,2.87511230907457
22700,"Fort Dodge, IA",1997,45,7,52,38685,1.34419025462065
22700,"Fort Dodge, IA",1998,66,10,76,38984,1.94951775087215
22700,"Fort Dodge, IA",1999,56,20,76,39496,1.9242454932145
22700,"Fort Dodge, IA",2000,72,10,82,40234,2.03807724809862
22700,"Fort Dodge, IA",2001,71,18,89,40045,2.22249968785117
22700,"Fort Dodge, IA",2002,51,40,91,39654,2.29485045644828
22700,"Fort Dodge, IA",2003,58,12,70,39377,1.77768748254057
22700,"Fort Dodge, IA",2004,55,10,65,38922,1.67000668002672
22700,"Fort Dodge, IA",2005,58,8,66,38562,1.71152948498522
22700,"Fort Dodge, IA",2006,29,9,38,38534,0.986142108268023
22700,"Fort Dodge, IA",2007,39,0,39,38393,1.01581017372959
22700,"Fort Dodge, IA",2008,25,0,25,38273,0.6532019961853
22700,"Fort Dodge, IA",2009,16,0,16,38316,0.417580123186136
22700,"Fort Dodge, IA",2010,23,0,23,37884,0.607116460774997
22700,"Fort Dodge, IA",2011,15,0,15,37746,0.397393101255762
22700,"Fort Dodge, IA",2012,31,0,31,37325,0.830542531815137
22700,"Fort Dodge, IA",2013,41,0,41,37333,1.09822409128653
22700,"Fort Dodge, IA",2014,16,4,20,37070,0.539519827353655
22700,"Fort Dodge, IA",2015,13,0,13,37048,0.350896134744116
22700,"Fort Dodge, IA",2016,18,0,18,36746,0.489849235290916
22700,"Fort Dodge, IA",2017,19,0,19,36643,0.518516497011708
22700,"Fort Dodge, IA",2018,68,2,70,36277,1.92959726548502
22780,"Fort Leonard Wood, MO",1990,13,0,13,41767,0.31125050877487
22780,"Fort Leonard Wood, MO",1991,14,0,14,41848,0.33454406423246
22780,"Fort Leonard Wood, MO",1992,16,0,16,43625,0.36676217765043
22780,"Fort Leonard Wood, MO",1993,13,0,13,40105,0.324149108589951
22780,"Fort Leonard Wood, MO",1994,9,0,9,39344,0.228751525010167
22780,"Fort Leonard Wood, MO",1995,8,0,8,37764,0.211841965893443
22780,"Fort Leonard Wood, MO",1996,8,12,20,37183,0.537880214076325
22780,"Fort Leonard Wood, MO",1997,8,8,16,37851,0.422710100129455
22780,"Fort Leonard Wood, MO",1998,10,4,14,39353,0.355754326226717
22780,"Fort Leonard Wood, MO",1999,26,60,86,38304,2.24519632414369
22780,"Fort Leonard Wood, MO",2000,5,2,7,41957,0.166837476463999
22780,"Fort Leonard Wood, MO",2001,8,0,8,43558,0.18366316176133
22780,"Fort Leonard Wood, MO",2002,40,60,100,44535,2.24542494667116
22780,"Fort Leonard Wood, MO",2003,20,4,24,44507,0.539241018266789
22780,"Fort Leonard Wood, MO",2004,82,56,138,45301,3.04629036886603
22780,"Fort Leonard Wood, MO",2005,141,35,176,45570,3.86219003730524
22780,"Fort Leonard Wood, MO",2006,126,24,150,46482,3.22705563443914
22780,"Fort Leonard Wood, MO",2007,98,6,104,47357,2.19608505606352
22780,"Fort Leonard Wood, MO",2008,89,24,113,48300,2.33954451345756
22780,"Fort Leonard Wood, MO",2009,136,8,144,50630,2.84416353940352
22780,"Fort Leonard Wood, MO",2010,54,0,54,52850,1.02175969725639
22780,"Fort Leonard Wood, MO",2011,70,42,112,53264,2.10273355361971
22780,"Fort Leonard Wood, MO",2012,49,346,395,53452,7.38980767791664
22780,"Fort Leonard Wood, MO",2013,29,413,442,54062,8.17579815767082
22780,"Fort Leonard Wood, MO",2014,72,0,72,53532,1.34498991257566
22780,"Fort Leonard Wood, MO",2015,49,0,49,53169,0.921589648103218
22780,"Fort Leonard Wood, MO",2016,49,0,49,52393,0.935239440383257
22780,"Fort Leonard Wood, MO",2017,54,0,54,51846,1.04154611734753
22780,"Fort Leonard Wood, MO",2018,49,0,49,52014,0.942054062367824
22800,"Fort Madison-Keokuk, IA-IL-MO",1990,20,4,24,67517,0.355466030777434
22800,"Fort Madison-Keokuk, IA-IL-MO",1991,28,5,33,67851,0.486359817836141
22800,"Fort Madison-Keokuk, IA-IL-MO",1992,34,24,58,68191,0.850552125647079
22800,"Fort Madison-Keokuk, IA-IL-MO",1993,53,6,59,68005,0.867583265936328
22800,"Fort Madison-Keokuk, IA-IL-MO",1994,58,3,61,67810,0.899572334463943
22800,"Fort Madison-Keokuk, IA-IL-MO",1995,79,6,85,67932,1.25125125125125
22800,"Fort Madison-Keokuk, IA-IL-MO",1996,40,6,46,67558,0.680896414932354
22800,"Fort Madison-Keokuk, IA-IL-MO",1997,45,4,49,67315,0.727920968580554
22800,"Fort Madison-Keokuk, IA-IL-MO",1998,48,55,103,67103,1.53495372785121
22800,"Fort Madison-Keokuk, IA-IL-MO",1999,38,14,52,66575,0.781073976717987
22800,"Fort Madison-Keokuk, IA-IL-MO",2000,38,32,70,65466,1.06925732441267
22800,"Fort Madison-Keokuk, IA-IL-MO",2001,69,44,113,64937,1.74014814358532
22800,"Fort Madison-Keokuk, IA-IL-MO",2002,62,37,99,64120,1.54398003742982
22800,"Fort Madison-Keokuk, IA-IL-MO",2003,37,2,39,63581,0.61339079284692
22800,"Fort Madison-Keokuk, IA-IL-MO",2004,35,18,53,63403,0.835922590413703
22800,"Fort Madison-Keokuk, IA-IL-MO",2005,31,2,33,63067,0.52325304834541
22800,"Fort Madison-Keokuk, IA-IL-MO",2006,29,6,35,62909,0.556359185490152
22800,"Fort Madison-Keokuk, IA-IL-MO",2007,42,16,58,62701,0.925025119216599
22800,"Fort Madison-Keokuk, IA-IL-MO",2008,29,5,34,62179,0.546808407983403
22800,"Fort Madison-Keokuk, IA-IL-MO",2009,8,2,10,62047,0.161168146727481
22800,"Fort Madison-Keokuk, IA-IL-MO",2010,17,128,145,62075,2.33588401127668
22800,"Fort Madison-Keokuk, IA-IL-MO",2011,11,14,25,61588,0.405923231798402
22800,"Fort Madison-Keokuk, IA-IL-MO",2012,14,4,18,61331,0.293489426228172
22800,"Fort Madison-Keokuk, IA-IL-MO",2013,17,0,17,60677,0.280172058605402
22800,"Fort Madison-Keokuk, IA-IL-MO",2014,23,8,31,60266,0.514386221086516
22800,"Fort Madison-Keokuk, IA-IL-MO",2015,19,0,19,59916,0.317110621536818
22800,"Fort Madison-Keokuk, IA-IL-MO",2016,22,45,67,59401,1.12792713927375
22800,"Fort Madison-Keokuk, IA-IL-MO",2017,25,0,25,58943,0.424138574555079
22800,"Fort Madison-Keokuk, IA-IL-MO",2018,10,16,26,58741,0.442620997259155
22820,"Fort Morgan, CO",1990,9,0,9,21928,0.410434148121124
22820,"Fort Morgan, CO",1991,28,0,28,22447,1.24738272374928
22820,"Fort Morgan, CO",1992,57,0,57,22887,2.49049678856993
22820,"Fort Morgan, CO",1993,56,0,56,23102,2.42403255129426
22820,"Fort Morgan, CO",1994,125,66,191,23667,8.07030886888917
22820,"Fort Morgan, CO",1995,98,0,98,24100,4.06639004149378
22820,"Fort Morgan, CO",1996,100,4,104,24586,4.23004962173595
22820,"Fort Morgan, CO",1997,117,10,127,25033,5.07330323972356
22820,"Fort Morgan, CO",1998,182,4,186,25040,7.42811501597444
22820,"Fort Morgan, CO",1999,94,14,108,25325,4.2645607107601204
22820,"Fort Morgan, CO",2000,110,6,116,27257,4.25578750412738
22820,"Fort Morgan, CO",2001,95,2,97,27307,3.55220273190025
22820,"Fort Morgan, CO",2002,129,10,139,27556,5.04427347946001
22820,"Fort Morgan, CO",2003,115,10,125,27736,4.50677819440438
22820,"Fort Morgan, CO",2004,133,10,143,27736,5.15575425439862
22820,"Fort Morgan, CO",2005,128,6,134,27727,4.83283442132218
22820,"Fort Morgan, CO",2006,80,6,86,27816,3.09174575783722
22820,"Fort Morgan, CO",2007,62,2,64,27745,2.30672193187962
22820,"Fort Morgan, CO",2008,36,0,36,27701,1.29959207248836
22820,"Fort Morgan, CO",2009,17,2,19,28099,0.676180646998114
22820,"Fort Morgan, CO",2010,22,0,22,28243,0.778954077116454
22820,"Fort Morgan, CO",2011,10,0,10,28453,0.351456788387868
22820,"Fort Morgan, CO",2012,18,0,18,28257,0.637010298333156
22820,"Fort Morgan, CO",2013,19,0,19,28236,0.672899844170562
22820,"Fort Morgan, CO",2014,18,2,20,28120,0.711237553342816
22820,"Fort Morgan, CO",2015,24,54,78,28237,2.76233310904133
22820,"Fort Morgan, CO",2016,34,0,34,28143,1.20811569484419
22820,"Fort Morgan, CO",2017,90,0,90,28228,3.18832365027632
22820,"Fort Morgan, CO",2018,140,6,146,28558,5.11240282932978
22860,"Fort Polk South, LA",1990,11,0,11,62063,0.177239256884134
22860,"Fort Polk South, LA",1991,26,0,26,63816,0.407421336341983
22860,"Fort Polk South, LA",1992,27,0,27,63841,0.42292570605097
22860,"Fort Polk South, LA",1993,59,0,59,56187,1.05006496164593
22860,"Fort Polk South, LA",1994,40,0,40,56563,0.70717606916182
22860,"Fort Polk South, LA",1995,6,40,46,55290,0.831976849339845
22860,"Fort Polk South, LA",1996,4,0,4,54046,0.0740110276431188
22860,"Fort Polk South, LA",1997,5,0,5,51749,0.0966202245454018
22860,"Fort Polk South, LA",1998,6,0,6,51397,0.116738331030994
22860,"Fort Polk South, LA",1999,5,0,5,51542,0.0970082651041869
22860,"Fort Polk South, LA",2000,1,0,1,52744,0.0189595025026543
22860,"Fort Polk South, LA",2001,2,0,2,52958,0.0377657766531969
22860,"Fort Polk South, LA",2002,31,0,31,52319,0.592518970163803
22860,"Fort Polk South, LA",2003,25,0,25,51288,0.487443456559039
22860,"Fort Polk South, LA",2004,23,0,23,51402,0.447453406482238
22860,"Fort Polk South, LA",2005,20,0,20,51808,0.38604076590488
22860,"Fort Polk South, LA",2006,18,38,56,50781,1.10277465981371
22860,"Fort Polk South, LA",2007,3,0,3,49796,0.060245802875733
22860,"Fort Polk South, LA",2008,2,0,2,48007,0.0416605911637886
22860,"Fort Polk South, LA",2009,28,0,28,50903,0.550065811445298
22860,"Fort Polk South, LA",2010,8,6,14,52714,0.26558409530675
22860,"Fort Polk South, LA",2011,5,0,5,52238,0.0957157624717638
22860,"Fort Polk South, LA",2012,156,0,156,54088,2.88418872947789
22860,"Fort Polk South, LA",2013,109,2,111,52787,2.10279045977229
22860,"Fort Polk South, LA",2014,76,0,76,52793,1.43958479343852
22860,"Fort Polk South, LA",2015,54,0,54,51415,1.05027715647185
22860,"Fort Polk South, LA",2016,54,0,54,51449,1.04958308227565
22860,"Fort Polk South, LA",2017,54,0,54,50519,1.06890476850294
22860,"Fort Polk South, LA",2018,50,0,50,48860,1.02333196889071
22900,"Fort Smith, AR-OK",1990,507,228,735,219561,3.34758905270062
22900,"Fort Smith, AR-OK",1991,482,71,553,221616,2.49530719803624
22900,"Fort Smith, AR-OK",1992,604,53,657,224067,2.93215868467914
22900,"Fort Smith, AR-OK",1993,599,75,674,227826,2.95839807572446
22900,"Fort Smith, AR-OK",1994,700,505,1205,229692,5.24615572157498
22900,"Fort Smith, AR-OK",1995,605,565,1170,234015,4.99967950772386
22900,"Fort Smith, AR-OK",1996,775,177,952,236935,4.01797961466225
22900,"Fort Smith, AR-OK",1997,653,246,899,239129,3.75947710231716
22900,"Fort Smith, AR-OK",1998,651,130,781,240636,3.24556591698665
22900,"Fort Smith, AR-OK",1999,565,216,781,242556,3.21987499793862
22900,"Fort Smith, AR-OK",2000,477,233,710,256126,2.77207312026112
22900,"Fort Smith, AR-OK",2001,550,127,677,258087,2.62314645836482
22900,"Fort Smith, AR-OK",2002,666,348,1014,260117,3.89824578939477
22900,"Fort Smith, AR-OK",2003,674,227,901,261903,3.44020496137883
22900,"Fort Smith, AR-OK",2004,640,232,872,264035,3.30259245933304
22900,"Fort Smith, AR-OK",2005,771,267,1038,266708,3.89189675600282
22900,"Fort Smith, AR-OK",2006,644,147,791,271075,2.91801162040026
22900,"Fort Smith, AR-OK",2007,783,305,1088,274305,3.96638778002588
22900,"Fort Smith, AR-OK",2008,484,264,748,276322,2.70698677629722
22900,"Fort Smith, AR-OK",2009,563,323,886,278908,3.17667474579431
22900,"Fort Smith, AR-OK",2010,513,169,682,280698,2.42965749666902
22900,"Fort Smith, AR-OK",2011,452,130,582,281349,2.06860518430846
22900,"Fort Smith, AR-OK",2012,506,117,623,281240,2.21518987341772
22900,"Fort Smith, AR-OK",2013,379,223,602,280349,2.14732351461928
22900,"Fort Smith, AR-OK",2014,371,233,604,280019,2.15699648952393
22900,"Fort Smith, AR-OK",2015,328,138,466,280496,1.66134276424619
22900,"Fort Smith, AR-OK",2016,399,304,703,281181,2.50016893033313
22900,"Fort Smith, AR-OK",2017,380,341,721,281990,2.55682825632115
22900,"Fort Smith, AR-OK",2018,399,199,598,282318,2.11817879129209
23060,"Fort Wayne, IN",1990,1610,254,1864,355027,5.2503049063874
23060,"Fort Wayne, IN",1991,1583,124,1707,356878,4.78314718195013
23060,"Fort Wayne, IN",1992,1799,55,1854,358700,5.168664622247
23060,"Fort Wayne, IN",1993,1871,198,2069,360661,5.7366890237647
23060,"Fort Wayne, IN",1994,1919,227,2146,361952,5.92896295641411
23060,"Fort Wayne, IN",1995,1950,264,2214,363758,6.08646407776599
23060,"Fort Wayne, IN",1996,2050,169,2219,366227,6.05908357384901
23060,"Fort Wayne, IN",1997,1754,700,2454,368597,6.65767762624221
23060,"Fort Wayne, IN",1998,2267,950,3217,371645,8.6561099974438
23060,"Fort Wayne, IN",1999,2556,752,3308,373783,8.8500547108884
23060,"Fort Wayne, IN",2000,1970,156,2126,391039,5.43679786415166
23060,"Fort Wayne, IN",2001,2129,476,2605,393580,6.61873062655623
23060,"Fort Wayne, IN",2002,2259,654,2913,396147,7.35333096047679
23060,"Fort Wayne, IN",2003,2264,367,2631,398993,6.5941006483823
23060,"Fort Wayne, IN",2004,2119,518,2637,400583,6.58290541535712
23060,"Fort Wayne, IN",2005,2056,485,2541,403240,6.30145818867176
23060,"Fort Wayne, IN",2006,1376,212,1588,406783,3.90380128963108
23060,"Fort Wayne, IN",2007,1070,45,1115,410223,2.71803384988165
23060,"Fort Wayne, IN",2008,771,245,1016,412062,2.46564837330305
23060,"Fort Wayne, IN",2009,764,120,884,414438,2.13300903874645
23060,"Fort Wayne, IN",2010,809,76,885,416976,2.12242431219063
23060,"Fort Wayne, IN",2011,721,22,743,420011,1.7690012880615
23060,"Fort Wayne, IN",2012,694,536,1230,421926,2.91520313988709
23060,"Fort Wayne, IN",2013,960,75,1035,424386,2.43881749162319
23060,"Fort Wayne, IN",2014,883,362,1245,426462,2.91936913488189
23060,"Fort Wayne, IN",2015,990,365,1355,428843,3.15966449259986
23060,"Fort Wayne, IN",2016,1076,460,1536,431125,3.56277181791824
23060,"Fort Wayne, IN",2017,1222,500,1722,434001,3.96773279324241
23060,"Fort Wayne, IN",2018,1343,541,1884,437631,4.30499667528123
23140,"Frankfort, IN",1990,80,16,96,31042,3.09258424070614
23140,"Frankfort, IN",1991,63,4,67,31424,2.1321283095723
23140,"Frankfort, IN",1992,86,0,86,31738,2.70968555044426
23140,"Frankfort, IN",1993,102,2,104,32016,3.24837581209395
23140,"Frankfort, IN",1994,139,0,139,32256,4.30927579365079
23140,"Frankfort, IN",1995,143,0,143,32458,4.40569351161501
23140,"Frankfort, IN",1996,124,68,192,32931,5.83037259724879
23140,"Frankfort, IN",1997,108,0,108,33166,3.25634686124344
23140,"Frankfort, IN",1998,119,3,122,33206,3.6740348129856
23140,"Frankfort, IN",1999,81,3,84,32945,2.54970405220823
23140,"Frankfort, IN",2000,73,4,77,33942,2.26857580578634
23140,"Frankfort, IN",2001,88,12,100,33809,2.95779230382443
23140,"Frankfort, IN",2002,93,2,95,33610,2.82653972032133
23140,"Frankfort, IN",2003,64,8,72,33383,2.15678638828146
23140,"Frankfort, IN",2004,48,6,54,33342,1.61957890948353
23140,"Frankfort, IN",2005,54,0,54,33237,1.6246953696182
23140,"Frankfort, IN",2006,49,0,49,33298,1.47155985344465
23140,"Frankfort, IN",2007,44,0,44,33188,1.32578040255514
23140,"Frankfort, IN",2008,44,0,44,33352,1.31926121372032
23140,"Frankfort, IN",2009,16,0,16,33280,0.480769230769231
23140,"Frankfort, IN",2010,13,0,13,33221,0.391318744167846
23140,"Frankfort, IN",2011,29,4,33,33032,0.999031242431582
23140,"Frankfort, IN",2012,0,0,0,32890,0
23140,"Frankfort, IN",2013,28,0,28,32773,0.854361822231715
23140,"Frankfort, IN",2014,24,0,24,32471,0.739121061870592
23140,"Frankfort, IN",2015,33,0,33,32381,1.01911614835861
23140,"Frankfort, IN",2016,26,0,26,32198,0.807503571650413
23140,"Frankfort, IN",2017,44,77,121,32207,3.75694724749278
23140,"Frankfort, IN",2018,28,4,32,32250,0.992248062015504
23180,"Frankfort, KY",1990,169,5,174,58882,2.9550626677083
23180,"Frankfort, KY",1991,300,85,385,59377,6.48399211816023
23180,"Frankfort, KY",1992,390,26,416,60427,6.88433978188558
23180,"Frankfort, KY",1993,512,34,546,61386,8.89453621346887
23180,"Frankfort, KY",1994,499,52,551,62154,8.86507706664092
23180,"Frankfort, KY",1995,410,37,447,63085,7.08567805341999
23180,"Frankfort, KY",1996,421,176,597,63798,9.35766011473714
23180,"Frankfort, KY",1997,407,76,483,64317,7.50967862307011
23180,"Frankfort, KY",1998,441,117,558,65010,8.58329487771112
23180,"Frankfort, KY",1999,464,190,654,65456,9.99144463456368
23180,"Frankfort, KY",2000,289,108,397,67039,5.92192604304957
23180,"Frankfort, KY",2001,315,60,375,67567,5.55004662039161
23180,"Frankfort, KY",2002,359,59,418,67608,6.18270027215714
23180,"Frankfort, KY",2003,417,72,489,67750,7.21771217712177
23180,"Frankfort, KY",2004,363,110,473,68250,6.93040293040293
23180,"Frankfort, KY",2005,433,72,505,68607,7.36076493652251
23180,"Frankfort, KY",2006,361,22,383,69218,5.5332427981161
23180,"Frankfort, KY",2007,266,22,288,69794,4.12642920594894
23180,"Frankfort, KY",2008,174,26,200,70389,2.84135305232352
23180,"Frankfort, KY",2009,316,87,403,70581,5.70975191623808
23180,"Frankfort, KY",2010,97,10,107,70723,1.51294486942013
23180,"Frankfort, KY",2011,49,4,53,70874,0.747805965516268
23180,"Frankfort, KY",2012,55,22,77,71161,1.08205337193125
23180,"Frankfort, KY",2013,63,6,69,71234,0.968638571468681
23180,"Frankfort, KY",2014,81,44,125,71603,1.74573691046465
23180,"Frankfort, KY",2015,82,8,90,71987,1.25022573520219
23180,"Frankfort, KY",2016,129,6,135,72459,1.86312259346665
23180,"Frankfort, KY",2017,131,20,151,73022,2.06786995699926
23180,"Frankfort, KY",2018,160,32,192,73478,2.61302702849833
23240,"Fredericksburg, TX",1990,23,0,23,17224,1.33534602879703
23240,"Fredericksburg, TX",1991,22,48,70,17440,4.01376146788991
23240,"Fredericksburg, TX",1992,46,0,46,17845,2.57775287195293
23240,"Fredericksburg, TX",1993,48,7,55,18542,2.96623880918995
23240,"Fredericksburg, TX",1994,57,7,64,18862,3.39306542254268
23240,"Fredericksburg, TX",1995,54,16,70,19198,3.64621314720283
23240,"Fredericksburg, TX",1996,37,122,159,19457,8.17186616641825
23240,"Fredericksburg, TX",1997,38,78,116,19768,5.86806960744638
23240,"Fredericksburg, TX",1998,47,34,81,19990,4.0520260130065
23240,"Fredericksburg, TX",1999,76,0,76,20365,3.73189295359686
23240,"Fredericksburg, TX",2000,61,0,61,20902,2.9183810161707
23240,"Fredericksburg, TX",2001,86,0,86,21104,4.07505686125853
23240,"Fredericksburg, TX",2002,99,51,150,21585,6.94927032661571
23240,"Fredericksburg, TX",2003,81,2,83,22128,3.75090383224873
23240,"Fredericksburg, TX",2004,79,0,79,22454,3.51830408835842
23240,"Fredericksburg, TX",2005,80,64,144,22858,6.29976375885904
23240,"Fredericksburg, TX",2006,76,57,133,23487,5.66270702942053
23240,"Fredericksburg, TX",2007,63,66,129,23787,5.42313028124606
23240,"Fredericksburg, TX",2008,42,49,91,24206,3.7593984962406
23240,"Fredericksburg, TX",2009,28,25,53,24608,2.1537711313394
23240,"Fredericksburg, TX",2010,34,0,34,24887,1.366175111504
23240,"Fredericksburg, TX",2011,33,0,33,25053,1.31720752005748
23240,"Fredericksburg, TX",2012,34,0,34,25193,1.34958123288215
23240,"Fredericksburg, TX",2013,41,0,41,25385,1.61512704352964
23240,"Fredericksburg, TX",2014,39,0,39,25495,1.52971170817807
23240,"Fredericksburg, TX",2015,41,0,41,25954,1.57971796254913
23240,"Fredericksburg, TX",2016,49,0,49,26259,1.86602688602003
23240,"Fredericksburg, TX",2017,54,0,54,26530,2.03543158688277
23240,"Fredericksburg, TX",2018,60,0,60,26804,2.23847186987017
23300,"Freeport, IL",1990,114,51,165,48109,3.42971169635619
23300,"Freeport, IL",1991,121,27,148,48212,3.06977515971127
23300,"Freeport, IL",1992,137,87,224,48434,4.62485031176446
23300,"Freeport, IL",1993,142,28,170,48687,3.49169182738719
23300,"Freeport, IL",1994,149,74,223,48924,4.55809009892895
23300,"Freeport, IL",1995,142,10,152,48848,3.11169341631182
23300,"Freeport, IL",1996,173,64,237,49014,4.83535316440201
23300,"Freeport, IL",1997,166,6,172,49055,3.50626847416166
23300,"Freeport, IL",1998,126,14,140,48909,2.862458852154
23300,"Freeport, IL",1999,128,36,164,48875,3.35549872122762
23300,"Freeport, IL",2000,81,60,141,48920,2.88225674570728
23300,"Freeport, IL",2001,83,51,134,48625,2.75578406169666
23300,"Freeport, IL",2002,108,8,116,48367,2.39832943949387
23300,"Freeport, IL",2003,100,12,112,48503,2.30913551739068
23300,"Freeport, IL",2004,108,0,108,48479,2.22776872460241
23300,"Freeport, IL",2005,90,20,110,48105,2.28666458788068
23300,"Freeport, IL",2006,72,18,90,47917,1.87824780349354
23300,"Freeport, IL",2007,59,10,69,47794,1.4436958614052
23300,"Freeport, IL",2008,30,18,48,47805,1.00407907122686
23300,"Freeport, IL",2009,29,2,31,47792,0.648644124539672
23300,"Freeport, IL",2010,27,0,27,47607,0.567143487302287
23300,"Freeport, IL",2011,10,0,10,47319,0.21133160041421
23300,"Freeport, IL",2012,24,0,24,46886,0.511879878855095
23300,"Freeport, IL",2013,18,0,18,46672,0.385670209118958
23300,"Freeport, IL",2014,8,0,8,46267,0.172909417079128
23300,"Freeport, IL",2015,11,0,11,45668,0.240868879740738
23300,"Freeport, IL",2016,10,0,10,45497,0.219794711739236
23300,"Freeport, IL",2017,14,0,14,44981,0.311242524621507
23300,"Freeport, IL",2018,12,0,12,44753,0.268138448819074
23340,"Fremont, NE",1990,32,29,61,34482,1.76903891885621
23340,"Fremont, NE",1991,36,10,46,34488,1.33379726281605
23340,"Fremont, NE",1992,55,4,59,34594,1.70549806324796
23340,"Fremont, NE",1993,70,6,76,34514,2.20200498348496
23340,"Fremont, NE",1994,95,87,182,34514,5.27322246045083
23340,"Fremont, NE",1995,74,73,147,34648,4.24266912953129
23340,"Fremont, NE",1996,56,2,58,34992,1.65752171925011
23340,"Fremont, NE",1997,56,12,68,35138,1.93522681996699
23340,"Fremont, NE",1998,85,44,129,35331,3.65118451218477
23340,"Fremont, NE",1999,118,32,150,35239,4.25664746445699
23340,"Fremont, NE",2000,93,48,141,36231,3.89169495735696
23340,"Fremont, NE",2001,57,78,135,36143,3.73516310212213
23340,"Fremont, NE",2002,84,26,110,36060,3.05047143649473
23340,"Fremont, NE",2003,84,40,124,36184,3.42692902940526
23340,"Fremont, NE",2004,102,25,127,36267,3.50180604957675
23340,"Fremont, NE",2005,108,4,112,36442,3.07337687283903
23340,"Fremont, NE",2006,50,21,71,36597,1.94004973085226
23340,"Fremont, NE",2007,64,2,66,36647,1.80096597265806
23340,"Fremont, NE",2008,49,2,51,36548,1.39542519426508
23340,"Fremont, NE",2009,49,2,51,36604,1.39329035078134
23340,"Fremont, NE",2010,38,2,40,36672,1.09075043630017
23340,"Fremont, NE",2011,27,14,41,36927,1.11029869743006
23340,"Fremont, NE",2012,45,4,49,36587,1.33927351244978
23340,"Fremont, NE",2013,61,18,79,36498,2.16450216450216
23340,"Fremont, NE",2014,45,0,45,36616,1.22897094166485
23340,"Fremont, NE",2015,50,0,50,36560,1.36761487964989
23340,"Fremont, NE",2016,54,0,54,36655,1.47319601691447
23340,"Fremont, NE",2017,70,0,70,36794,1.90248410066859
23340,"Fremont, NE",2018,62,2,64,36791,1.73955586964203
23380,"Fremont, OH",1990,112,8,120,61953,1.93695220570432
23380,"Fremont, OH",1991,107,152,259,62451,4.14725144513298
23380,"Fremont, OH",1992,117,78,195,62587,3.11566299710803
23380,"Fremont, OH",1993,165,70,235,62503,3.75981952866262
23380,"Fremont, OH",1994,181,31,212,62586,3.38733902150641
23380,"Fremont, OH",1995,152,12,164,62784,2.61213047910296
23380,"Fremont, OH",1996,149,14,163,62662,2.60125754045514
23380,"Fremont, OH",1997,152,12,164,62383,2.62892134074988
23380,"Fremont, OH",1998,125,10,135,62100,2.17391304347826
23380,"Fremont, OH",1999,149,16,165,61776,2.67094017094017
23380,"Fremont, OH",2000,141,8,149,61812,2.41053517116418
23380,"Fremont, OH",2001,169,26,195,61788,3.1559526121577
23380,"Fremont, OH",2002,171,33,204,61918,3.29468006072548
23380,"Fremont, OH",2003,156,83,239,61784,3.86831542146834
23380,"Fremont, OH",2004,167,31,198,61930,3.19715808170515
23380,"Fremont, OH",2005,128,4,132,61865,2.13367817020933
23380,"Fremont, OH",2006,102,10,112,61745,1.81391205765649
23380,"Fremont, OH",2007,60,0,60,61571,0.974484741193094
23380,"Fremont, OH",2008,37,24,61,61184,0.996992677824268
23380,"Fremont, OH",2009,29,0,29,61039,0.475106079719524
23380,"Fremont, OH",2010,33,0,33,60886,0.541996518082975
23380,"Fremont, OH",2011,51,0,51,60603,0.841542497896144
23380,"Fremont, OH",2012,12,0,12,60463,0.198468484858509
23380,"Fremont, OH",2013,22,0,22,60049,0.366367466568969
23380,"Fremont, OH",2014,20,0,20,59827,0.334297223661558
23380,"Fremont, OH",2015,32,66,98,59462,1.64811139887659
23380,"Fremont, OH",2016,37,0,37,59297,0.623977604263285
23380,"Fremont, OH",2017,48,0,48,59112,0.812017864393017
23380,"Fremont, OH",2018,42,2,44,58799,0.748312046123233
23420,"Fresno, CA",1990,3872,1481,5353,671665,7.96974682319311
23420,"Fresno, CA",1991,3494,872,4366,688295,6.3432103967049
23420,"Fresno, CA",1992,4157,835,4992,704214,7.08875427071884
23420,"Fresno, CA",1993,3754,402,4156,717941,5.78877651506182
23420,"Fresno, CA",1994,3713,930,4643,727995,6.37779105625725
23420,"Fresno, CA",1995,3071,985,4056,734752,5.52022995514133
23420,"Fresno, CA",1996,3021,269,3290,743573,4.42458238801032
23420,"Fresno, CA",1997,2511,268,2779,750486,3.70293383221006
23420,"Fresno, CA",1998,2730,288,3018,754667,3.99911484138037
23420,"Fresno, CA",1999,2607,364,2971,762251,3.89766625429157
23420,"Fresno, CA",2000,2909,247,3156,801288,3.93865875939737
23420,"Fresno, CA",2001,3618,150,3768,813021,4.63456663481017
23420,"Fresno, CA",2002,3655,182,3837,829762,4.62421754671822
23420,"Fresno, CA",2003,4470,1283,5753,847193,6.79066045163263
23420,"Fresno, CA",2004,5402,1755,7157,861035,8.31208952017049
23420,"Fresno, CA",2005,5865,1535,7400,872470,8.48166699141518
23420,"Fresno, CA",2006,3904,1374,5278,883862,5.97152044097382
23420,"Fresno, CA",2007,3645,1210,4855,895933,5.41893199603095
23420,"Fresno, CA",2008,2094,466,2560,909630,2.81433110165672
23420,"Fresno, CA",2009,2068,160,2228,921478,2.41785479414593
23420,"Fresno, CA",2010,1917,331,2248,932063,2.41185413432354
23420,"Fresno, CA",2011,1289,333,1622,939479,1.72648883051138
23420,"Fresno, CA",2012,1511,333,1844,945349,1.95060237012997
23420,"Fresno, CA",2013,2350,422,2772,952029,2.91167600986945
23420,"Fresno, CA",2014,1611,281,1892,961311,1.96814558451947
23420,"Fresno, CA",2015,2053,269,2322,970442,2.39272414013408
23420,"Fresno, CA",2016,2553,351,2904,977956,2.96945874865536
23420,"Fresno, CA",2017,1796,1137,2933,986542,2.97301077906465
23420,"Fresno, CA",2018,2213,716,2929,994400,2.94549477071601
23460,"Gadsden, AL",1990,114,18,132,99798,1.32267179703
23460,"Gadsden, AL",1991,147,18,165,100308,1.64493360449815
23460,"Gadsden, AL",1992,185,37,222,100846,2.201376356028
23460,"Gadsden, AL",1993,208,81,289,101160,2.856860419138
23460,"Gadsden, AL",1994,239,52,291,102016,2.85249372647428
23460,"Gadsden, AL",1995,236,87,323,102099,3.1635961174938
23460,"Gadsden, AL",1996,216,42,258,102773,2.5103869693402
23460,"Gadsden, AL",1997,173,56,229,103791,2.2063570059061
23460,"Gadsden, AL",1998,218,22,240,103984,2.30804739190645
23460,"Gadsden, AL",1999,155,40,195,103577,1.88265734670825
23460,"Gadsden, AL",2000,180,83,263,103286,2.54632767267587
23460,"Gadsden, AL",2001,199,107,306,102976,2.97156619018024
23460,"Gadsden, AL",2002,254,74,328,102988,3.18483706839632
23460,"Gadsden, AL",2003,252,83,335,103025,3.25163795195341
23460,"Gadsden, AL",2004,279,30,309,103080,2.9976717112922
23460,"Gadsden, AL",2005,337,62,399,103174,3.86725337778898
23460,"Gadsden, AL",2006,312,79,391,103528,3.77675604667336
23460,"Gadsden, AL",2007,238,24,262,103893,2.52182533953202
23460,"Gadsden, AL",2008,191,8,199,104206,1.90967890524538
23460,"Gadsden, AL",2009,128,0,128,104239,1.22794731338558
23460,"Gadsden, AL",2010,105,0,105,104455,1.00521755780001
23460,"Gadsden, AL",2011,82,17,99,104358,0.948657505893175
23460,"Gadsden, AL",2012,90,0,90,104273,0.863118928198095
23460,"Gadsden, AL",2013,75,0,75,103883,0.721966057969061
23460,"Gadsden, AL",2014,79,0,79,103407,0.763971491291692
23460,"Gadsden, AL",2015,83,0,83,103003,0.8058017727639
23460,"Gadsden, AL",2016,97,0,97,102849,0.943130220031308
23460,"Gadsden, AL",2017,112,0,112,102937,1.08804414350525
23460,"Gadsden, AL",2018,104,0,104,102501,1.01462424756832
23500,"Gaffney, SC",1990,148,35,183,44610,4.10221923335575
23500,"Gaffney, SC",1991,173,60,233,45145,5.16114741388858
23500,"Gaffney, SC",1992,9,0,9,45595,0.197390064700077
23500,"Gaffney, SC",1993,145,0,145,46037,3.14964050654908
23500,"Gaffney, SC",1994,166,2,168,46635,3.60244451592152
23500,"Gaffney, SC",1995,132,2,134,47162,2.84127051439718
23500,"Gaffney, SC",1996,148,66,214,47908,4.46689488185689
23500,"Gaffney, SC",1997,156,36,192,48567,3.95330162455989
23500,"Gaffney, SC",1998,190,36,226,49160,4.5972335231895904
23500,"Gaffney, SC",1999,48,19,67,49977,1.34061668367449
23500,"Gaffney, SC",2000,147,4,151,52649,2.8680506752265
23500,"Gaffney, SC",2001,142,0,142,53020,2.6782346284421
23500,"Gaffney, SC",2002,149,9,158,53407,2.95841369108918
23500,"Gaffney, SC",2003,156,16,172,53437,3.21874356719127
23500,"Gaffney, SC",2004,181,0,181,53642,3.37422169195779
23500,"Gaffney, SC",2005,108,0,108,53772,2.00848024994421
23500,"Gaffney, SC",2006,141,0,141,54166,2.60310896134106
23500,"Gaffney, SC",2007,141,114,255,54467,4.68173389391742
23500,"Gaffney, SC",2008,107,2,109,54981,1.98250304650698
23500,"Gaffney, SC",2009,72,0,72,55149,1.30555404449763
23500,"Gaffney, SC",2010,91,0,91,55535,1.6386062843252
23500,"Gaffney, SC",2011,71,0,71,55701,1.27466293244286
23500,"Gaffney, SC",2012,72,2,74,55822,1.3256422199133
23500,"Gaffney, SC",2013,84,26,110,56061,1.96214837409251
23500,"Gaffney, SC",2014,83,60,143,56358,2.53735050924447
23500,"Gaffney, SC",2015,87,0,87,56511,1.53952327865371
23500,"Gaffney, SC",2016,109,0,109,56683,1.92297514245894
23500,"Gaffney, SC",2017,128,60,188,56925,3.30259112867809
23500,"Gaffney, SC",2018,118,54,172,57078,3.01342023196328
23540,"Gainesville, FL",1990,920,266,1186,192007,6.17685813538048
23540,"Gainesville, FL",1991,928,436,1364,196194,6.95230231301671
23540,"Gainesville, FL",1992,1096,588,1684,199567,8.43826885206472
23540,"Gainesville, FL",1993,1021,521,1542,202123,7.62901797420383
23540,"Gainesville, FL",1994,1123,520,1643,202435,8.11618544224072
23540,"Gainesville, FL",1995,979,1047,2026,205410,9.86320042841147
23540,"Gainesville, FL",1996,1092,813,1905,206816,9.2110861828872
23540,"Gainesville, FL",1997,1121,606,1727,208373,8.2880219606187
23540,"Gainesville, FL",1998,1156,1294,2450,209403,11.6999278902403
23540,"Gainesville, FL",1999,1245,1549,2794,210362,13.2818664968008
23540,"Gainesville, FL",2000,1142,901,2043,233054,8.76620868983154
23540,"Gainesville, FL",2001,1129,1272,2401,236001,10.1736857047216
23540,"Gainesville, FL",2002,1116,768,1884,239116,7.87902106090768
23540,"Gainesville, FL",2003,1256,507,1763,242033,7.28413067639537
23540,"Gainesville, FL",2004,1435,681,2116,245138,8.6318726594816
23540,"Gainesville, FL",2005,1448,947,2395,249557,9.59700589444496
23540,"Gainesville, FL",2006,1101,940,2041,255729,7.98110499786884
23540,"Gainesville, FL",2007,740,735,1475,259295,5.68850151371989
23540,"Gainesville, FL",2008,482,572,1054,261685,4.02774327913331
23540,"Gainesville, FL",2009,384,145,529,263486,2.00769680362524
23540,"Gainesville, FL",2010,367,123,490,264612,1.85176787144952
23540,"Gainesville, FL",2011,296,168,464,266796,1.73915650909309
23540,"Gainesville, FL",2012,397,227,624,268405,2.32484491719603
23540,"Gainesville, FL",2013,558,242,800,269451,2.96899992948625
23540,"Gainesville, FL",2014,536,263,799,272486,2.93226074000132
23540,"Gainesville, FL",2015,623,591,1214,276546,4.38986642366912
23540,"Gainesville, FL",2016,609,501,1110,281885,3.93777604342196
23540,"Gainesville, FL",2017,684,1585,2269,284685,7.97021269122012
23540,"Gainesville, FL",2018,753,816,1569,288212,5.44390934451029
23580,"Gainesville, GA",1990,617,14,631,95984,6.57401233538923
23580,"Gainesville, GA",1991,610,16,626,98333,6.36612327499415
23580,"Gainesville, GA",1992,831,2,833,99993,8.33058314081986
23580,"Gainesville, GA",1993,962,224,1186,102637,11.5552870797081
23580,"Gainesville, GA",1994,1056,92,1148,105614,10.8697710530801
23580,"Gainesville, GA",1995,1179,35,1214,108819,11.156140012314
23580,"Gainesville, GA",1996,1407,283,1690,112186,15.0642682687679
23580,"Gainesville, GA",1997,1590,369,1959,115843,16.9108189532384
23580,"Gainesville, GA",1998,1735,318,2053,119320,17.2058330539725
23580,"Gainesville, GA",1999,1903,721,2624,123302,21.2810822208885
23580,"Gainesville, GA",2000,1633,488,2121,140993,15.0433000219869
23580,"Gainesville, GA",2001,1611,88,1699,146148,11.6252018501793
23580,"Gainesville, GA",2002,1464,455,1919,150229,12.7738319498898
23580,"Gainesville, GA",2003,1525,305,1830,153561,11.9170883232071
23580,"Gainesville, GA",2004,1736,22,1758,156385,11.2414873549253
23580,"Gainesville, GA",2005,2094,110,2204,160979,13.6912268059809
23580,"Gainesville, GA",2006,1702,152,1854,166524,11.1335303019385
23580,"Gainesville, GA",2007,1283,44,1327,172446,7.69516254363685
23580,"Gainesville, GA",2008,416,322,738,177277,4.16297658466693
23580,"Gainesville, GA",2009,237,2,239,178503,1.33891307148899
23580,"Gainesville, GA",2010,184,0,184,180040,1.02199511219729
23580,"Gainesville, GA",2011,228,0,228,182271,1.25088467172507
23580,"Gainesville, GA",2012,303,0,303,184127,1.64560330641351
23580,"Gainesville, GA",2013,552,0,552,186486,2.96000772175927
23580,"Gainesville, GA",2014,714,8,722,189239,3.81528120524839
23580,"Gainesville, GA",2015,906,40,946,192458,4.91535815606522
23580,"Gainesville, GA",2016,1033,545,1578,196523,8.02959450038927
23580,"Gainesville, GA",2017,1184,179,1363,199439,6.83416984641921
23580,"Gainesville, GA",2018,1159,619,1778,202148,8.79553594396185
23620,"Gainesville, TX",1990,5,0,5,30952,0.161540449728612
23620,"Gainesville, TX",1991,8,0,8,30606,0.2613866562112
23620,"Gainesville, TX",1992,8,0,8,30950,0.258481421647819
23620,"Gainesville, TX",1993,19,0,19,30858,0.615723637306371
23620,"Gainesville, TX",1994,23,0,23,31273,0.735458702395037
23620,"Gainesville, TX",1995,42,2,44,31684,1.38871354626941
23620,"Gainesville, TX",1996,40,2,42,32160,1.30597014925373
23620,"Gainesville, TX",1997,41,0,41,32826,1.24900993115214
23620,"Gainesville, TX",1998,35,0,35,32895,1.0639914880681
23620,"Gainesville, TX",1999,40,2,42,33343,1.25963470593528
23620,"Gainesville, TX",2000,38,12,50,36433,1.37238218098976
23620,"Gainesville, TX",2001,48,16,64,36844,1.73705352296168
23620,"Gainesville, TX",2002,31,12,43,37390,1.15004011767852
23620,"Gainesville, TX",2003,60,0,60,37598,1.59582956540242
23620,"Gainesville, TX",2004,109,16,125,37815,3.3055665741108
23620,"Gainesville, TX",2005,42,4,46,38143,1.20598799255434
23620,"Gainesville, TX",2006,26,148,174,38241,4.55009021730603
23620,"Gainesville, TX",2007,23,6,29,38252,0.758130293840845
23620,"Gainesville, TX",2008,48,0,48,38223,1.25578839965466
23620,"Gainesville, TX",2009,28,0,28,38413,0.7289198969099
23620,"Gainesville, TX",2010,26,0,26,38474,0.675781046940791
23620,"Gainesville, TX",2011,15,0,15,38444,0.390177921132036
23620,"Gainesville, TX",2012,36,0,36,38722,0.929704044212592
23620,"Gainesville, TX",2013,38,0,38,38463,0.987962457426618
23620,"Gainesville, TX",2014,25,0,25,38771,0.644811843903949
23620,"Gainesville, TX",2015,40,0,40,39173,1.02111147984581
23620,"Gainesville, TX",2016,51,0,51,39355,1.29589632829374
23620,"Gainesville, TX",2017,70,0,70,39984,1.75070028011204
23620,"Gainesville, TX",2018,55,0,55,40574,1.35554788780993
23660,"Galesburg, IL",1990,50,0,50,56365,0.887075312694048
23660,"Galesburg, IL",1991,45,0,45,56335,0.798792935120263
23660,"Galesburg, IL",1992,69,4,73,56324,1.2960727221078
23660,"Galesburg, IL",1993,84,4,88,56379,1.56086486102982
23660,"Galesburg, IL",1994,84,0,84,56105,1.49719276356831
23660,"Galesburg, IL",1995,93,0,93,55986,1.66112956810631
23660,"Galesburg, IL",1996,97,0,97,55732,1.74047226010192
23660,"Galesburg, IL",1997,85,0,85,55640,1.52767792954709
23660,"Galesburg, IL",1998,109,0,109,55614,1.95993814507139
23660,"Galesburg, IL",1999,111,0,111,55429,2.00256183586209
23660,"Galesburg, IL",2000,110,0,110,55783,1.9719269311439
23660,"Galesburg, IL",2001,74,152,226,55329,4.08465723219288
23660,"Galesburg, IL",2002,76,0,76,54963,1.3827483943744
23660,"Galesburg, IL",2003,55,0,55,54425,1.01056499770326
23660,"Galesburg, IL",2004,67,0,67,53909,1.24283514811998
23660,"Galesburg, IL",2005,70,0,70,53513,1.30809336049184
23660,"Galesburg, IL",2006,62,0,62,53196,1.16550116550117
23660,"Galesburg, IL",2007,61,0,61,52894,1.15324989601845
23660,"Galesburg, IL",2008,49,0,49,52836,0.927397986221516
23660,"Galesburg, IL",2009,31,0,31,52817,0.58693223772649
23660,"Galesburg, IL",2010,7,0,7,52913,0.132292631300437
23660,"Galesburg, IL",2011,31,0,31,52699,0.588246456289493
23660,"Galesburg, IL",2012,23,0,23,52297,0.439795781784806
23660,"Galesburg, IL",2013,6,2,8,52127,0.153471329637232
23660,"Galesburg, IL",2014,27,0,27,51944,0.519790543662406
23660,"Galesburg, IL",2015,19,0,19,51374,0.369836882469732
23660,"Galesburg, IL",2016,16,0,16,50938,0.314107346185559
23660,"Galesburg, IL",2017,24,0,24,50628,0.474045982460299
23660,"Galesburg, IL",2018,16,6,22,50112,0.439016602809706
23700,"Gallup, NM",1990,9,70,79,61257,1.28964852996392
23700,"Gallup, NM",1991,12,0,12,62804,0.191070632443793
23700,"Gallup, NM",1992,10,0,10,64864,0.15416872224963
23700,"Gallup, NM",1993,25,0,25,64479,0.387723134663999
23700,"Gallup, NM",1994,38,40,78,65301,1.19446869113796
23700,"Gallup, NM",1995,50,0,50,66524,0.751608442066021
23700,"Gallup, NM",1996,36,0,36,67250,0.535315985130111
23700,"Gallup, NM",1997,41,0,41,67205,0.610073655233986
23700,"Gallup, NM",1998,34,0,34,67386,0.504555842459858
23700,"Gallup, NM",1999,43,20,63,66906,0.941619585687382
23700,"Gallup, NM",2000,29,115,144,74563,1.93125276611724
23700,"Gallup, NM",2001,15,0,15,74387,0.20164813744337
23700,"Gallup, NM",2002,28,52,80,72868,1.09787561069331
23700,"Gallup, NM",2003,24,0,24,71545,0.335453211265637
23700,"Gallup, NM",2004,21,0,21,71500,0.293706293706294
23700,"Gallup, NM",2005,21,0,21,70666,0.297172614835989
23700,"Gallup, NM",2006,38,0,38,70541,0.538693809274039
23700,"Gallup, NM",2007,31,30,61,69959,0.871939278720393
23700,"Gallup, NM",2008,5,72,77,70449,1.09298925463811
23700,"Gallup, NM",2009,2,0,2,70567,0.0283418595094024
23700,"Gallup, NM",2010,17,0,17,71672,0.23719165085389
23700,"Gallup, NM",2011,2,0,2,72328,0.0276518084282712
23700,"Gallup, NM",2012,7,0,7,72374,0.096719816508691
23700,"Gallup, NM",2013,9,0,9,72674,0.123840713322509
23700,"Gallup, NM",2014,4,0,4,72807,0.0549397722746439
23700,"Gallup, NM",2015,4,0,4,73461,0.0544506608948966
23700,"Gallup, NM",2016,10,0,10,73106,0.136787678165951
23700,"Gallup, NM",2017,10,0,10,72574,0.137790393253782
23700,"Gallup, NM",2018,4,0,4,72290,0.0553326877853092
23780,"Garden City, KS",1990,39,20,59,37149,1.58819887480148
23780,"Garden City, KS",1991,74,15,89,37588,2.36777695009045
23780,"Garden City, KS",1992,78,2,80,38194,2.09456982772163
23780,"Garden City, KS",1993,102,67,169,38585,4.37994039134379
23780,"Garden City, KS",1994,118,105,223,38959,5.72396622089889
23780,"Garden City, KS",1995,99,115,214,39319,5.44266130878201
23780,"Garden City, KS",1996,116,79,195,39657,4.91716468719268
23780,"Garden City, KS",1997,50,91,141,40172,3.50990739818779
23780,"Garden City, KS",1998,13,0,13,40818,0.318486942035377
23780,"Garden City, KS",1999,44,40,84,41546,2.02185529292832
23780,"Garden City, KS",2000,55,26,81,45005,1.79980002221975
23780,"Garden City, KS",2001,54,12,66,44219,1.49257106673602
23780,"Garden City, KS",2002,66,14,80,42870,1.86610683461628
23780,"Garden City, KS",2003,34,0,34,41950,0.810488676996424
23780,"Garden City, KS",2004,40,0,40,41693,0.959393663204855
23780,"Garden City, KS",2005,17,0,17,40901,0.415637759467984
23780,"Garden City, KS",2006,15,0,15,40311,0.372106869092803
23780,"Garden City, KS",2007,9,0,9,39591,0.227324391907252
23780,"Garden City, KS",2008,11,14,25,39370,0.63500127000254
23780,"Garden City, KS",2009,15,0,15,40241,0.372754156208842
23780,"Garden City, KS",2010,12,10,22,40955,0.537174948113783
23780,"Garden City, KS",2011,10,35,45,41077,1.09550356647272
23780,"Garden City, KS",2012,14,9,23,41098,0.559637938585819
23780,"Garden City, KS",2013,34,76,110,41009,2.68233802336073
23780,"Garden City, KS",2014,10,4,14,41087,0.34074038016891
23780,"Garden City, KS",2015,73,68,141,41144,3.42698813921836
23780,"Garden City, KS",2016,31,2,33,40865,0.807537012113055
23780,"Garden City, KS",2017,29,4,33,40793,0.808962321967004
23780,"Garden City, KS",2018,48,0,48,40554,1.1836070424619
23820,"Gardnerville Ranchos, NV",1990,551,66,617,27953,22.0727649983902
23820,"Gardnerville Ranchos, NV",1991,415,54,469,29762,15.7583495732814
23820,"Gardnerville Ranchos, NV",1992,498,210,708,31120,22.7506426735218
23820,"Gardnerville Ranchos, NV",1993,508,44,552,32227,17.128494740435
23820,"Gardnerville Ranchos, NV",1994,625,85,710,33245,21.3565949766882
23820,"Gardnerville Ranchos, NV",1995,424,24,448,34613,12.9431138589547
23820,"Gardnerville Ranchos, NV",1996,448,2,450,35441,12.6971586580514
23820,"Gardnerville Ranchos, NV",1997,421,0,421,36056,11.6762813401376
23820,"Gardnerville Ranchos, NV",1998,435,4,439,36775,11.9374575118967
23820,"Gardnerville Ranchos, NV",1999,485,0,485,37534,12.9216177332552
23820,"Gardnerville Ranchos, NV",2000,542,104,646,41443,15.5876746374539
23820,"Gardnerville Ranchos, NV",2001,571,51,622,42327,14.6951118671297
23820,"Gardnerville Ranchos, NV",2002,672,4,676,43436,15.5631273597937
23820,"Gardnerville Ranchos, NV",2003,527,102,629,44524,14.1272122900009
23820,"Gardnerville Ranchos, NV",2004,507,46,553,46388,11.9211865137536
23820,"Gardnerville Ranchos, NV",2005,539,74,613,46731,13.1176306948278
23820,"Gardnerville Ranchos, NV",2006,588,2,590,46855,12.5920392700886
23820,"Gardnerville Ranchos, NV",2007,160,28,188,47166,3.98592206250265
23820,"Gardnerville Ranchos, NV",2008,46,22,68,47270,1.43854453141527
23820,"Gardnerville Ranchos, NV",2009,44,0,44,46965,0.936867880336421
23820,"Gardnerville Ranchos, NV",2010,38,18,56,47034,1.1906280562997
23820,"Gardnerville Ranchos, NV",2011,34,2,36,46969,0.766462986224957
23820,"Gardnerville Ranchos, NV",2012,47,0,47,46911,1.00189720960969
23820,"Gardnerville Ranchos, NV",2013,112,30,142,46938,3.0252673739827
23820,"Gardnerville Ranchos, NV",2014,156,0,156,47382,3.2923895150057
23820,"Gardnerville Ranchos, NV",2015,138,2,140,47424,2.95209176788124
23820,"Gardnerville Ranchos, NV",2016,162,0,162,47848,3.38572145126233
23820,"Gardnerville Ranchos, NV",2017,173,24,197,48018,4.10262818109875
23820,"Gardnerville Ranchos, NV",2018,235,0,235,48467,4.84865991293045
23860,"Georgetown, SC",1990,404,4,408,46648,8.74635568513119
23860,"Georgetown, SC",1991,321,52,373,47709,7.81823136095915
23860,"Georgetown, SC",1992,320,0,320,48646,6.57813592073346
23860,"Georgetown, SC",1993,315,64,379,49294,7.68856250253581
23860,"Georgetown, SC",1994,386,202,588,49863,11.7923109319536
23860,"Georgetown, SC",1995,458,102,560,50709,11.0434045238518
23860,"Georgetown, SC",1996,570,69,639,51557,12.3940493046531
23860,"Georgetown, SC",1997,546,618,1164,52399,22.2141643924502
23860,"Georgetown, SC",1998,632,266,898,53694,16.7244012366372
23860,"Georgetown, SC",1999,613,256,869,54795,15.8591112327767
23860,"Georgetown, SC",2000,483,164,647,56080,11.537089871612
23860,"Georgetown, SC",2001,478,51,529,56800,9.31338028169014
23860,"Georgetown, SC",2002,537,129,666,57688,11.5448620163639
23860,"Georgetown, SC",2003,508,219,727,58387,12.4514018531522
23860,"Georgetown, SC",2004,604,183,787,59176,13.2993105312965
23860,"Georgetown, SC",2005,740,313,1053,59521,17.6912350262932
23860,"Georgetown, SC",2006,642,114,756,59821,12.6377024790625
23860,"Georgetown, SC",2007,353,52,405,60277,6.71898070574183
23860,"Georgetown, SC",2008,239,0,239,60621,3.94252816680688
23860,"Georgetown, SC",2009,129,4,133,60369,2.20311749407809
23860,"Georgetown, SC",2010,140,0,140,60347,2.31991648300661
23860,"Georgetown, SC",2011,149,0,149,60188,2.47557652688243
23860,"Georgetown, SC",2012,182,48,230,60258,3.81692057486143
23860,"Georgetown, SC",2013,222,42,264,60501,4.36356423860763
23860,"Georgetown, SC",2014,296,0,296,60850,4.86442070665571
23860,"Georgetown, SC",2015,273,26,299,61483,4.8631328985248
23860,"Georgetown, SC",2016,330,36,366,61604,5.94117265112655
23860,"Georgetown, SC",2017,323,240,563,61841,9.10399249688718
23860,"Georgetown, SC",2018,339,29,368,62249,5.91174155408119
23900,"Gettysburg, PA",1990,654,0,654,78730,8.30687158643465
23900,"Gettysburg, PA",1991,482,49,531,80190,6.62177328843996
23900,"Gettysburg, PA",1992,470,68,538,81148,6.62986148765219
23900,"Gettysburg, PA",1993,458,10,468,82102,5.70022654746535
23900,"Gettysburg, PA",1994,538,22,560,82981,6.7485327966643
23900,"Gettysburg, PA",1995,580,35,615,83563,7.35971662099254
23900,"Gettysburg, PA",1996,592,16,608,84445,7.19995263189058
23900,"Gettysburg, PA",1997,562,12,574,85624,6.70372792674951
23900,"Gettysburg, PA",1998,572,16,588,86623,6.78803551019937
23900,"Gettysburg, PA",1999,618,94,712,87582,8.12952433148364
23900,"Gettysburg, PA",2000,600,39,639,91457,6.98689001388631
23900,"Gettysburg, PA",2001,576,0,576,92591,6.22090699960039
23900,"Gettysburg, PA",2002,646,8,654,93934,6.96233525666958
23900,"Gettysburg, PA",2003,522,10,532,95503,5.57050563856633
23900,"Gettysburg, PA",2004,635,40,675,97300,6.93730729701953
23900,"Gettysburg, PA",2005,602,4,606,98606,6.1456706488449
23900,"Gettysburg, PA",2006,541,0,541,99899,5.41546962432056
23900,"Gettysburg, PA",2007,384,4,388,100502,3.86061968916041
23900,"Gettysburg, PA",2008,278,0,278,101056,2.75094996833439
23900,"Gettysburg, PA",2009,198,0,198,101252,1.95551692806068
23900,"Gettysburg, PA",2010,284,22,306,101473,3.0155804992461
23900,"Gettysburg, PA",2011,146,2,148,101457,1.45874606976355
23900,"Gettysburg, PA",2012,167,0,167,101242,1.64951304794453
23900,"Gettysburg, PA",2013,200,0,200,101132,1.97761341612941
23900,"Gettysburg, PA",2014,222,50,272,101350,2.68376911692156
23900,"Gettysburg, PA",2015,218,22,240,101776,2.35811979248546
23900,"Gettysburg, PA",2016,347,0,347,101812,3.40824264330334
23900,"Gettysburg, PA",2017,249,0,249,102367,2.43242451180556
23900,"Gettysburg, PA",2018,224,0,224,102811,2.1787551915651
23940,"Gillette, WY",1990,15,0,15,29402,0.510169376232909
23940,"Gillette, WY",1991,20,0,20,29821,0.670668320981858
23940,"Gillette, WY",1992,82,0,82,30507,2.68790769331629
23940,"Gillette, WY",1993,41,0,41,30530,1.3429413691451
23940,"Gillette, WY",1994,48,0,48,30817,1.5575818541714
23940,"Gillette, WY",1995,53,0,53,31418,1.68693105862881
23940,"Gillette, WY",1996,68,0,68,31919,2.13039255615777
23940,"Gillette, WY",1997,38,0,38,32068,1.18498191343395
23940,"Gillette, WY",1998,50,0,50,32418,1.54235301375779
23940,"Gillette, WY",1999,40,0,40,32806,1.21928915442297
23940,"Gillette, WY",2000,61,0,61,33979,1.79522646340387
23940,"Gillette, WY",2001,105,0,105,34699,3.0260238047206
23940,"Gillette, WY",2002,144,0,144,36193,3.97866990854585
23940,"Gillette, WY",2003,159,0,159,36586,4.34592467063904
23940,"Gillette, WY",2004,129,0,129,36907,3.49527189963964
23940,"Gillette, WY",2005,200,73,273,37888,7.20544763513514
23940,"Gillette, WY",2006,161,61,222,39497,5.62068005164949
23940,"Gillette, WY",2007,398,604,1002,41651,24.0570454490889
23940,"Gillette, WY",2008,277,72,349,42846,8.1454511506325
23940,"Gillette, WY",2009,249,100,349,45650,7.64512595837897
23940,"Gillette, WY",2010,269,48,317,46245,6.85479511298519
23940,"Gillette, WY",2011,201,0,201,46543,4.31858711299229
23940,"Gillette, WY",2012,179,0,179,47855,3.74046599101452
23940,"Gillette, WY",2013,122,0,122,48038,2.53965610558308
23940,"Gillette, WY",2014,163,0,163,48132,3.38652040222721
23940,"Gillette, WY",2015,109,0,109,49269,2.21234447624267
23940,"Gillette, WY",2016,53,0,53,48746,1.08726869897017
23940,"Gillette, WY",2017,57,0,57,46251,1.23240578582085
23940,"Gillette, WY",2018,84,0,84,46140,1.82054616384915
23980,"Glasgow, KY",1990,41,13,54,34086,1.58422812885055
23980,"Glasgow, KY",1991,32,8,40,34294,1.16638479034233
23980,"Glasgow, KY",1992,65,27,92,34434,2.67177789394203
23980,"Glasgow, KY",1993,60,11,71,34862,2.036601457174
23980,"Glasgow, KY",1994,60,36,96,35064,2.7378507871321
23980,"Glasgow, KY",1995,47,22,69,35738,1.93071800324584
23980,"Glasgow, KY",1996,28,24,52,36236,1.43503697979909
23980,"Glasgow, KY",1997,35,32,67,36668,1.82720628340788
23980,"Glasgow, KY",1998,41,23,64,36955,1.73183601677716
23980,"Glasgow, KY",1999,112,40,152,37368,4.0676514664954
23980,"Glasgow, KY",2000,45,16,61,38128,1.59987410826689
23980,"Glasgow, KY",2001,54,63,117,38517,3.03761975231716
23980,"Glasgow, KY",2002,40,11,51,38704,1.31769326167838
23980,"Glasgow, KY",2003,72,0,72,39164,1.83842304156879
23980,"Glasgow, KY",2004,39,16,55,39601,1.38885381682281
23980,"Glasgow, KY",2005,352,4,356,40320,8.82936507936508
23980,"Glasgow, KY",2006,259,16,275,40857,6.73079276500967
23980,"Glasgow, KY",2007,238,40,278,41435,6.70930372873175
23980,"Glasgow, KY",2008,138,38,176,41797,4.21082852836328
23980,"Glasgow, KY",2009,88,42,130,42171,3.08268715467976
23980,"Glasgow, KY",2010,152,4,156,42123,3.7034399259312
23980,"Glasgow, KY",2011,44,4,48,42329,1.13397434383047
23980,"Glasgow, KY",2012,41,10,51,42620,1.19662130455185
23980,"Glasgow, KY",2013,120,12,132,42952,3.07319798845223
23980,"Glasgow, KY",2014,80,6,86,43048,1.99776993123955
23980,"Glasgow, KY",2015,80,4,84,43566,1.92810907588486
23980,"Glasgow, KY",2016,55,6,61,43794,1.39288487007353
23980,"Glasgow, KY",2017,128,16,144,43815,3.28654570352619
23980,"Glasgow, KY",2018,198,0,198,44176,4.48207171314741
24020,"Glens Falls, NY",1990,662,78,740,118968,6.22016004303678
24020,"Glens Falls, NY",1991,600,68,668,119988,5.56722338900557
24020,"Glens Falls, NY",1992,554,35,589,120748,4.8779275847219
24020,"Glens Falls, NY",1993,502,63,565,121781,4.63947578029413
24020,"Glens Falls, NY",1994,501,34,535,121749,4.39428660605015
24020,"Glens Falls, NY",1995,422,10,432,122214,3.53478324905494
24020,"Glens Falls, NY",1996,415,26,441,122091,3.61205985699192
24020,"Glens Falls, NY",1997,366,46,412,121648,3.3868209917138
24020,"Glens Falls, NY",1998,437,48,485,121434,3.99393909448754
24020,"Glens Falls, NY",1999,446,103,549,121821,4.50661216046494
24020,"Glens Falls, NY",2000,485,65,550,124250,4.42655935613682
24020,"Glens Falls, NY",2001,407,38,445,124548,3.57291967755404
24020,"Glens Falls, NY",2002,610,126,736,124926,5.89148776075437
24020,"Glens Falls, NY",2003,646,132,778,125944,6.1773486628978
24020,"Glens Falls, NY",2004,717,92,809,126854,6.37741025115487
24020,"Glens Falls, NY",2005,708,474,1182,127674,9.25795385121481
24020,"Glens Falls, NY",2006,571,138,709,128325,5.52503409312293
24020,"Glens Falls, NY",2007,452,45,497,128794,3.85887541345094
24020,"Glens Falls, NY",2008,316,41,357,129100,2.76529821843532
24020,"Glens Falls, NY",2009,282,43,325,128771,2.52386018591142
24020,"Glens Falls, NY",2010,255,24,279,129013,2.16257276398502
24020,"Glens Falls, NY",2011,222,20,242,128807,1.87877987997547
24020,"Glens Falls, NY",2012,235,61,296,128398,2.30533185875169
24020,"Glens Falls, NY",2013,210,41,251,127834,1.96348389317396
24020,"Glens Falls, NY",2014,260,108,368,127334,2.890037224936
24020,"Glens Falls, NY",2015,203,178,381,126636,3.00862314033924
24020,"Glens Falls, NY",2016,216,143,359,126195,2.84480367684932
24020,"Glens Falls, NY",2017,260,4,264,125917,2.09661920153752
24020,"Glens Falls, NY",2018,225,2,227,125462,1.80931277996525
24060,"Glenwood Springs, CO",1990,340,56,396,43056,9.19732441471572
24060,"Glenwood Springs, CO",1991,193,10,203,43845,4.6299464020983
24060,"Glenwood Springs, CO",1992,352,110,462,43992,10.5019094380797
24060,"Glenwood Springs, CO",1993,469,65,534,45704,11.6838788727464
24060,"Glenwood Springs, CO",1994,575,153,728,47604,15.2928325350811
24060,"Glenwood Springs, CO",1995,452,37,489,49014,9.97674133920921
24060,"Glenwood Springs, CO",1996,430,127,557,49974,11.1457958138232
24060,"Glenwood Springs, CO",1997,434,156,590,51305,11.4998538154176
24060,"Glenwood Springs, CO",1998,489,169,658,52704,12.4848208864602
24060,"Glenwood Springs, CO",1999,718,180,898,53941,16.6478189132571
24060,"Glenwood Springs, CO",2000,715,233,948,59074,16.0476690252903
24060,"Glenwood Springs, CO",2001,604,62,666,60649,10.9812198057676
24060,"Glenwood Springs, CO",2002,538,112,650,62023,10.4799832320268
24060,"Glenwood Springs, CO",2003,413,54,467,62839,7.43169051067013
24060,"Glenwood Springs, CO",2004,522,88,610,63413,9.61947865579613
24060,"Glenwood Springs, CO",2005,697,36,733,64978,11.2807411739358
24060,"Glenwood Springs, CO",2006,774,195,969,67098,14.4415630868282
24060,"Glenwood Springs, CO",2007,626,147,773,69348,11.1466805098921
24060,"Glenwood Springs, CO",2008,367,150,517,71903,7.19024240991336
24060,"Glenwood Springs, CO",2009,99,6,105,74097,1.41706141949067
24060,"Glenwood Springs, CO",2010,81,0,81,73252,1.10577185605854
24060,"Glenwood Springs, CO",2011,62,4,66,73240,0.901146914254506
24060,"Glenwood Springs, CO",2012,59,60,119,74087,1.60621971465979
24060,"Glenwood Springs, CO",2013,105,5,110,74440,1.47770016120365
24060,"Glenwood Springs, CO",2014,143,38,181,74927,2.41568459967702
24060,"Glenwood Springs, CO",2015,200,41,241,75708,3.18328314048713
24060,"Glenwood Springs, CO",2016,187,23,210,76814,2.73387663707137
24060,"Glenwood Springs, CO",2017,168,79,247,77065,3.20508661519497
24060,"Glenwood Springs, CO",2018,169,103,272,77720,3.49974266598044
24100,"Gloversville, NY",1990,72,2,74,54281,1.36327628451945
24100,"Gloversville, NY",1991,110,0,110,54466,2.01960856314031
24100,"Gloversville, NY",1992,106,0,106,54314,1.95161468497993
24100,"Gloversville, NY",1993,111,21,132,54397,2.42660440833134
24100,"Gloversville, NY",1994,111,2,113,54285,2.08160633692549
24100,"Gloversville, NY",1995,93,0,93,54051,1.72059721374258
24100,"Gloversville, NY",1996,78,0,78,53998,1.44449794436831
24100,"Gloversville, NY",1997,63,0,63,53503,1.17750406519261
24100,"Gloversville, NY",1998,66,4,70,53161,1.31675476383063
24100,"Gloversville, NY",1999,92,24,116,52985,2.18929885816741
24100,"Gloversville, NY",2000,95,19,114,54976,2.07363213038417
24100,"Gloversville, NY",2001,96,0,96,54904,1.74850648404488
24100,"Gloversville, NY",2002,103,0,103,54988,1.87313595693606
24100,"Gloversville, NY",2003,112,0,112,55081,2.03336903832538
24100,"Gloversville, NY",2004,105,0,105,55233,1.90103742327956
24100,"Gloversville, NY",2005,110,0,110,55301,1.98911412090197
24100,"Gloversville, NY",2006,122,0,122,55328,2.20503181029497
24100,"Gloversville, NY",2007,94,0,94,55489,1.69402944727784
24100,"Gloversville, NY",2008,101,0,101,55584,1.81706966033391
24100,"Gloversville, NY",2009,77,0,77,55558,1.38593901868318
24100,"Gloversville, NY",2010,92,0,92,55462,1.65879340809924
24100,"Gloversville, NY",2011,88,0,88,55115,1.59666152590039
24100,"Gloversville, NY",2012,57,116,173,54853,3.15388401728256
24100,"Gloversville, NY",2013,68,42,110,54359,2.02358395113965
24100,"Gloversville, NY",2014,72,0,72,53945,1.33469274260821
24100,"Gloversville, NY",2015,55,0,55,53800,1.02230483271375
24100,"Gloversville, NY",2016,69,0,69,53604,1.28721737183792
24100,"Gloversville, NY",2017,48,0,48,53777,0.892574892612083
24100,"Gloversville, NY",2018,51,0,51,53591,0.951652329682223
24140,"Goldsboro, NC",1990,298,68,366,104850,3.49070100143062
24140,"Goldsboro, NC",1991,299,17,316,106313,2.9723552152606
24140,"Goldsboro, NC",1992,411,52,463,107191,4.31939248630948
24140,"Goldsboro, NC",1993,444,98,542,107760,5.02969561989607
24140,"Goldsboro, NC",1994,488,88,576,108649,5.30147539323878
24140,"Goldsboro, NC",1995,434,105,539,110561,4.87513680230823
24140,"Goldsboro, NC",1996,424,42,466,111675,4.17282292366241
24140,"Goldsboro, NC",1997,429,30,459,111945,4.1002277904328
24140,"Goldsboro, NC",1998,334,44,378,111815,3.38058400035773
24140,"Goldsboro, NC",1999,529,26,555,111374,4.98320972578878
24140,"Goldsboro, NC",2000,357,71,428,113648,3.76601436012952
24140,"Goldsboro, NC",2001,421,0,421,113934,3.69512173714607
24140,"Goldsboro, NC",2002,425,8,433,114305,3.78811075630987
24140,"Goldsboro, NC",2003,629,61,690,114595,6.02120511366115
24140,"Goldsboro, NC",2004,533,7,540,116484,4.63582981353662
24140,"Goldsboro, NC",2005,603,4,607,117009,5.18763513917733
24140,"Goldsboro, NC",2006,514,8,522,117534,4.44126805860432
24140,"Goldsboro, NC",2007,469,0,469,118942,3.94309831682669
24140,"Goldsboro, NC",2008,298,92,390,119910,3.25243932949712
24140,"Goldsboro, NC",2009,259,0,259,121217,2.13666399927403
24140,"Goldsboro, NC",2010,223,56,279,122900,2.27013832384052
24140,"Goldsboro, NC",2011,205,0,205,124040,1.65269267978072
24140,"Goldsboro, NC",2012,201,62,263,124574,2.11119495239777
24140,"Goldsboro, NC",2013,273,4,277,124622,2.22272150984577
24140,"Goldsboro, NC",2014,257,0,257,124631,2.06208728165545
24140,"Goldsboro, NC",2015,244,4,248,124428,1.99312051949722
24140,"Goldsboro, NC",2016,260,9,269,124448,2.16154538441759
24140,"Goldsboro, NC",2017,272,8,280,123257,2.27167625368133
24140,"Goldsboro, NC",2018,269,6,275,123248,2.23127352979359
24220,"Grand Forks, ND-MN",1990,121,12,133,103095,1.29007226344634
24220,"Grand Forks, ND-MN",1991,134,15,149,102628,1.45184550025334
24220,"Grand Forks, ND-MN",1992,218,132,350,103441,3.38357131118222
24220,"Grand Forks, ND-MN",1993,242,179,421,103375,4.07255139056832
24220,"Grand Forks, ND-MN",1994,256,7,263,104187,2.52430725522378
24220,"Grand Forks, ND-MN",1995,159,316,475,103906,4.57143957038092
24220,"Grand Forks, ND-MN",1996,213,55,268,103378,2.59242778927818
24220,"Grand Forks, ND-MN",1997,415,147,562,101297,5.54804189660108
24220,"Grand Forks, ND-MN",1998,326,79,405,97377,4.15909300964293
24220,"Grand Forks, ND-MN",1999,195,115,310,95125,3.25886990801577
24220,"Grand Forks, ND-MN",2000,151,4,155,97405,1.59129408141266
24220,"Grand Forks, ND-MN",2001,164,38,202,96663,2.08973443820283
24220,"Grand Forks, ND-MN",2002,229,142,371,96367,3.84986561789824
24220,"Grand Forks, ND-MN",2003,374,300,674,96267,7.00136079861219
24220,"Grand Forks, ND-MN",2004,363,227,590,98164,6.01035002648629
24220,"Grand Forks, ND-MN",2005,335,312,647,97777,6.61709809055299
24220,"Grand Forks, ND-MN",2006,243,243,486,98266,4.94575946919586
24220,"Grand Forks, ND-MN",2007,252,152,404,97606,4.13908981005266
24220,"Grand Forks, ND-MN",2008,167,207,374,98092,3.81274721689842
24220,"Grand Forks, ND-MN",2009,166,159,325,97941,3.31832429728102
24220,"Grand Forks, ND-MN",2010,154,46,200,98631,2.02776003487747
24220,"Grand Forks, ND-MN",2011,142,249,391,98179,3.98252172053087
24220,"Grand Forks, ND-MN",2012,219,296,515,99086,5.1975051975052
24220,"Grand Forks, ND-MN",2013,274,834,1108,100737,10.9989378282061
24220,"Grand Forks, ND-MN",2014,314,685,999,101262,9.8654974225277
24220,"Grand Forks, ND-MN",2015,245,284,529,101881,5.19233223073979
24220,"Grand Forks, ND-MN",2016,211,232,443,102233,4.33323877808535
24220,"Grand Forks, ND-MN",2017,227,190,417,102277,4.07716299852362
24220,"Grand Forks, ND-MN",2018,254,101,355,102299,3.47021965024096
24260,"Grand Island, NE",1990,136,10,146,72021,2.02718651504422
24260,"Grand Island, NE",1991,189,41,230,72499,3.17245755113864
24260,"Grand Island, NE",1992,239,44,283,73020,3.87565050671049
24260,"Grand Island, NE",1993,283,65,348,73807,4.71499993225575
24260,"Grand Island, NE",1994,259,125,384,74204,5.17492318473398
24260,"Grand Island, NE",1995,271,124,395,74869,5.27588187367268
24260,"Grand Island, NE",1996,246,290,536,75217,7.12604863262294
24260,"Grand Island, NE",1997,243,69,312,75510,4.13190305919746
24260,"Grand Island, NE",1998,214,166,380,75796,5.01345717452108
24260,"Grand Island, NE",1999,219,34,253,75923,3.33232353832172
24260,"Grand Island, NE",2000,182,72,254,77621,3.27231032839051
24260,"Grand Island, NE",2001,189,16,205,77308,2.65173073938014
24260,"Grand Island, NE",2002,175,174,349,77526,4.50171555349173
24260,"Grand Island, NE",2003,205,77,282,77941,3.61812139952015
24260,"Grand Island, NE",2004,218,94,312,78215,3.98900466662405
24260,"Grand Island, NE",2005,223,64,287,78140,3.67289480419759
24260,"Grand Island, NE",2006,199,135,334,78556,4.25174397881766
24260,"Grand Island, NE",2007,324,156,480,78988,6.07687243631944
24260,"Grand Island, NE",2008,149,34,183,79947,2.28901647341364
24260,"Grand Island, NE",2009,176,36,212,81169,2.6118345673841
24260,"Grand Island, NE",2010,169,22,191,82054,2.32773539376508
24260,"Grand Island, NE",2011,144,57,201,82612,2.43306057231395
24260,"Grand Island, NE",2012,192,250,442,83272,5.30790661927178
24260,"Grand Island, NE",2013,205,95,300,83775,3.5810205908684
24260,"Grand Island, NE",2014,248,56,304,84342,3.60437267316402
24260,"Grand Island, NE",2015,222,78,300,84472,3.55147267733687
24260,"Grand Island, NE",2016,197,189,386,84875,4.54786450662739
24260,"Grand Island, NE",2017,196,86,282,84862,3.32304211543447
24260,"Grand Island, NE",2018,166,39,205,85088,2.40927040240692
24300,"Grand Junction, CO",1990,265,2,267,93764,2.84757476216885
24300,"Grand Junction, CO",1991,343,0,343,96383,3.55871886120996
24300,"Grand Junction, CO",1992,535,28,563,98040,5.74255405956752
24300,"Grand Junction, CO",1993,773,18,791,100674,7.85704352663051
24300,"Grand Junction, CO",1994,882,42,924,103502,8.92736372244015
24300,"Grand Junction, CO",1995,832,109,941,106132,8.86631741604794
24300,"Grand Junction, CO",1996,917,127,1044,108331,9.63713064589084
24300,"Grand Junction, CO",1997,965,149,1114,110806,10.053607205386
24300,"Grand Junction, CO",1998,1105,181,1286,112967,11.3838554622146
24300,"Grand Junction, CO",1999,1232,130,1362,115151,11.8279476513448
24300,"Grand Junction, CO",2000,1132,184,1316,117631,11.1875270974488
24300,"Grand Junction, CO",2001,1146,107,1253,119496,10.4857066345317
24300,"Grand Junction, CO",2002,1287,83,1370,122440,11.1891538712839
24300,"Grand Junction, CO",2003,1428,161,1589,124994,12.7126102052899
24300,"Grand Junction, CO",2004,1366,185,1551,127678,12.1477466752299
24300,"Grand Junction, CO",2005,1471,34,1505,130194,11.5596724887476
24300,"Grand Junction, CO",2006,1426,148,1574,134665,11.6882634686073
24300,"Grand Junction, CO",2007,1310,56,1366,139434,9.79674971671185
24300,"Grand Junction, CO",2008,692,92,784,143155,5.47658132793126
24300,"Grand Junction, CO",2009,363,2,365,147851,2.46870159823065
24300,"Grand Junction, CO",2010,348,60,408,146361,2.7876278516818
24300,"Grand Junction, CO",2011,289,70,359,147285,2.43745120005432
24300,"Grand Junction, CO",2012,323,32,355,147437,2.40780808073957
24300,"Grand Junction, CO",2013,440,2,442,147313,3.0004140842967
24300,"Grand Junction, CO",2014,452,52,504,147312,3.42130987292278
24300,"Grand Junction, CO",2015,446,40,486,148227,3.27875488271368
24300,"Grand Junction, CO",2016,498,99,597,149838,3.98430304729107
24300,"Grand Junction, CO",2017,665,90,755,151406,4.98659234112254
24300,"Grand Junction, CO",2018,822,8,830,153207,5.41750703296847
24340,"Grand Rapids-Wyoming, MI",1990,3372,1999,5371,794842,6.75731780655778
24340,"Grand Rapids-Wyoming, MI",1991,3056,458,3514,807710,4.35057136843669
24340,"Grand Rapids-Wyoming, MI",1992,3767,872,4639,818011,5.67107288288299
24340,"Grand Rapids-Wyoming, MI",1993,4009,573,4582,827960,5.53408377216291
24340,"Grand Rapids-Wyoming, MI",1994,4728,1080,5808,839221,6.92070384320697
24340,"Grand Rapids-Wyoming, MI",1995,4661,1511,6172,851836,7.2455261341385
24340,"Grand Rapids-Wyoming, MI",1996,5270,1682,6952,864492,8.04171698523526
24340,"Grand Rapids-Wyoming, MI",1997,4451,1847,6298,875737,7.19165685588253
24340,"Grand Rapids-Wyoming, MI",1998,4849,1816,6665,885501,7.52681250501129
24340,"Grand Rapids-Wyoming, MI",1999,5094,1053,6147,896825,6.85418002397346
24340,"Grand Rapids-Wyoming, MI",2000,4776,916,5692,934152,6.09322679820843
24340,"Grand Rapids-Wyoming, MI",2001,5084,995,6079,944552,6.4358553049488
24340,"Grand Rapids-Wyoming, MI",2002,5093,1190,6283,952185,6.59850764294754
24340,"Grand Rapids-Wyoming, MI",2003,5336,1102,6438,959259,6.71143038532868
24340,"Grand Rapids-Wyoming, MI",2004,5401,1204,6605,965089,6.84392838380709
24340,"Grand Rapids-Wyoming, MI",2005,4899,570,5469,970713,5.63400304724465
24340,"Grand Rapids-Wyoming, MI",2006,3434,631,4065,976610,4.16235754292911
24340,"Grand Rapids-Wyoming, MI",2007,2226,502,2728,981643,2.77901436673006
24340,"Grand Rapids-Wyoming, MI",2008,1415,261,1676,984563,1.70227806651276
24340,"Grand Rapids-Wyoming, MI",2009,1117,74,1191,987281,1.20634348275719
24340,"Grand Rapids-Wyoming, MI",2010,1227,44,1271,989517,1.28446504708863
24340,"Grand Rapids-Wyoming, MI",2011,1305,184,1489,997545,1.49266449132621
24340,"Grand Rapids-Wyoming, MI",2012,1696,339,2035,1008798,2.01725221501232
24340,"Grand Rapids-Wyoming, MI",2013,2084,219,2303,1020647,2.25641186423906
24340,"Grand Rapids-Wyoming, MI",2014,2273,898,3171,1031438,3.07434862783803
24340,"Grand Rapids-Wyoming, MI",2015,2495,1177,3672,1040441,3.52927268341021
24340,"Grand Rapids-Wyoming, MI",2016,2649,2068,4717,1050591,4.48985380609581
24340,"Grand Rapids-Wyoming, MI",2017,2953,1886,4839,1060326,4.56369078943646
24340,"Grand Rapids-Wyoming, MI",2018,2749,1105,3854,1069405,3.60387318181606
24380,"Grants, NM",2003,0,0,0,26940,0
24420,"Grants Pass, OR",1990,439,175,614,62978,9.74943631109276
24420,"Grants Pass, OR",1991,363,250,613,64540,9.49798574527425
24420,"Grants Pass, OR",1992,415,170,585,65442,8.93921334922527
24420,"Grants Pass, OR",1993,331,309,640,67404,9.49498546080351
24420,"Grants Pass, OR",1994,428,201,629,69277,9.07949247224909
24420,"Grants Pass, OR",1995,355,66,421,71150,5.91707659873507
24420,"Grants Pass, OR",1996,302,44,346,72114,4.79795878747539
24420,"Grants Pass, OR",1997,292,43,335,73213,4.57569010967998
24420,"Grants Pass, OR",1998,326,62,388,74192,5.22967435842139
24420,"Grants Pass, OR",1999,365,75,440,74913,5.87347990335456
24420,"Grants Pass, OR",2000,367,57,424,75851,5.58990652727057
24420,"Grants Pass, OR",2001,396,15,411,76452,5.37592214722963
24420,"Grants Pass, OR",2002,407,113,520,77712,6.69137327568458
24420,"Grants Pass, OR",2003,495,129,624,78779,7.92089262366874
24420,"Grants Pass, OR",2004,635,125,760,79729,9.53229063452445
24420,"Grants Pass, OR",2005,722,127,849,80660,10.5256632779569
24420,"Grants Pass, OR",2006,543,84,627,81601,7.68372936606169
24420,"Grants Pass, OR",2007,385,32,417,81746,5.10116702957943
24420,"Grants Pass, OR",2008,180,9,189,82389,2.2939955576594
24420,"Grants Pass, OR",2009,103,2,105,82315,1.27558768146753
24420,"Grants Pass, OR",2010,94,12,106,82875,1.2790346907994
24420,"Grants Pass, OR",2011,68,2,70,82690,0.846535252146572
24420,"Grants Pass, OR",2012,79,2,81,82746,0.978899282140526
24420,"Grants Pass, OR",2013,130,2,132,83119,1.58808455347153
24420,"Grants Pass, OR",2014,145,4,149,83364,1.78734225804904
24420,"Grants Pass, OR",2015,173,64,237,84508,2.80446821602689
24420,"Grants Pass, OR",2016,209,4,213,85489,2.49154862029033
24420,"Grants Pass, OR",2017,228,22,250,86653,2.88507033801484
24420,"Grants Pass, OR",2018,204,23,227,87393,2.59746203929376
24460,"Great Bend, KS",1990,8,0,8,29275,0.273270708795901
24460,"Great Bend, KS",1991,12,0,12,29370,0.408580183861083
24460,"Great Bend, KS",1992,22,0,22,29632,0.74244060475162
24460,"Great Bend, KS",1993,18,0,18,29503,0.610107446700336
24460,"Great Bend, KS",1994,27,35,62,29450,2.10526315789474
24460,"Great Bend, KS",1995,29,0,29,29239,0.991825985840829
24460,"Great Bend, KS",1996,39,0,39,29042,1.34288272157565
24460,"Great Bend, KS",1997,9,0,9,29098,0.309299608220496
24460,"Great Bend, KS",1998,14,0,14,28958,0.483458802403481
24460,"Great Bend, KS",1999,42,12,54,28689,1.88225452263934
24460,"Great Bend, KS",2000,12,0,12,28163,0.426090970422185
24460,"Great Bend, KS",2001,63,0,63,27771,2.2685535270606
24460,"Great Bend, KS",2002,33,4,37,27684,1.33651206473053
24460,"Great Bend, KS",2003,24,26,50,27581,1.81284217396034
24460,"Great Bend, KS",2004,29,12,41,27390,1.49689667761957
24460,"Great Bend, KS",2005,52,0,52,27536,1.88843695525857
24460,"Great Bend, KS",2006,21,0,21,27460,0.764748725418791
24460,"Great Bend, KS",2007,31,8,39,27492,1.41859450021825
24460,"Great Bend, KS",2008,12,0,12,27314,0.439335139488907
24460,"Great Bend, KS",2009,11,4,15,27526,0.544939330087917
24460,"Great Bend, KS",2010,7,0,7,27674,0.25294500252945
24460,"Great Bend, KS",2011,9,0,9,27694,0.324980140102549
24460,"Great Bend, KS",2012,9,0,9,27526,0.32696359805275
24460,"Great Bend, KS",2013,33,0,33,27453,1.20205442028194
24460,"Great Bend, KS",2014,10,48,58,27345,2.1210458950448
24460,"Great Bend, KS",2015,27,0,27,27173,0.993633386081772
24460,"Great Bend, KS",2016,24,0,24,26896,0.892325996430696
24460,"Great Bend, KS",2017,12,64,76,26432,2.87530266343826
24460,"Great Bend, KS",2018,11,0,11,26111,0.421278388418674
24500,"Great Falls, MT",1990,53,2,55,77725,0.707623029913155
24500,"Great Falls, MT",1991,66,24,90,78332,1.14895572690599
24500,"Great Falls, MT",1992,102,32,134,79145,1.69309495230274
24500,"Great Falls, MT",1993,109,2,111,80175,1.3844714686623
24500,"Great Falls, MT",1994,118,20,138,81006,1.70357751277683
24500,"Great Falls, MT",1995,99,28,127,80810,1.57158767479272
24500,"Great Falls, MT",1996,104,30,134,80772,1.65899073936513
24500,"Great Falls, MT",1997,110,55,165,78980,2.0891364902507
24500,"Great Falls, MT",1998,109,167,276,78578,3.51243350556135
24500,"Great Falls, MT",1999,89,12,101,78215,1.29131240810586
24500,"Great Falls, MT",2000,81,18,99,80318,1.23260041335691
24500,"Great Falls, MT",2001,113,54,167,80055,2.08606582974205
24500,"Great Falls, MT",2002,112,8,120,79848,1.50285542530809
24500,"Great Falls, MT",2003,169,32,201,79633,2.52407921339143
24500,"Great Falls, MT",2004,180,44,224,80198,2.79308710940422
24500,"Great Falls, MT",2005,272,44,316,80041,3.94797666196075
24500,"Great Falls, MT",2006,309,11,320,79984,4.00080016003201
24500,"Great Falls, MT",2007,240,76,316,80099,3.94511791657823
24500,"Great Falls, MT",2008,203,2,205,80529,2.54566677842765
24500,"Great Falls, MT",2009,143,44,187,80680,2.31779871095687
24500,"Great Falls, MT",2010,134,16,150,81501,1.84046821511392
24500,"Great Falls, MT",2011,106,38,144,81694,1.76267534947487
24500,"Great Falls, MT",2012,121,8,129,81611,1.58066927252454
24500,"Great Falls, MT",2013,143,4,147,82189,1.78856051296402
24500,"Great Falls, MT",2014,155,308,463,82058,5.64235053255015
24500,"Great Falls, MT",2015,152,74,226,81887,2.75990083896101
24500,"Great Falls, MT",2016,153,89,242,81536,2.96801412872841
24500,"Great Falls, MT",2017,197,8,205,81604,2.51213175824714
24500,"Great Falls, MT",2018,132,12,144,81643,1.76377644133606
24540,"Greeley, CO",1990,246,25,271,131986,2.05324807176519
24540,"Greeley, CO",1991,322,35,357,133377,2.67662340583459
24540,"Greeley, CO",1992,509,12,521,135930,3.83285514603105
24540,"Greeley, CO",1993,840,125,965,140154,6.88528333119283
24540,"Greeley, CO",1994,1078,86,1164,144052,8.080415405548
24540,"Greeley, CO",1995,1284,186,1470,147973,9.93424476086854
24540,"Greeley, CO",1996,1665,191,1856,151064,12.2861833395117
24540,"Greeley, CO",1997,1773,344,2117,155453,13.6182640412215
24540,"Greeley, CO",1998,2773,296,3069,159445,19.2480165574336
24540,"Greeley, CO",1999,3381,176,3557,166032,21.4235809964344
24540,"Greeley, CO",2000,3934,435,4369,182782,23.9027913033012
24540,"Greeley, CO",2001,3944,357,4301,192278,22.3686537201344
24540,"Greeley, CO",2002,3821,590,4411,202234,21.8113670302719
24540,"Greeley, CO",2003,3624,339,3963,208858,18.9746143312681
24540,"Greeley, CO",2004,3806,608,4414,215322,20.4995309350647
24540,"Greeley, CO",2005,4100,179,4279,222879,19.1987580705226
24540,"Greeley, CO",2006,2579,343,2922,230703,12.6656350372557
24540,"Greeley, CO",2007,1556,291,1847,237692,7.77056022078993
24540,"Greeley, CO",2008,852,128,980,243442,4.02559952678667
24540,"Greeley, CO",2009,718,43,761,248193,3.06616222052999
24540,"Greeley, CO",2010,789,74,863,254198,3.39499130598982
24540,"Greeley, CO",2011,792,97,889,258783,3.43531066569288
24540,"Greeley, CO",2012,1182,59,1241,264058,4.6997250604034
24540,"Greeley, CO",2013,1616,319,1935,270126,7.16332378223496
24540,"Greeley, CO",2014,1995,713,2708,276037,9.81027905679311
24540,"Greeley, CO",2015,2624,562,3186,285033,11.17765311385
24540,"Greeley, CO",2016,2463,546,3009,294965,10.201210313088
24540,"Greeley, CO",2017,2777,869,3646,305274,11.9433689079319
24540,"Greeley, CO",2018,3194,913,4107,314305,13.0669254386663
24580,"Green Bay, WI",1990,944,530,1474,244494,6.02877780231826
24580,"Green Bay, WI",1991,1125,743,1868,247889,7.5356308670413
24580,"Green Bay, WI",1992,1519,897,2416,251009,9.62515288296436
24580,"Green Bay, WI",1993,1409,859,2268,254859,8.89903829176133
24580,"Green Bay, WI",1994,1370,1110,2480,258028,9.61136000744105
24580,"Green Bay, WI",1995,1366,1022,2388,261709,9.12463843429152
24580,"Green Bay, WI",1996,1471,709,2180,264782,8.23318805658995
24580,"Green Bay, WI",1997,1368,682,2050,267037,7.67683879013021
24580,"Green Bay, WI",1998,1776,495,2271,268751,8.45020111553073
24580,"Green Bay, WI",1999,1846,727,2573,270847,9.49982831635573
24580,"Green Bay, WI",2000,1691,460,2151,283282,7.59314040426148
24580,"Green Bay, WI",2001,1728,989,2717,285783,9.50721351514961
24580,"Green Bay, WI",2002,1856,944,2800,288713,9.6982124116337
24580,"Green Bay, WI",2003,1990,1121,3111,291169,10.6845165522429
24580,"Green Bay, WI",2004,2251,818,3069,294570,10.4185762297586
24580,"Green Bay, WI",2005,1924,683,2607,296800,8.78369272237197
24580,"Green Bay, WI",2006,1509,596,2105,298702,7.04715736754357
24580,"Green Bay, WI",2007,1559,334,1893,301190,6.28506922540589
24580,"Green Bay, WI",2008,573,311,884,302468,2.92262321964638
24580,"Green Bay, WI",2009,607,230,837,304686,2.74709044721451
24580,"Green Bay, WI",2010,611,523,1134,306758,3.69672510578371
24580,"Green Bay, WI",2011,484,396,880,308594,2.85164325942825
24580,"Green Bay, WI",2012,648,275,923,310602,2.97164860496713
24580,"Green Bay, WI",2013,719,551,1270,311969,4.07091730268071
24580,"Green Bay, WI",2014,641,363,1004,314044,3.19700424144387
24580,"Green Bay, WI",2015,656,362,1018,315694,3.22464158330535
24580,"Green Bay, WI",2016,804,204,1008,317394,3.17586343787217
24580,"Green Bay, WI",2017,828,348,1176,319786,3.67745930090748
24580,"Green Bay, WI",2018,766,435,1201,321591,3.7345572481817
24620,"Greeneville, TN",1990,110,6,116,55960,2.07290922087205
24620,"Greeneville, TN",1991,95,17,112,56492,1.98258160447497
24620,"Greeneville, TN",1992,133,35,168,57002,2.94726500824532
24620,"Greeneville, TN",1993,168,50,218,57545,3.78833956034408
24620,"Greeneville, TN",1994,231,27,258,57086,4.51949689941492
24620,"Greeneville, TN",1995,242,32,274,57794,4.74097657196249
24620,"Greeneville, TN",1996,300,48,348,58248,5.97445405850845
24620,"Greeneville, TN",1997,300,56,356,59290,6.00438522516445
24620,"Greeneville, TN",1998,274,17,291,60291,4.82659103348759
24620,"Greeneville, TN",1999,291,19,310,61145,5.06991577397988
24620,"Greeneville, TN",2000,269,13,282,63081,4.47044276406525
24620,"Greeneville, TN",2001,259,20,279,63622,4.38527553362045
24620,"Greeneville, TN",2002,281,16,297,64070,4.63555486186983
24620,"Greeneville, TN",2003,319,29,348,64614,5.38582969635064
24620,"Greeneville, TN",2004,371,22,393,65364,6.01248393611162
24620,"Greeneville, TN",2005,381,108,489,66369,7.36789766306559
24620,"Greeneville, TN",2006,357,21,378,67153,5.62893690527601
24620,"Greeneville, TN",2007,280,12,292,67840,4.30424528301887
24620,"Greeneville, TN",2008,175,10,185,68328,2.7075283924599
24620,"Greeneville, TN",2009,116,6,122,68744,1.774700337484
24620,"Greeneville, TN",2010,130,6,136,68833,1.97579649296123
24620,"Greeneville, TN",2011,105,2,107,69097,1.54854769382173
24620,"Greeneville, TN",2012,88,40,128,68698,1.86322745931468
24620,"Greeneville, TN",2013,93,50,143,68330,2.09278501390312
24620,"Greeneville, TN",2014,87,7,94,68467,1.37292418245286
24620,"Greeneville, TN",2015,105,0,105,68521,1.53237693553801
24620,"Greeneville, TN",2016,123,4,127,68511,1.85371692137029
24620,"Greeneville, TN",2017,125,7,132,68759,1.91974868744455
24620,"Greeneville, TN",2018,164,7,171,69087,2.4751400408181
24640,"Greenfield Town, MA",1990,220,36,256,70272,3.64298724954463
24640,"Greenfield Town, MA",1991,163,20,183,70582,2.59272902439716
24640,"Greenfield Town, MA",1992,177,7,184,70712,2.60210431044236
24640,"Greenfield Town, MA",1993,187,10,197,70762,2.7839801023148
24640,"Greenfield Town, MA",1994,213,7,220,70811,3.10686192823149
24640,"Greenfield Town, MA",1995,151,0,151,71010,2.12646106182228
24640,"Greenfield Town, MA",1996,155,5,160,71168,2.24820143884892
24640,"Greenfield Town, MA",1997,160,6,166,70849,2.34301119281853
24640,"Greenfield Town, MA",1998,159,24,183,70624,2.59118713185319
24640,"Greenfield Town, MA",1999,185,10,195,70745,2.75637854265319
24640,"Greenfield Town, MA",2000,201,6,207,71471,2.89627960991171
24640,"Greenfield Town, MA",2001,192,0,192,71557,2.68317565018097
24640,"Greenfield Town, MA",2002,235,6,241,71761,3.35837014534357
24640,"Greenfield Town, MA",2003,238,6,244,71837,3.39657836490945
24640,"Greenfield Town, MA",2004,243,22,265,71875,3.68695652173913
24640,"Greenfield Town, MA",2005,235,16,251,71879,3.49197957678877
24640,"Greenfield Town, MA",2006,194,16,210,71708,2.92854353768059
24640,"Greenfield Town, MA",2007,137,6,143,71577,1.99784847087752
24640,"Greenfield Town, MA",2008,95,2,97,71571,1.3552975367118
24640,"Greenfield Town, MA",2009,55,8,63,71392,0.882451815329449
24640,"Greenfield Town, MA",2010,58,0,58,71366,0.812711935655634
24640,"Greenfield Town, MA",2011,49,10,59,71679,0.823114161748908
24640,"Greenfield Town, MA",2012,40,12,52,71678,0.725466670387009
24640,"Greenfield Town, MA",2013,53,4,57,71355,0.798822787471095
24640,"Greenfield Town, MA",2014,60,10,70,71295,0.981836033382425
24640,"Greenfield Town, MA",2015,51,68,119,70902,1.67837296550168
24640,"Greenfield Town, MA",2016,46,8,54,70728,0.763488293179505
24640,"Greenfield Town, MA",2017,66,9,75,70787,1.05951657790272
24640,"Greenfield Town, MA",2018,59,0,59,70963,0.83141919028226
24660,"Greensboro-High Point, NC",1990,2591,341,2932,541876,5.41083199846459
24660,"Greensboro-High Point, NC",1991,2732,443,3175,549034,5.78288412010914
24660,"Greensboro-High Point, NC",1992,3123,466,3589,554732,6.46979081790847
24660,"Greensboro-High Point, NC",1993,3396,772,4168,561221,7.42666436216749
24660,"Greensboro-High Point, NC",1994,3632,718,4350,568522,7.65141894245077
24660,"Greensboro-High Point, NC",1995,3633,1217,4850,577549,8.39755587837569
24660,"Greensboro-High Point, NC",1996,3883,1674,5557,584822,9.50203651709409
24660,"Greensboro-High Point, NC",1997,4154,1429,5583,591582,9.43740681765165
24660,"Greensboro-High Point, NC",1998,4347,1302,5649,599197,9.42761729447911
24660,"Greensboro-High Point, NC",1999,4120,1608,5728,605547,9.45921621277952
24660,"Greensboro-High Point, NC",2000,3924,862,4786,645409,7.41545283688328
24660,"Greensboro-High Point, NC",2001,4616,1777,6393,652741,9.79408371773797
24660,"Greensboro-High Point, NC",2002,4495,1173,5668,657855,8.61588039917611
24660,"Greensboro-High Point, NC",2003,4024,792,4816,663140,7.26241819223693
24660,"Greensboro-High Point, NC",2004,4872,1267,6139,667711,9.19409744635029
24660,"Greensboro-High Point, NC",2005,5220,1070,6290,677080,9.28989188869853
24660,"Greensboro-High Point, NC",2006,4660,1757,6417,689637,9.3048951839881
24660,"Greensboro-High Point, NC",2007,3724,1242,4966,700485,7.08937379101622
24660,"Greensboro-High Point, NC",2008,2070,1226,3296,711405,4.63308523274365
24660,"Greensboro-High Point, NC",2009,1363,712,2075,718902,2.88634612228092
24660,"Greensboro-High Point, NC",2010,1234,669,1903,725233,2.6239842919448
24660,"Greensboro-High Point, NC",2011,1054,993,2047,730019,2.80403660726639
24660,"Greensboro-High Point, NC",2012,1183,704,1887,735443,2.56580047671947
24660,"Greensboro-High Point, NC",2013,1416,616,2032,740631,2.74360646529783
24660,"Greensboro-High Point, NC",2014,1470,1162,2632,746585,3.5253855890488
24660,"Greensboro-High Point, NC",2015,1658,554,2212,751724,2.94256934726043
24660,"Greensboro-High Point, NC",2016,1635,1100,2735,759546,3.60083523578559
24660,"Greensboro-High Point, NC",2017,2012,1043,3055,763486,4.00138312948764
24660,"Greensboro-High Point, NC",2018,1949,275,2224,767711,2.89692345166345
24700,"Greensburg, IN",1990,59,93,152,23663,6.42353040611926
24700,"Greensburg, IN",1991,62,11,73,23893,3.05528815971205
24700,"Greensburg, IN",1992,101,4,105,24281,4.32436884807051
24700,"Greensburg, IN",1993,75,16,91,24426,3.72553836076312
24700,"Greensburg, IN",1994,122,115,237,24663,9.60953655273081
24700,"Greensburg, IN",1995,95,161,256,24907,10.2782350343277
24700,"Greensburg, IN",1996,86,32,118,25051,4.71039080276237
24700,"Greensburg, IN",1997,71,32,103,25373,4.05943325582312
24700,"Greensburg, IN",1998,112,2,114,25571,4.45817527668061
24700,"Greensburg, IN",1999,102,28,130,25745,5.04952417945232
24700,"Greensburg, IN",2000,100,0,100,24572,4.06967279830702
24700,"Greensburg, IN",2001,100,34,134,24585,5.45047793369941
24700,"Greensburg, IN",2002,102,120,222,24793,8.95414028153108
24700,"Greensburg, IN",2003,91,36,127,24946,5.09099655255352
24700,"Greensburg, IN",2004,98,12,110,25208,4.36369406537607
24700,"Greensburg, IN",2005,88,2,90,25374,3.54693781035706
24700,"Greensburg, IN",2006,102,50,152,25469,5.96803957752562
24700,"Greensburg, IN",2007,91,22,113,25486,4.43380679588794
24700,"Greensburg, IN",2008,34,18,52,25600,2.03125
24700,"Greensburg, IN",2009,51,64,115,25595,4.49306505176792
24700,"Greensburg, IN",2010,31,0,31,25798,1.20164353825878
24700,"Greensburg, IN",2011,26,0,26,25898,1.00393852807167
24700,"Greensburg, IN",2012,29,0,29,26041,1.11362850888983
24700,"Greensburg, IN",2013,36,0,36,26234,1.37226499961882
24700,"Greensburg, IN",2014,50,0,50,26414,1.89293556447339
24700,"Greensburg, IN",2015,50,0,50,26336,1.89854191980559
24700,"Greensburg, IN",2016,47,0,47,26562,1.76944507190724
24700,"Greensburg, IN",2017,54,0,54,26652,2.02611436289959
24700,"Greensburg, IN",2018,58,0,58,26794,2.16466373068597
24740,"Greenville, MS",1990,65,32,97,67843,1.42977167872883
24740,"Greenville, MS",1991,47,8,55,67415,0.815842171623526
24740,"Greenville, MS",1992,43,15,58,66616,0.8706617028942
24740,"Greenville, MS",1993,58,35,93,66532,1.39782360367943
24740,"Greenville, MS",1994,62,42,104,66610,1.56132712805885
24740,"Greenville, MS",1995,78,264,342,66362,5.15355173141256
24740,"Greenville, MS",1996,87,22,109,65891,1.65424716577378
24740,"Greenville, MS",1997,93,16,109,65540,1.66310649984742
24740,"Greenville, MS",1998,113,72,185,65129,2.84051651338114
24740,"Greenville, MS",1999,80,24,104,64296,1.61751897474182
24740,"Greenville, MS",2000,68,58,126,62657,2.0109484973746
24740,"Greenville, MS",2001,91,105,196,61221,3.20151581973506
24740,"Greenville, MS",2002,78,24,102,59570,1.71227127748867
24740,"Greenville, MS",2003,70,37,107,58072,1.84254029480645
24740,"Greenville, MS",2004,55,79,134,56802,2.35907186366677
24740,"Greenville, MS",2005,43,12,55,55872,0.984392898052692
24740,"Greenville, MS",2006,27,12,39,54325,0.717901518637828
24740,"Greenville, MS",2007,27,61,88,53069,1.65821854566696
24740,"Greenville, MS",2008,29,9,38,52236,0.727467646833601
24740,"Greenville, MS",2009,11,0,11,51565,0.213322990400465
24740,"Greenville, MS",2010,14,0,14,51096,0.273994050414905
24740,"Greenville, MS",2011,7,0,7,50449,0.138753989177189
24740,"Greenville, MS",2012,9,0,9,50016,0.179942418426104
24740,"Greenville, MS",2013,7,0,7,49662,0.140952841206556
24740,"Greenville, MS",2014,10,0,10,49012,0.204031665714519
24740,"Greenville, MS",2015,21,0,21,47965,0.437819243198165
24740,"Greenville, MS",2016,27,0,27,47186,0.572203619717713
24740,"Greenville, MS",2017,27,42,69,46202,1.49344184234449
24740,"Greenville, MS",2018,11,0,11,45063,0.244102700663515
24780,"Greenville, NC",1990,598,563,1161,108954,10.6558731207666
24780,"Greenville, NC",1991,421,513,934,111452,8.38028927251193
24780,"Greenville, NC",1992,641,768,1409,113375,12.4277839029768
24780,"Greenville, NC",1993,817,929,1746,115341,15.1377220589383
24780,"Greenville, NC",1994,793,1060,1853,117839,15.7248449155203
24780,"Greenville, NC",1995,877,681,1558,120185,12.9633481715688
24780,"Greenville, NC",1996,663,356,1019,122028,8.35054249844298
24780,"Greenville, NC",1997,851,562,1413,124457,11.3533188169408
24780,"Greenville, NC",1998,774,598,1372,126630,10.8347153123273
24780,"Greenville, NC",1999,742,447,1189,128137,9.2791309301763
24780,"Greenville, NC",2000,722,1044,1766,134298,13.1498607574201
24780,"Greenville, NC",2001,763,1075,1838,136605,13.4548515793712
24780,"Greenville, NC",2002,811,1026,1837,139128,13.2036685641999
24780,"Greenville, NC",2003,955,754,1709,141610,12.0683567544665
24780,"Greenville, NC",2004,1499,692,2191,144486,15.1640989438423
24780,"Greenville, NC",2005,1393,1155,2548,147929,17.2244793110208
24780,"Greenville, NC",2006,1548,743,2291,152934,14.9803183072436
24780,"Greenville, NC",2007,1317,1196,2513,157479,15.9576832466551
24780,"Greenville, NC",2008,609,638,1247,162116,7.69202299587949
24780,"Greenville, NC",2009,366,196,562,165581,3.39410922750799
24780,"Greenville, NC",2010,350,319,669,168853,3.9620261410813
24780,"Greenville, NC",2011,296,40,336,170761,1.96766240535017
24780,"Greenville, NC",2012,316,454,770,172969,4.45166474917471
24780,"Greenville, NC",2013,378,180,558,174384,3.19983484723369
24780,"Greenville, NC",2014,335,570,905,174998,5.17148767414485
24780,"Greenville, NC",2015,352,186,538,176098,3.05511703710434
24780,"Greenville, NC",2016,466,395,861,177232,4.85803918028347
24780,"Greenville, NC",2017,603,534,1137,178617,6.36557550513109
24780,"Greenville, NC",2018,610,540,1150,179914,6.39194281712374
24820,"Greenville, OH",1990,128,7,135,53637,2.51691929078808
24820,"Greenville, OH",1991,122,59,181,53683,3.37164465473241
24820,"Greenville, OH",1992,132,83,215,53748,4.00014884274764
24820,"Greenville, OH",1993,135,37,172,53880,3.19227913882702
24820,"Greenville, OH",1994,159,41,200,54079,3.69829323767082
24820,"Greenville, OH",1995,156,17,173,54191,3.19241202413685
24820,"Greenville, OH",1996,163,39,202,54365,3.71562586222754
24820,"Greenville, OH",1997,183,35,218,54244,4.01887766388909
24820,"Greenville, OH",1998,223,29,252,54094,4.65855732613599
24820,"Greenville, OH",1999,191,2,193,54079,3.56885297435234
24820,"Greenville, OH",2000,170,7,177,53291,3.32138635041564
24820,"Greenville, OH",2001,153,22,175,53110,3.29504801355677
24820,"Greenville, OH",2002,148,20,168,53011,3.16915357190017
24820,"Greenville, OH",2003,97,8,105,53190,1.97405527354766
24820,"Greenville, OH",2004,109,18,127,53236,2.38560372680141
24820,"Greenville, OH",2005,103,66,169,53200,3.17669172932331
24820,"Greenville, OH",2006,100,0,100,53023,1.88597401127812
24820,"Greenville, OH",2007,65,0,65,52996,1.22650766095554
24820,"Greenville, OH",2008,48,8,56,52909,1.05842106257915
24820,"Greenville, OH",2009,38,0,38,52829,0.719301898578432
24820,"Greenville, OH",2010,30,0,30,52965,0.566411781365052
24820,"Greenville, OH",2011,28,0,28,52647,0.53184416965829
24820,"Greenville, OH",2012,30,0,30,52511,0.571308868618004
24820,"Greenville, OH",2013,31,0,31,52306,0.592666233319313
24820,"Greenville, OH",2014,38,0,38,52182,0.728220459162163
24820,"Greenville, OH",2015,44,0,44,51973,0.84659342350836
24820,"Greenville, OH",2016,28,0,28,51614,0.542488472119968
24820,"Greenville, OH",2017,45,0,45,51577,0.872481920235764
24820,"Greenville, OH",2018,64,4,68,51323,1.32494203378602
24860,"Greenville-Anderson-Mauldin, SC",1990,2768,1585,4353,619719,7.02415126855881
24860,"Greenville-Anderson-Mauldin, SC",1991,2794,303,3097,625691,4.94972758118624
24860,"Greenville-Anderson-Mauldin, SC",1992,3293,184,3477,632111,5.50061618924524
24860,"Greenville-Anderson-Mauldin, SC",1993,3667,310,3977,639525,6.21867792502248
24860,"Greenville-Anderson-Mauldin, SC",1994,4072,1045,5117,647045,7.90825985827879
24860,"Greenville-Anderson-Mauldin, SC",1995,3946,901,4847,655776,7.39124335138828
24860,"Greenville-Anderson-Mauldin, SC",1996,4418,1736,6154,665781,9.24327969707757
24860,"Greenville-Anderson-Mauldin, SC",1997,4189,1002,5191,675327,7.6866466171203
24860,"Greenville-Anderson-Mauldin, SC",1998,4927,921,5848,685214,8.53456000607109
24860,"Greenville-Anderson-Mauldin, SC",1999,5531,894,6425,693559,9.26381173050887
24860,"Greenville-Anderson-Mauldin, SC",2000,4699,759,5458,727743,7.49990037691877
24860,"Greenville-Anderson-Mauldin, SC",2001,4869,475,5344,735668,7.26414632687571
24860,"Greenville-Anderson-Mauldin, SC",2002,5238,621,5859,741131,7.90548499523026
24860,"Greenville-Anderson-Mauldin, SC",2003,5405,448,5853,747276,7.83244744913526
24860,"Greenville-Anderson-Mauldin, SC",2004,5590,661,6251,754196,8.28829641101252
24860,"Greenville-Anderson-Mauldin, SC",2005,6398,595,6993,763048,9.1645610761053
24860,"Greenville-Anderson-Mauldin, SC",2006,6199,923,7122,777494,9.1601993070043
24860,"Greenville-Anderson-Mauldin, SC",2007,5531,1106,6637,793500,8.36420919974795
24860,"Greenville-Anderson-Mauldin, SC",2008,2924,903,3827,808765,4.73190605429266
24860,"Greenville-Anderson-Mauldin, SC",2009,1729,92,1821,819279,2.22268604468075
24860,"Greenville-Anderson-Mauldin, SC",2010,1756,206,1962,825629,2.37637001607259
24860,"Greenville-Anderson-Mauldin, SC",2011,1907,122,2029,833116,2.43543516149012
24860,"Greenville-Anderson-Mauldin, SC",2012,2650,168,2818,840824,3.35147426809891
24860,"Greenville-Anderson-Mauldin, SC",2013,3254,641,3895,848385,4.59107598554901
24860,"Greenville-Anderson-Mauldin, SC",2014,3306,1173,4479,860295,5.20635363450909
24860,"Greenville-Anderson-Mauldin, SC",2015,3782,2114,5896,872598,6.75683418939764
24860,"Greenville-Anderson-Mauldin, SC",2016,4237,1516,5753,884320,6.505563596888
24860,"Greenville-Anderson-Mauldin, SC",2017,4458,841,5299,895422,5.91788006102151
24860,"Greenville-Anderson-Mauldin, SC",2018,5254,1176,6430,906626,7.09222987207515
24900,"Greenwood, MS",1990,20,0,20,37283,0.53643751844004
24900,"Greenwood, MS",1991,21,0,21,37639,0.557931932304259
24900,"Greenwood, MS",1992,19,20,39,37432,1.04188929258389
24900,"Greenwood, MS",1993,15,44,59,37470,1.57459300773952
24900,"Greenwood, MS",1994,29,0,29,37295,0.77758412655852
24900,"Greenwood, MS",1995,24,82,106,37164,2.85222258099236
24900,"Greenwood, MS",1996,20,4,24,37276,0.643845906213113
24900,"Greenwood, MS",1997,44,0,44,37516,1.17283292461883
24900,"Greenwood, MS",1998,13,55,68,37233,1.82633685171756
24900,"Greenwood, MS",1999,24,32,56,36737,1.52434874921741
24900,"Greenwood, MS",2000,20,0,20,37763,0.529618939173265
24900,"Greenwood, MS",2001,31,0,31,36775,0.842963970088375
24900,"Greenwood, MS",2002,38,144,182,35957,5.06160135717663
24900,"Greenwood, MS",2003,36,0,36,34516,1.04299455325067
24900,"Greenwood, MS",2004,38,264,302,34863,8.66247884576772
24900,"Greenwood, MS",2005,50,230,280,34178,8.19240447071216
24900,"Greenwood, MS",2006,38,202,240,33862,7.08759080975725
24900,"Greenwood, MS",2007,21,0,21,33540,0.626118067978533
24900,"Greenwood, MS",2008,78,14,92,33329,2.76035884665006
24900,"Greenwood, MS",2009,10,0,10,32508,0.307616586686354
24900,"Greenwood, MS",2010,9,0,9,32418,0.277623542476402
24900,"Greenwood, MS",2011,7,0,7,32067,0.218292949137743
24900,"Greenwood, MS",2012,17,0,17,30800,0.551948051948052
24900,"Greenwood, MS",2013,16,0,16,30752,0.520291363163372
24900,"Greenwood, MS",2014,19,0,19,30716,0.618570126318531
24900,"Greenwood, MS",2015,15,0,15,30261,0.495687518588282
24900,"Greenwood, MS",2016,13,0,13,29799,0.436256250209739
24900,"Greenwood, MS",2017,0,0,0,29324,0
24900,"Greenwood, MS",2018,7,0,7,28919,0.242055396106366
24940,"Greenwood, SC",1990,348,141,489,83513,5.85537580975417
24940,"Greenwood, SC",1991,333,67,400,84100,4.75624256837099
24940,"Greenwood, SC",1992,372,52,424,84766,5.00200552108157
24940,"Greenwood, SC",1993,665,56,721,85374,8.44519408719282
24940,"Greenwood, SC",1994,449,163,612,86043,7.11272270841323
24940,"Greenwood, SC",1995,394,166,560,86640,6.46352723915051
24940,"Greenwood, SC",1996,453,4,457,87356,5.23146664224552
24940,"Greenwood, SC",1997,380,34,414,87478,4.73261848693386
24940,"Greenwood, SC",1998,362,169,531,88096,6.02751543770432
24940,"Greenwood, SC",1999,341,182,523,88329,5.92104518334862
24940,"Greenwood, SC",2000,292,188,480,92532,5.18739463104656
24940,"Greenwood, SC",2001,281,66,347,92874,3.73624480478928
24940,"Greenwood, SC",2002,320,54,374,93307,4.00827376295455
24940,"Greenwood, SC",2003,226,22,248,93594,2.64974250486142
24940,"Greenwood, SC",2004,327,166,493,93490,5.27329126109744
24940,"Greenwood, SC",2005,312,10,322,93625,3.4392523364486
24940,"Greenwood, SC",2006,246,0,246,93912,2.61947354970611
24940,"Greenwood, SC",2007,245,26,271,93943,2.88472797334554
24940,"Greenwood, SC",2008,131,28,159,94561,1.68145429934117
24940,"Greenwood, SC",2009,79,0,79,95212,0.82972734529261
24940,"Greenwood, SC",2010,69,0,69,95098,0.725567309512293
24940,"Greenwood, SC",2011,79,0,79,94925,0.832235975770345
24940,"Greenwood, SC",2012,144,60,204,94983,2.14775275575629
24940,"Greenwood, SC",2013,106,44,150,94730,1.58344769344453
24940,"Greenwood, SC",2014,127,76,203,94476,2.14869384817308
24940,"Greenwood, SC",2015,98,48,146,94785,1.54032811098803
24940,"Greenwood, SC",2016,125,47,172,94913,1.8121858965579
24940,"Greenwood, SC",2017,157,13,170,95147,1.78670898714621
24940,"Greenwood, SC",2018,153,0,153,95282,1.60575974475767
24980,"Grenada, MS",1990,18,50,68,21586,3.15018993792273
24980,"Grenada, MS",1991,11,6,17,21765,0.781070526073972
24980,"Grenada, MS",1992,8,4,12,21895,0.548070335693081
24980,"Grenada, MS",1993,3,4,7,22082,0.317000271714519
24980,"Grenada, MS",1994,12,2,14,22032,0.635439360929557
24980,"Grenada, MS",1995,11,6,17,22160,0.767148014440433
24980,"Grenada, MS",1996,35,2,37,22314,1.65815183293
24980,"Grenada, MS",1997,31,4,35,22420,1.56110615521855
24980,"Grenada, MS",1998,22,0,22,22438,0.98047954363134
24980,"Grenada, MS",1999,45,2,47,22476,2.09111941626624
24980,"Grenada, MS",2000,32,2,34,23160,1.46804835924007
24980,"Grenada, MS",2001,23,58,81,22898,3.53742684950651
24980,"Grenada, MS",2002,23,0,23,22684,1.01393052371716
24980,"Grenada, MS",2003,20,0,20,22410,0.892458723784025
24980,"Grenada, MS",2004,36,0,36,22222,1.620016200162
24980,"Grenada, MS",2005,29,0,29,22173,1.30789699183692
24980,"Grenada, MS",2006,41,8,49,22388,2.18867250312667
24980,"Grenada, MS",2007,96,6,102,22335,4.56682337139019
24980,"Grenada, MS",2008,17,0,17,22194,0.765972785437506
24980,"Grenada, MS",2009,6,2,8,22036,0.363042294427301
24980,"Grenada, MS",2010,13,0,13,21841,0.595210841994414
24980,"Grenada, MS",2011,16,0,16,21609,0.740432227312694
24980,"Grenada, MS",2012,17,0,17,21620,0.786308973172988
24980,"Grenada, MS",2013,15,0,15,21539,0.696411161149543
24980,"Grenada, MS",2014,14,0,14,21605,0.647998148576718
24980,"Grenada, MS",2015,7,0,7,21452,0.326309901174716
24980,"Grenada, MS",2016,8,0,8,21224,0.376931775348662
24980,"Grenada, MS",2017,0,0,0,21056,0
24980,"Grenada, MS",2018,0,0,0,21055,0
25060,"Gulfport-Biloxi-Pascagoula, MS",1990,765,2,767,312267,2.45623136610657
25060,"Gulfport-Biloxi-Pascagoula, MS",1991,802,12,814,313994,2.59240622432276
25060,"Gulfport-Biloxi-Pascagoula, MS",1992,1161,20,1181,321480,3.67363444071171
25060,"Gulfport-Biloxi-Pascagoula, MS",1993,1761,127,1888,329198,5.735150274303
25060,"Gulfport-Biloxi-Pascagoula, MS",1994,1982,744,2726,337162,8.08513414916272
25060,"Gulfport-Biloxi-Pascagoula, MS",1995,1538,782,2320,341343,6.79668251582719
25060,"Gulfport-Biloxi-Pascagoula, MS",1996,1759,438,2197,341418,6.43492727389886
25060,"Gulfport-Biloxi-Pascagoula, MS",1997,1644,223,1867,344585,5.41811164153982
25060,"Gulfport-Biloxi-Pascagoula, MS",1998,1892,1446,3338,348122,9.58859250492643
25060,"Gulfport-Biloxi-Pascagoula, MS",1999,2401,589,2990,352629,8.47916648942656
25060,"Gulfport-Biloxi-Pascagoula, MS",2000,2435,1384,3819,365397,10.4516457442179
25060,"Gulfport-Biloxi-Pascagoula, MS",2001,2258,545,2803,368163,7.61347555294801
25060,"Gulfport-Biloxi-Pascagoula, MS",2002,2305,342,2647,370891,7.13686770506699
25060,"Gulfport-Biloxi-Pascagoula, MS",2003,2296,544,2840,371296,7.64888390933379
25060,"Gulfport-Biloxi-Pascagoula, MS",2004,2908,722,3630,379253,9.57144702876444
25060,"Gulfport-Biloxi-Pascagoula, MS",2005,2369,535,2904,383412,7.57409783731339
25060,"Gulfport-Biloxi-Pascagoula, MS",2006,4676,819,5495,347253,15.8241973431475
25060,"Gulfport-Biloxi-Pascagoula, MS",2007,3319,3557,6876,356789,19.2718945931629
25060,"Gulfport-Biloxi-Pascagoula, MS",2008,2448,2729,5177,363290,14.25032343307
25060,"Gulfport-Biloxi-Pascagoula, MS",2009,2679,956,3635,367577,9.88908446393545
25060,"Gulfport-Biloxi-Pascagoula, MS",2010,1594,464,2058,371397,5.54124023618931
25060,"Gulfport-Biloxi-Pascagoula, MS",2011,1541,416,1957,375796,5.20761264090091
25060,"Gulfport-Biloxi-Pascagoula, MS",2012,1398,451,1849,378721,4.88222200511722
25060,"Gulfport-Biloxi-Pascagoula, MS",2013,1310,485,1795,381966,4.69937114821738
25060,"Gulfport-Biloxi-Pascagoula, MS",2014,1386,568,1954,385756,5.06537811466316
25060,"Gulfport-Biloxi-Pascagoula, MS",2015,1506,206,1712,388344,4.40846260016892
25060,"Gulfport-Biloxi-Pascagoula, MS",2016,1614,162,1776,390780,4.54475664056502
25060,"Gulfport-Biloxi-Pascagoula, MS",2017,1799,139,1938,394322,4.91476509045907
25060,"Gulfport-Biloxi-Pascagoula, MS",2018,1921,238,2159,397261,5.43471420552231
25100,"Guymon, OK",1990,37,0,37,16428,2.25225225225225
25100,"Guymon, OK",1991,3,0,3,16228,0.184865664283954
25100,"Guymon, OK",1992,2,0,2,16166,0.123716441915131
25100,"Guymon, OK",1993,21,0,21,16016,1.31118881118881
25100,"Guymon, OK",1994,20,0,20,16265,1.22963418383031
25100,"Guymon, OK",1995,29,92,121,16614,7.28301432526785
25100,"Guymon, OK",1996,25,0,25,17398,1.43694677549144
25100,"Guymon, OK",1997,9,92,101,18028,5.60239627246505
25100,"Guymon, OK",1998,11,79,90,18552,4.85122897800776
25100,"Guymon, OK",1999,8,94,102,18488,5.51709216789269
25100,"Guymon, OK",2000,11,64,75,20161,3.72005356877139
25100,"Guymon, OK",2001,6,85,91,19945,4.56254700426172
25100,"Guymon, OK",2002,15,0,15,19734,0.76010945576163
25100,"Guymon, OK",2003,15,0,15,19469,0.770455596075813
25100,"Guymon, OK",2004,10,0,10,19693,0.507794647844412
25100,"Guymon, OK",2005,15,0,15,19408,0.772877164056059
25100,"Guymon, OK",2006,14,0,14,19361,0.723103145498683
25100,"Guymon, OK",2007,11,0,11,19258,0.571191193270329
25100,"Guymon, OK",2008,13,0,13,19539,0.665335994677312
25100,"Guymon, OK",2009,0,0,0,20128,0
25100,"Guymon, OK",2010,2,0,2,20813,0.0960937875366358
25100,"Guymon, OK",2011,10,0,10,21245,0.470698987997176
25100,"Guymon, OK",2012,2,0,2,21556,0.092781592132121
25100,"Guymon, OK",2013,9,0,9,22022,0.408682226864045
25100,"Guymon, OK",2014,5,4,9,21733,0.414116780932223
25100,"Guymon, OK",2015,5,0,5,21439,0.2332198330146
25100,"Guymon, OK",2016,2,0,2,21121,0.0946924861512239
25100,"Guymon, OK",2017,3,4,7,20856,0.335634829305715
25100,"Guymon, OK",2018,1,0,1,20455,0.0488878024932779
25180,"Hagerstown-Martinsburg, MD-WV",1990,675,91,766,181675,4.21632035227742
25180,"Hagerstown-Martinsburg, MD-WV",1991,906,118,1024,185089,5.53247356677058
25180,"Hagerstown-Martinsburg, MD-WV",1992,1116,114,1230,187990,6.5429012181499004
25180,"Hagerstown-Martinsburg, MD-WV",1993,1249,100,1349,189651,7.11306557835181
25180,"Hagerstown-Martinsburg, MD-WV",1994,1333,188,1521,191375,7.94774657086871
25180,"Hagerstown-Martinsburg, MD-WV",1995,1060,123,1183,193258,6.12135073321674
25180,"Hagerstown-Martinsburg, MD-WV",1996,1160,257,1417,194943,7.26879139030383
25180,"Hagerstown-Martinsburg, MD-WV",1997,1217,268,1485,196327,7.56391122973407
25180,"Hagerstown-Martinsburg, MD-WV",1998,1283,53,1336,198596,6.72722512034482
25180,"Hagerstown-Martinsburg, MD-WV",1999,1386,126,1512,200828,7.52883064114566
25180,"Hagerstown-Martinsburg, MD-WV",2000,1312,186,1498,208408,7.18782388392
25180,"Hagerstown-Martinsburg, MD-WV",2001,1863,191,2054,211521,9.71061974933931
25180,"Hagerstown-Martinsburg, MD-WV",2002,2329,347,2676,215706,12.4057745264388
25180,"Hagerstown-Martinsburg, MD-WV",2003,2439,196,2635,221396,11.9017507091366
25180,"Hagerstown-Martinsburg, MD-WV",2004,2827,352,3179,227681,13.9625177331442
25180,"Hagerstown-Martinsburg, MD-WV",2005,3313,567,3880,234198,16.567178199643
25180,"Hagerstown-Martinsburg, MD-WV",2006,2207,360,2567,240604,10.6689830593008
25180,"Hagerstown-Martinsburg, MD-WV",2007,1484,201,1685,245305,6.8689998165549
25180,"Hagerstown-Martinsburg, MD-WV",2008,946,146,1092,248303,4.39785262360906
25180,"Hagerstown-Martinsburg, MD-WV",2009,608,42,650,249783,2.6022587606042
25180,"Hagerstown-Martinsburg, MD-WV",2010,594,62,656,252340,2.59966711579615
25180,"Hagerstown-Martinsburg, MD-WV",2011,484,8,492,254484,1.93332390248503
25180,"Hagerstown-Martinsburg, MD-WV",2012,572,121,693,255986,2.70717929886791
25180,"Hagerstown-Martinsburg, MD-WV",2013,801,74,875,257483,3.39828260506519
25180,"Hagerstown-Martinsburg, MD-WV",2014,783,192,975,259247,3.76089212218463
25180,"Hagerstown-Martinsburg, MD-WV",2015,828,150,978,260799,3.75001437888949
25180,"Hagerstown-Martinsburg, MD-WV",2016,946,9,955,263141,3.62923299675839
25180,"Hagerstown-Martinsburg, MD-WV",2017,1171,86,1257,265295,4.73812171356415
25180,"Hagerstown-Martinsburg, MD-WV",2018,1363,30,1393,268049,5.19681103081899
25200,"Hailey, ID",1990,356,75,431,17848,24.1483639623487
25200,"Hailey, ID",1991,192,42,234,18458,12.6774298407195
25200,"Hailey, ID",1992,209,49,258,19028,13.5589657347067
25200,"Hailey, ID",1993,257,38,295,19568,15.0756336876533
25200,"Hailey, ID",1994,306,55,361,20358,17.7325866981039
25200,"Hailey, ID",1995,385,85,470,21020,22.3596574690771
25200,"Hailey, ID",1996,387,54,441,21568,20.4469584569733
25200,"Hailey, ID",1997,279,40,319,21803,14.6310140806311
25200,"Hailey, ID",1998,274,67,341,21841,15.6128382400073
25200,"Hailey, ID",1999,289,76,365,22064,16.542784626541
25200,"Hailey, ID",2000,279,158,437,24134,18.1072346067788
25200,"Hailey, ID",2001,316,44,360,24914,14.4497069920527
25200,"Hailey, ID",2002,286,27,313,25456,12.2957259585167
25200,"Hailey, ID",2003,316,14,330,25958,12.7128438246398
25200,"Hailey, ID",2004,357,90,447,26274,17.0130166704727
25200,"Hailey, ID",2005,282,78,360,26660,13.503375843961
25200,"Hailey, ID",2006,253,89,342,26917,12.7057250065015
25200,"Hailey, ID",2007,143,42,185,27210,6.79897096655641
25200,"Hailey, ID",2008,86,36,122,27638,4.414212316376
25200,"Hailey, ID",2009,44,0,44,27874,1.5785319652723
25200,"Hailey, ID",2010,31,0,31,27618,1.12245636903469
25200,"Hailey, ID",2011,37,24,61,27330,2.2319795096963
25200,"Hailey, ID",2012,26,10,36,27478,1.31013902030715
25200,"Hailey, ID",2013,65,0,65,27701,2.34648568643731
25200,"Hailey, ID",2014,96,0,96,27850,3.44703770197487
25200,"Hailey, ID",2015,67,0,67,28015,2.39157594145993
25200,"Hailey, ID",2016,91,0,91,28345,3.210442758864
25200,"Hailey, ID",2017,80,0,80,28712,2.78629144608526
25200,"Hailey, ID",2018,98,24,122,29088,4.19416941694169
25220,"Hammond, LA",1990,203,20,223,85718,2.60155393266292
25220,"Hammond, LA",1991,273,0,273,86305,3.16320027808354
25220,"Hammond, LA",1992,383,10,393,87793,4.47643889603955
25220,"Hammond, LA",1993,417,14,431,89398,4.82113693818654
25220,"Hammond, LA",1994,451,52,503,91078,5.5227387513999
25220,"Hammond, LA",1995,414,138,552,92958,5.93816562318466
25220,"Hammond, LA",1996,530,104,634,93869,6.75409347068787
25220,"Hammond, LA",1997,489,137,626,95359,6.56466615631456
25220,"Hammond, LA",1998,514,112,626,96910,6.45960169229182
25220,"Hammond, LA",1999,535,113,648,98127,6.60368705860772
25220,"Hammond, LA",2000,469,83,552,100716,5.48075777433576
25220,"Hammond, LA",2001,473,114,587,101657,5.77431952546308
25220,"Hammond, LA",2002,473,150,623,102511,6.07739657207519
25220,"Hammond, LA",2003,676,172,848,103782,8.17097377194504
25220,"Hammond, LA",2004,736,94,830,105335,7.87962215787725
25220,"Hammond, LA",2005,1028,203,1231,106987,11.5060708310355
25220,"Hammond, LA",2006,1881,243,2124,114102,18.6149234895094
25220,"Hammond, LA",2007,1028,46,1074,116792,9.19583533118707
25220,"Hammond, LA",2008,728,157,885,118621,7.46073629458528
25220,"Hammond, LA",2009,726,89,815,120009,6.79115732986693
25220,"Hammond, LA",2010,470,56,526,121482,4.32985956767258
25220,"Hammond, LA",2011,488,87,575,122684,4.68683772945127
25220,"Hammond, LA",2012,526,61,587,123639,4.74769288007829
25220,"Hammond, LA",2013,669,20,689,125526,5.48890269744913
25220,"Hammond, LA",2014,577,15,592,127022,4.66060997307553
25220,"Hammond, LA",2015,621,6,627,128740,4.8702811868883
25220,"Hammond, LA",2016,684,14,698,130657,5.3422319508331
25220,"Hammond, LA",2017,796,187,983,132322,7.42884781064373
25220,"Hammond, LA",2018,932,390,1322,133777,9.88211725483454
25260,"Hanford-Corcoran, CA",1990,519,108,627,101814,6.15828864399788
25260,"Hanford-Corcoran, CA",1991,468,126,594,103971,5.71313154629656
25260,"Hanford-Corcoran, CA",1992,571,47,618,106742,5.78966105188211
25260,"Hanford-Corcoran, CA",1993,528,13,541,108177,5.00106307255701
25260,"Hanford-Corcoran, CA",1994,661,13,674,110252,6.11326778652542
25260,"Hanford-Corcoran, CA",1995,675,6,681,112189,6.07011382577615
25260,"Hanford-Corcoran, CA",1996,587,4,591,113422,5.21062933117032
25260,"Hanford-Corcoran, CA",1997,560,144,704,114441,6.15164145717007
25260,"Hanford-Corcoran, CA",1998,530,243,773,118708,6.51177679684604
25260,"Hanford-Corcoran, CA",1999,509,30,539,123201,4.3749644889246
25260,"Hanford-Corcoran, CA",2000,445,0,445,129835,3.4274271190357
25260,"Hanford-Corcoran, CA",2001,660,0,660,132881,4.96685003875648
25260,"Hanford-Corcoran, CA",2002,621,80,701,135369,5.17843819485998
25260,"Hanford-Corcoran, CA",2003,849,168,1017,139393,7.29591873336538
25260,"Hanford-Corcoran, CA",2004,743,124,867,143601,6.03756241251802
25260,"Hanford-Corcoran, CA",2005,1068,35,1103,145147,7.59919254273254
25260,"Hanford-Corcoran, CA",2006,755,94,849,147712,5.74767114384749
25260,"Hanford-Corcoran, CA",2007,472,25,497,150420,3.30408190400213
25260,"Hanford-Corcoran, CA",2008,236,137,373,152027,2.45351154729094
25260,"Hanford-Corcoran, CA",2009,194,0,194,152278,1.2739857366133
25260,"Hanford-Corcoran, CA",2010,193,72,265,152381,1.73906195654314
25260,"Hanford-Corcoran, CA",2011,142,80,222,151886,1.46162253268899
25260,"Hanford-Corcoran, CA",2012,272,0,272,151026,1.80101439487241
25260,"Hanford-Corcoran, CA",2013,250,5,255,150416,1.69529837251356
25260,"Hanford-Corcoran, CA",2014,274,160,434,149603,2.90101134335541
25260,"Hanford-Corcoran, CA",2015,401,190,591,150199,3.93477985872076
25260,"Hanford-Corcoran, CA",2016,518,87,605,149509,4.04657913570421
25260,"Hanford-Corcoran, CA",2017,272,0,272,149696,1.81701581872595
25260,"Hanford-Corcoran, CA",2018,294,58,352,151366,2.32548921157988
25300,"Hannibal, MO",1990,47,59,106,36213,2.92712561787203
25300,"Hannibal, MO",1991,85,6,91,36163,2.51638414954512
25300,"Hannibal, MO",1992,115,49,164,36398,4.50574207374031
25300,"Hannibal, MO",1993,97,40,137,36408,3.76290925071413
25300,"Hannibal, MO",1994,113,136,249,36537,6.81500944248296
25300,"Hannibal, MO",1995,125,10,135,36630,3.68550368550369
25300,"Hannibal, MO",1996,124,10,134,36614,3.65980226143005
25300,"Hannibal, MO",1997,101,36,137,36575,3.74572795625427
25300,"Hannibal, MO",1998,115,23,138,36746,3.75551080389702
25300,"Hannibal, MO",1999,98,8,106,36794,2.88090449529815
25300,"Hannibal, MO",2000,57,52,109,37954,2.87189756020446
25300,"Hannibal, MO",2001,68,10,78,37819,2.06245537957111
25300,"Hannibal, MO",2002,55,6,61,37822,1.61281793665063
25300,"Hannibal, MO",2003,49,12,61,38037,1.60370165891106
25300,"Hannibal, MO",2004,65,9,74,37985,1.94813742266684
25300,"Hannibal, MO",2005,55,18,73,38307,1.9056569295429
25300,"Hannibal, MO",2006,47,10,57,38560,1.47821576763485
25300,"Hannibal, MO",2007,61,8,69,38513,1.79160283540623
25300,"Hannibal, MO",2008,34,10,44,38667,1.13792122481703
25300,"Hannibal, MO",2009,35,5,40,38829,1.03015787169384
25300,"Hannibal, MO",2010,46,10,56,38970,1.43700282268412
25300,"Hannibal, MO",2011,45,6,51,39048,1.3060848186847
25300,"Hannibal, MO",2012,44,2,46,38959,1.18072845812264
25300,"Hannibal, MO",2013,41,0,41,38924,1.05333470352482
25300,"Hannibal, MO",2014,43,0,43,39034,1.10160373008147
25300,"Hannibal, MO",2015,64,0,64,38861,1.64689534494738
25300,"Hannibal, MO",2016,59,11,70,38913,1.79888469149128
25300,"Hannibal, MO",2017,44,6,50,38835,1.28749839062701
25300,"Hannibal, MO",2018,52,0,52,38804,1.34006803422328
25420,"Harrisburg-Carlisle, PA",1990,2100,485,2585,475658,5.43457694393871
25420,"Harrisburg-Carlisle, PA",1991,1752,283,2035,480950,4.23120906539141
25420,"Harrisburg-Carlisle, PA",1992,2099,174,2273,484616,4.69031150436634
25420,"Harrisburg-Carlisle, PA",1993,2247,351,2598,489143,5.31133022449468
25420,"Harrisburg-Carlisle, PA",1994,2076,187,2263,492587,4.59411230909464
25420,"Harrisburg-Carlisle, PA",1995,1653,258,1911,494378,3.8654632689966
25420,"Harrisburg-Carlisle, PA",1996,1857,549,2406,496699,4.84397995566732
25420,"Harrisburg-Carlisle, PA",1997,1998,895,2893,497494,5.81514550929257
25420,"Harrisburg-Carlisle, PA",1998,1994,261,2255,499511,4.51441509796581
25420,"Harrisburg-Carlisle, PA",1999,2210,385,2595,500322,5.18665979109454
25420,"Harrisburg-Carlisle, PA",2000,1730,223,1953,509451,3.83353845610275
25420,"Harrisburg-Carlisle, PA",2001,1843,251,2094,511391,4.09471422062571
25420,"Harrisburg-Carlisle, PA",2002,2210,176,2386,515553,4.62804018209573
25420,"Harrisburg-Carlisle, PA",2003,2348,483,2831,519152,5.45312355533639
25420,"Harrisburg-Carlisle, PA",2004,2306,92,2398,521882,4.59490842757558
25420,"Harrisburg-Carlisle, PA",2005,2328,376,2704,525775,5.14288431363226
25420,"Harrisburg-Carlisle, PA",2006,1886,144,2030,532268,3.81386820173296
25420,"Harrisburg-Carlisle, PA",2007,2030,199,2229,537268,4.14876746800479
25420,"Harrisburg-Carlisle, PA",2008,1472,392,1864,542301,3.43720553714634
25420,"Harrisburg-Carlisle, PA",2009,1199,323,1522,546874,2.78309080336604
25420,"Harrisburg-Carlisle, PA",2010,1315,297,1612,550102,2.93036564128107
25420,"Harrisburg-Carlisle, PA",2011,952,161,1113,552243,2.01541712615642
25420,"Harrisburg-Carlisle, PA",2012,1215,701,1916,555060,3.45187907613591
25420,"Harrisburg-Carlisle, PA",2013,1331,336,1667,558163,2.98658277241594
25420,"Harrisburg-Carlisle, PA",2014,1201,401,1602,561206,2.85456677227257
25420,"Harrisburg-Carlisle, PA",2015,1195,420,1615,564752,2.85966229424597
25420,"Harrisburg-Carlisle, PA",2016,1239,388,1627,567640,2.86625325910789
25420,"Harrisburg-Carlisle, PA",2017,1270,294,1564,571101,2.73856988518668
25420,"Harrisburg-Carlisle, PA",2018,1344,669,2013,574659,3.50294696506972
25460,"Harrison, AR",1990,109,0,109,36005,3.02735731148452
25460,"Harrison, AR",1991,123,0,123,36358,3.38302436877716
25460,"Harrison, AR",1992,163,26,189,36870,5.12611879576892
25460,"Harrison, AR",1993,202,15,217,37773,5.74484420088423
25460,"Harrison, AR",1994,215,358,573,38638,14.8299601428645
25460,"Harrison, AR",1995,190,36,226,39311,5.74902698990105
25460,"Harrison, AR",1996,188,13,201,39692,5.0639927441298
25460,"Harrison, AR",1997,135,13,148,40004,3.6996300369963
25460,"Harrison, AR",1998,136,0,136,40066,3.39439924125193
25460,"Harrison, AR",1999,154,0,154,40206,3.83027408844451
25460,"Harrison, AR",2000,141,13,154,42693,3.60714871290375
25460,"Harrison, AR",2001,84,0,84,42792,1.96298373527762
25460,"Harrison, AR",2002,97,0,97,42982,2.25675864315295
25460,"Harrison, AR",2003,107,0,107,43167,2.47874533787384
25460,"Harrison, AR",2004,60,0,60,43403,1.38239292214824
25460,"Harrison, AR",2005,77,0,77,43959,1.75163220273437
25460,"Harrison, AR",2006,63,0,63,44530,1.41477655513137
25460,"Harrison, AR",2007,45,0,45,45187,0.995861641622591
25460,"Harrison, AR",2008,36,0,36,45397,0.793003942991828
25460,"Harrison, AR",2009,21,0,21,45155,0.465064776879637
25460,"Harrison, AR",2010,19,53,72,45198,1.59299084030267
25460,"Harrison, AR",2011,14,4,18,45332,0.39707050207359
25460,"Harrison, AR",2012,18,0,18,45379,0.396659247669627
25460,"Harrison, AR",2013,19,0,19,45366,0.418815853282194
25460,"Harrison, AR",2014,13,0,13,44981,0.289010915719971
25460,"Harrison, AR",2015,22,0,22,44970,0.489215032243718
25460,"Harrison, AR",2016,8,0,8,45120,0.177304964539007
25460,"Harrison, AR",2017,34,0,34,45323,0.750170994859122
25460,"Harrison, AR",2018,56,0,56,45285,1.23661256486695
25500,"Harrisonburg, VA",1990,529,310,839,88637,9.46557306768054
25500,"Harrisonburg, VA",1991,394,132,526,89799,5.85752625307631
25500,"Harrisonburg, VA",1992,439,163,602,91027,6.61342239115867
25500,"Harrisonburg, VA",1993,478,112,590,92302,6.39206084375203
25500,"Harrisonburg, VA",1994,516,102,618,93590,6.60326958008334
25500,"Harrisonburg, VA",1995,505,69,574,94939,6.04598742350351
25500,"Harrisonburg, VA",1996,425,466,891,96479,9.23517034795137
25500,"Harrisonburg, VA",1997,503,557,1060,96975,10.9306522299562
25500,"Harrisonburg, VA",1998,718,122,840,97191,8.64277556563879
25500,"Harrisonburg, VA",1999,586,422,1008,97855,10.3009554953758
25500,"Harrisonburg, VA",2000,557,74,631,108414,5.82028151345767
25500,"Harrisonburg, VA",2001,546,53,599,110317,5.42980682940979
25500,"Harrisonburg, VA",2002,763,30,793,112152,7.07076110992225
25500,"Harrisonburg, VA",2003,665,63,728,113151,6.43388038992143
25500,"Harrisonburg, VA",2004,1034,48,1082,114542,9.44631663494613
25500,"Harrisonburg, VA",2005,1152,46,1198,116602,10.2742663076105
25500,"Harrisonburg, VA",2006,886,22,908,118858,7.63936798532703
25500,"Harrisonburg, VA",2007,902,404,1306,120825,10.8090213118146
25500,"Harrisonburg, VA",2008,488,455,943,122361,7.70670393344284
25500,"Harrisonburg, VA",2009,469,151,620,124144,4.99420028354169
25500,"Harrisonburg, VA",2010,392,70,462,125398,3.68426928659149
25500,"Harrisonburg, VA",2011,248,0,248,126782,1.95611364389267
25500,"Harrisonburg, VA",2012,319,325,644,128451,5.01358494678905
25500,"Harrisonburg, VA",2013,470,8,478,128972,3.70623080978817
25500,"Harrisonburg, VA",2014,324,80,404,130443,3.09713821362587
25500,"Harrisonburg, VA",2015,401,5,406,131208,3.09432351685873
25500,"Harrisonburg, VA",2016,620,24,644,133024,4.84123165744527
25500,"Harrisonburg, VA",2017,446,6,452,134220,3.36760542393086
25500,"Harrisonburg, VA",2018,450,33,483,135277,3.5704517397636
25540,"Hartford-West Hartford-East Hartford, CT",1990,1767,459,2226,1124257,1.97997432971287
25540,"Hartford-West Hartford-East Hartford, CT",1991,2099,244,2343,1123523,2.08540457115698
25540,"Hartford-West Hartford-East Hartford, CT",1992,2597,348,2945,1117980,2.63421528113204
25540,"Hartford-West Hartford-East Hartford, CT",1993,2838,100,2938,1115402,2.63402791101325
25540,"Hartford-West Hartford-East Hartford, CT",1994,2768,191,2959,1112606,2.65952187926364
25540,"Hartford-West Hartford-East Hartford, CT",1995,2472,48,2520,1108126,2.27410962291292
25540,"Hartford-West Hartford-East Hartford, CT",1996,2660,248,2908,1106886,2.62719015327685
25540,"Hartford-West Hartford-East Hartford, CT",1997,2869,524,3393,1106388,3.06673608173624
25540,"Hartford-West Hartford-East Hartford, CT",1998,3504,899,4403,1108585,3.97172972753555
25540,"Hartford-West Hartford-East Hartford, CT",1999,3570,273,3843,1112333,3.45490064575986
25540,"Hartford-West Hartford-East Hartford, CT",2000,3077,188,3265,1150872,2.83697926441863
25540,"Hartford-West Hartford-East Hartford, CT",2001,3014,490,3504,1158513,3.02456683697119
25540,"Hartford-West Hartford-East Hartford, CT",2002,3133,713,3846,1169000,3.28999144568007
25540,"Hartford-West Hartford-East Hartford, CT",2003,3117,1020,4137,1179394,3.50773363269611
25540,"Hartford-West Hartford-East Hartford, CT",2004,3319,739,4058,1182605,3.43140778197285
25540,"Hartford-West Hartford-East Hartford, CT",2005,2902,1134,4036,1187929,3.39750944711342
25540,"Hartford-West Hartford-East Hartford, CT",2006,2697,941,3638,1193725,3.04760309116421
25540,"Hartford-West Hartford-East Hartford, CT",2007,1890,905,2795,1198395,2.33228609932451
25540,"Hartford-West Hartford-East Hartford, CT",2008,1098,593,1691,1204436,1.4039766330465
25540,"Hartford-West Hartford-East Hartford, CT",2009,1011,327,1338,1209604,1.10614713575683
25540,"Hartford-West Hartford-East Hartford, CT",2010,1067,212,1279,1214064,1.05348647188287
25540,"Hartford-West Hartford-East Hartford, CT",2011,759,364,1123,1215979,0.923535686060368
25540,"Hartford-West Hartford-East Hartford, CT",2012,939,384,1323,1215098,1.0888010678974
25540,"Hartford-West Hartford-East Hartford, CT",2013,959,520,1479,1214663,1.21762167778223
25540,"Hartford-West Hartford-East Hartford, CT",2014,754,639,1393,1213800,1.14763552479815
25540,"Hartford-West Hartford-East Hartford, CT",2015,788,794,1582,1211598,1.30571361128031
25540,"Hartford-West Hartford-East Hartford, CT",2016,872,1193,2065,1208416,1.70884860842624
25540,"Hartford-West Hartford-East Hartford, CT",2017,761,746,1507,1206719,1.248840865189
25540,"Hartford-West Hartford-East Hartford, CT",2018,807,780,1587,1206300,1.31559313603581
25580,"Hastings, NE",1990,22,24,46,29591,1.55452671420364
25580,"Hastings, NE",1991,43,2,45,29676,1.51637687019814
25580,"Hastings, NE",1992,47,0,47,29610,1.58730158730159
25580,"Hastings, NE",1993,53,162,215,29685,7.24271517601482
25580,"Hastings, NE",1994,77,125,202,29676,6.80684728400054
25580,"Hastings, NE",1995,55,50,105,29749,3.52953040438334
25580,"Hastings, NE",1996,73,108,181,29659,6.10270069793317
25580,"Hastings, NE",1997,70,18,88,29620,2.97096556380824
25580,"Hastings, NE",1998,62,20,82,29433,2.78598851629124
25580,"Hastings, NE",1999,73,8,81,29292,2.76526013928718
25580,"Hastings, NE",2000,81,4,85,31154,2.72838158823907
25580,"Hastings, NE",2001,77,0,77,31021,2.48218948454273
25580,"Hastings, NE",2002,83,4,87,30716,2.83240005209012
25580,"Hastings, NE",2003,123,104,227,30693,7.39582315185873
25580,"Hastings, NE",2004,152,124,276,30740,8.97852960312297
25580,"Hastings, NE",2005,145,36,181,30987,5.84115919579178
25580,"Hastings, NE",2006,144,8,152,30910,4.91750242639922
25580,"Hastings, NE",2007,101,12,113,30892,3.65790495921274
25580,"Hastings, NE",2008,55,4,59,31160,1.89345314505777
25580,"Hastings, NE",2009,78,16,94,31280,3.00511508951407
25580,"Hastings, NE",2010,68,108,176,31328,5.61797752808989
25580,"Hastings, NE",2011,62,64,126,31204,4.03794385335213
25580,"Hastings, NE",2012,61,10,71,31347,2.26496953456471
25580,"Hastings, NE",2013,71,11,82,31534,2.60036785691634
25580,"Hastings, NE",2014,95,25,120,31396,3.82214294814626
25580,"Hastings, NE",2015,48,20,68,31569,2.15401184706516
25580,"Hastings, NE",2016,71,0,71,31663,2.2423649054101
25580,"Hastings, NE",2017,57,0,57,31774,1.7939195568704
25580,"Hastings, NE",2018,38,0,38,31511,1.20592808860398
25620,"Hattiesburg, MS",1990,41,0,41,109658,0.373889729887468
25620,"Hattiesburg, MS",1991,35,0,35,110795,0.315898731892233
25620,"Hattiesburg, MS",1992,63,8,71,111745,0.635375184572017
25620,"Hattiesburg, MS",1993,71,0,71,113188,0.627274976145881
25620,"Hattiesburg, MS",1994,77,60,137,114935,1.19197807456388
25620,"Hattiesburg, MS",1995,69,122,191,117482,1.62578097070189
25620,"Hattiesburg, MS",1996,104,88,192,119659,1.60455962359705
25620,"Hattiesburg, MS",1997,107,42,149,121378,1.22757007035871
25620,"Hattiesburg, MS",1998,117,28,145,123362,1.17540247401955
25620,"Hattiesburg, MS",1999,111,54,165,124870,1.32137422919837
25620,"Hattiesburg, MS",2000,148,182,330,124342,2.65397050071577
25620,"Hattiesburg, MS",2001,124,130,254,125102,2.03034323991623
25620,"Hattiesburg, MS",2002,133,318,451,126193,3.57389078633522
25620,"Hattiesburg, MS",2003,119,14,133,127371,1.04419373326738
25620,"Hattiesburg, MS",2004,201,415,616,128966,4.7764527084658
25620,"Hattiesburg, MS",2005,181,60,241,130815,1.84229637274013
25620,"Hattiesburg, MS",2006,231,226,457,134167,3.40620271750878
25620,"Hattiesburg, MS",2007,297,834,1131,137293,8.2378562636114
25620,"Hattiesburg, MS",2008,231,517,748,139305,5.36951293923405
25620,"Hattiesburg, MS",2009,98,10,108,141266,0.764515169963048
25620,"Hattiesburg, MS",2010,74,0,74,143283,0.516460431453836
25620,"Hattiesburg, MS",2011,48,16,64,145306,0.440449809367817
25620,"Hattiesburg, MS",2012,58,170,228,146547,1.55581485803189
25620,"Hattiesburg, MS",2013,99,108,207,147766,1.40086352746911
25620,"Hattiesburg, MS",2014,55,111,166,148035,1.12135643597798
25620,"Hattiesburg, MS",2015,122,90,212,148655,1.42612088392587
25620,"Hattiesburg, MS",2016,101,73,174,149016,1.16765984860686
25620,"Hattiesburg, MS",2017,134,0,134,148719,0.901028113421957
25620,"Hattiesburg, MS",2018,102,4,106,149414,0.709438205255197
25700,"Hays, KS",1990,17,0,17,25949,0.655131218929438
25700,"Hays, KS",1991,28,0,28,25885,1.08170755263666
25700,"Hays, KS",1992,40,0,40,25975,1.53994225216554
25700,"Hays, KS",1993,57,34,91,26098,3.48685723043911
25700,"Hays, KS",1994,58,43,101,26242,3.8487920128039
25700,"Hays, KS",1995,39,85,124,26393,4.69821543591104
25700,"Hays, KS",1996,48,28,76,26304,2.88929440389294
25700,"Hays, KS",1997,29,23,52,26629,1.95275827105787
25700,"Hays, KS",1998,35,52,87,26588,3.27215285091018
25700,"Hays, KS",1999,31,16,47,26318,1.78584998860096
25700,"Hays, KS",2000,33,2,35,27454,1.2748597654258
25700,"Hays, KS",2001,46,12,58,27591,2.10213475408648
25700,"Hays, KS",2002,66,42,108,27532,3.92270812145867
25700,"Hays, KS",2003,68,59,127,27507,4.61700658014324
25700,"Hays, KS",2004,35,10,45,27457,1.63892632115672
25700,"Hays, KS",2005,47,8,55,27429,2.00517700244267
25700,"Hays, KS",2006,54,0,54,27653,1.95277185115539
25700,"Hays, KS",2007,53,14,67,27710,2.41789967520751
25700,"Hays, KS",2008,31,24,55,28010,1.96358443413067
25700,"Hays, KS",2009,45,14,59,28353,2.08090854583289
25700,"Hays, KS",2010,28,26,54,28424,1.89980298339431
25700,"Hays, KS",2011,39,57,96,28762,3.33773729226062
25700,"Hays, KS",2012,45,24,69,29086,2.3722753214605
25700,"Hays, KS",2013,45,34,79,29030,2.72132276954874
25700,"Hays, KS",2014,45,24,69,28963,2.38234989469323
25700,"Hays, KS",2015,44,20,64,29002,2.20674436245776
25700,"Hays, KS",2016,53,24,77,28948,2.65994196490258
25700,"Hays, KS",2017,46,29,75,28769,2.60697278320414
25700,"Hays, KS",2018,29,2,31,28710,1.07976314872867
25720,"Heber, UT",1990,75,18,93,10135,9.17612234829798
25720,"Heber, UT",1991,80,5,85,10412,8.16365731847868
25720,"Heber, UT",1992,111,33,144,10649,13.522396469152
25720,"Heber, UT",1993,128,37,165,10973,15.0369087760868
25720,"Heber, UT",1994,229,37,266,11436,23.2598810772998
25720,"Heber, UT",1995,259,28,287,11777,24.3695338371402
25720,"Heber, UT",1996,231,64,295,12284,24.0149788342559
25720,"Heber, UT",1997,179,6,185,12765,14.4927536231884
25720,"Heber, UT",1998,219,86,305,13299,22.9340551921197
25720,"Heber, UT",1999,411,172,583,13813,42.2066169550423
25720,"Heber, UT",2000,318,0,318,15421,20.6212307891836
25720,"Heber, UT",2001,278,9,287,16205,17.7105831533477
25720,"Heber, UT",2002,249,140,389,16975,22.9160530191458
25720,"Heber, UT",2003,269,0,269,17765,15.1421334083873
25720,"Heber, UT",2004,318,28,346,18349,18.8566134394245
25720,"Heber, UT",2005,475,18,493,19410,25.3992787223081
25720,"Heber, UT",2006,558,50,608,20755,29.2941459889183
25720,"Heber, UT",2007,415,4,419,21413,19.5675524214262
25720,"Heber, UT",2008,162,75,237,22120,10.7142857142857
25720,"Heber, UT",2009,89,0,89,22886,3.88884033907192
25720,"Heber, UT",2010,101,168,269,23644,11.3770935543901
25720,"Heber, UT",2011,152,53,205,24408,8.39888561127499
25720,"Heber, UT",2012,196,40,236,25345,9.3115012823042
25720,"Heber, UT",2013,385,10,395,26589,14.855767422618401
25720,"Heber, UT",2014,407,29,436,27822,15.6710516857163
25720,"Heber, UT",2015,477,75,552,29147,18.9384842350842
25720,"Heber, UT",2016,521,164,685,30430,22.5106802497535
25720,"Heber, UT",2017,507,40,547,31975,17.1071149335418
25720,"Heber, UT",2018,389,136,525,33240,15.7942238267148
25740,"Helena, MT",1990,39,104,143,55559,2.57384042189384
25740,"Helena, MT",1991,32,9,41,56377,0.72724692693829
25740,"Helena, MT",1992,56,28,84,57822,1.45273425339836
25740,"Helena, MT",1993,61,30,91,59365,1.53288974985261
25740,"Helena, MT",1994,62,65,127,60506,2.09896539186196
25740,"Helena, MT",1995,35,128,163,61969,2.63034743178041
25740,"Helena, MT",1996,51,182,233,62930,3.70252661687589
25740,"Helena, MT",1997,31,74,105,63122,1.66344539146415
25740,"Helena, MT",1998,47,24,71,63716,1.11431979408626
25740,"Helena, MT",1999,37,16,53,64414,0.822802496351725
25740,"Helena, MT",2000,43,59,102,65938,1.54690770117383
25740,"Helena, MT",2001,57,4,61,66349,0.919380849749054
25740,"Helena, MT",2002,62,52,114,66452,1.71552398723891
25740,"Helena, MT",2003,73,56,129,67372,1.91474202932969
25740,"Helena, MT",2004,111,34,145,68552,2.11518263507994
25740,"Helena, MT",2005,108,144,252,69238,3.63961986192553
25740,"Helena, MT",2006,104,76,180,70330,2.55936300298592
25740,"Helena, MT",2007,62,93,155,71686,2.16220740451413
25740,"Helena, MT",2008,48,31,79,72950,1.08293351610692
25740,"Helena, MT",2009,66,30,96,74035,1.29668400081043
25740,"Helena, MT",2010,80,89,169,74983,2.2538442046864
25740,"Helena, MT",2011,84,73,157,75637,2.07570368999299
25740,"Helena, MT",2012,76,106,182,76048,2.39322533136966
25740,"Helena, MT",2013,62,71,133,76688,1.73430002086376
25740,"Helena, MT",2014,53,286,339,77206,4.39085045203741
25740,"Helena, MT",2015,79,94,173,77802,2.22359322382458
25740,"Helena, MT",2016,57,124,181,78680,2.30045754956787
25740,"Helena, MT",2017,50,102,152,79786,1.90509613215351
25740,"Helena, MT",2018,62,133,195,80797,2.41345594514648
25760,"Helena-West Helena, AR",1990,7,2,9,28773,0.312793243665937
25760,"Helena-West Helena, AR",1991,11,0,11,28192,0.390181611804767
25760,"Helena-West Helena, AR",1992,8,0,8,28114,0.284555737355054
25760,"Helena-West Helena, AR",1993,5,0,5,28116,0.177834684876938
25760,"Helena-West Helena, AR",1994,5,0,5,28140,0.177683013503909
25760,"Helena-West Helena, AR",1995,9,15,24,27943,0.858891314461583
25760,"Helena-West Helena, AR",1996,13,33,46,27741,1.65819545077683
25760,"Helena-West Helena, AR",1997,16,4,20,27689,0.722308497959478
25760,"Helena-West Helena, AR",1998,31,0,31,27337,1.13399422028752
25760,"Helena-West Helena, AR",1999,39,0,39,27007,1.44407005591143
25760,"Helena-West Helena, AR",2000,9,0,9,26290,0.342335488779003
25760,"Helena-West Helena, AR",2001,11,0,11,25821,0.426009836954417
25760,"Helena-West Helena, AR",2002,15,0,15,25067,0.59839629792157
25760,"Helena-West Helena, AR",2003,2,0,2,24520,0.0815660685154976
25760,"Helena-West Helena, AR",2004,2,0,2,24174,0.0827335153470671
25760,"Helena-West Helena, AR",2005,3,0,3,23946,0.125281884239539
25760,"Helena-West Helena, AR",2006,2,0,2,23244,0.086043710204784
25760,"Helena-West Helena, AR",2007,2,0,2,22775,0.0878155872667399
25760,"Helena-West Helena, AR",2008,3,0,3,22411,0.13386283521485
25760,"Helena-West Helena, AR",2009,2,0,2,21976,0.0910083727702949
25760,"Helena-West Helena, AR",2010,2,0,2,21676,0.0922679461155195
25760,"Helena-West Helena, AR",2011,29,0,29,21407,1.35469706170879
25760,"Helena-West Helena, AR",2012,30,0,30,20740,1.44648023143684
25760,"Helena-West Helena, AR",2013,36,0,36,20443,1.76099398327056
25760,"Helena-West Helena, AR",2014,34,0,34,19960,1.70340681362725
25760,"Helena-West Helena, AR",2015,1,39,40,19557,2.04530347190264
25760,"Helena-West Helena, AR",2016,1,39,40,19062,2.09841569614941
25760,"Helena-West Helena, AR",2017,2,44,46,18564,2.47791424262013
25760,"Helena-West Helena, AR",2018,2,40,42,18029,2.3295801209163
25780,"Henderson, NC",1990,21,22,43,39043,1.10134979381707
25780,"Henderson, NC",1991,187,27,214,39341,5.43961770163443
25780,"Henderson, NC",1992,79,59,138,39730,3.47344575887239
25780,"Henderson, NC",1993,220,20,240,40018,5.9973012144535
25780,"Henderson, NC",1994,185,14,199,40459,4.91855952940013
25780,"Henderson, NC",1995,162,14,176,40626,4.33220105351253
25780,"Henderson, NC",1996,100,22,122,41089,2.96916449658059
25780,"Henderson, NC",1997,105,2,107,41603,2.5719299089008
25780,"Henderson, NC",1998,105,83,188,42058,4.47001759475011
25780,"Henderson, NC",1999,105,24,129,42564,3.03073019453059
25780,"Henderson, NC",2000,136,2,138,43159,3.19747908895016
25780,"Henderson, NC",2001,115,0,115,43932,2.61768187198397
25780,"Henderson, NC",2002,126,0,126,44056,2.85999636825858
25780,"Henderson, NC",2003,146,2,148,44030,3.36134453781513
25780,"Henderson, NC",2004,122,2,124,44081,2.81300333477008
25780,"Henderson, NC",2005,118,0,118,44136,2.67355446800798
25780,"Henderson, NC",2006,105,0,105,44574,2.35563332884641
25780,"Henderson, NC",2007,90,0,90,44676,2.01450443190975
25780,"Henderson, NC",2008,80,0,80,44977,1.77868688440759
25780,"Henderson, NC",2009,47,0,47,45223,1.03929416447383
25780,"Henderson, NC",2010,43,40,83,45301,1.83218913489768
25780,"Henderson, NC",2011,36,0,36,45297,0.794754619511226
25780,"Henderson, NC",2012,35,0,35,45104,0.775984391628237
25780,"Henderson, NC",2013,30,0,30,44505,0.674081563869228
25780,"Henderson, NC",2014,26,0,26,44537,0.583784269259268
25780,"Henderson, NC",2015,74,0,74,44480,1.6636690647482
25780,"Henderson, NC",2016,35,0,35,44500,0.786516853932584
25780,"Henderson, NC",2017,60,0,60,44312,1.35403502437263
25780,"Henderson, NC",2018,44,0,44,44582,0.986945403974698
25820,"Hereford, TX",1990,4,27,31,19170,1.61711006781429
25820,"Hereford, TX",1991,2,0,2,18800,0.106382978723404
25820,"Hereford, TX",1992,1,0,1,18763,0.0532963811757182
25820,"Hereford, TX",1993,2,0,2,19049,0.104992388051866
25820,"Hereford, TX",1994,3,0,3,19090,0.157150340492404
25820,"Hereford, TX",1995,10,28,38,19228,1.97628458498024
25820,"Hereford, TX",1996,2,0,2,19202,0.104155817102385
25820,"Hereford, TX",1997,2,0,2,19190,0.104220948410631
25820,"Hereford, TX",1998,1,0,1,19089,0.0523861910000524
25820,"Hereford, TX",1999,2,0,2,18858,0.10605578534309
25820,"Hereford, TX",2000,3,0,3,18515,0.162030785849311
25820,"Hereford, TX",2001,1,0,1,18391,0.0543744222717634
25820,"Hereford, TX",2002,2,0,2,18439,0.108465751938825
25820,"Hereford, TX",2003,3,0,3,18454,0.162566381272353
25820,"Hereford, TX",2004,6,0,6,18671,0.321353971399497
25820,"Hereford, TX",2005,17,2,19,18737,1.01403639856967
25820,"Hereford, TX",2006,17,110,127,18770,6.76611614278103
25820,"Hereford, TX",2007,25,0,25,18916,1.32163248043984
25820,"Hereford, TX",2008,10,0,10,19054,0.524824183898394
25820,"Hereford, TX",2009,2,0,2,19084,0.104799832320268
25820,"Hereford, TX",2010,1,0,1,19465,0.051374261494991
25820,"Hereford, TX",2011,4,0,4,19522,0.204897039237783
25820,"Hereford, TX",2012,1,2,3,19381,0.154790774469842
25820,"Hereford, TX",2013,3,7,10,19195,0.52096900234436
25820,"Hereford, TX",2014,2,8,10,19139,0.522493338209938
25820,"Hereford, TX",2015,2,8,10,18851,0.530475836825633
25820,"Hereford, TX",2016,2,9,11,18894,0.582195405948979
25820,"Hereford, TX",2017,1,0,1,18851,0.0530475836825633
25820,"Hereford, TX",2018,2,0,2,18760,0.106609808102345
25840,"Hermiston-Pendleton, OR",1990,39,2,41,66973,0.612187000731638
25840,"Hermiston-Pendleton, OR",1991,33,0,33,68068,0.48480930833872
25840,"Hermiston-Pendleton, OR",1992,53,10,63,69324,0.908776181409036
25840,"Hermiston-Pendleton, OR",1993,69,2,71,70764,1.00333502911085
25840,"Hermiston-Pendleton, OR",1994,73,14,87,71726,1.21294927920141
25840,"Hermiston-Pendleton, OR",1995,76,77,153,72806,2.10147515314672
25840,"Hermiston-Pendleton, OR",1996,65,56,121,73409,1.64829925485976
25840,"Hermiston-Pendleton, OR",1997,127,53,180,64380,2.79589934762349
25840,"Hermiston-Pendleton, OR",1998,127,160,287,65542,4.37887156327241
25840,"Hermiston-Pendleton, OR",1999,154,103,257,66735,3.85105267101221
25840,"Hermiston-Pendleton, OR",2000,108,36,144,70728,2.03596878181201
25840,"Hermiston-Pendleton, OR",2001,134,34,168,70682,2.37684276053309
25840,"Hermiston-Pendleton, OR",2002,189,136,325,72150,4.5045045045045
25840,"Hermiston-Pendleton, OR",2003,175,24,199,84137,2.36519010661184
25840,"Hermiston-Pendleton, OR",2004,152,46,198,84738,2.3366140338455
25840,"Hermiston-Pendleton, OR",2005,151,79,230,84927,2.70820822588812
25840,"Hermiston-Pendleton, OR",2006,161,44,205,85187,2.40647047084649
25840,"Hermiston-Pendleton, OR",2007,121,20,141,85317,1.65266007946834
25840,"Hermiston-Pendleton, OR",2008,71,8,79,85490,0.924084688267634
25840,"Hermiston-Pendleton, OR",2009,48,18,66,86301,0.764765182326972
25840,"Hermiston-Pendleton, OR",2010,71,12,83,87306,0.95067922021396
25840,"Hermiston-Pendleton, OR",2011,57,50,107,88030,1.21549471770987
25840,"Hermiston-Pendleton, OR",2012,57,4,61,88241,0.691288630001927
25840,"Hermiston-Pendleton, OR",2013,74,24,98,88099,1.11238493058945
25840,"Hermiston-Pendleton, OR",2014,109,0,109,87818,1.24120339793664
25840,"Hermiston-Pendleton, OR",2015,97,2,99,87645,1.12955673455417
25840,"Hermiston-Pendleton, OR",2016,105,0,105,87903,1.1944984812805
25840,"Hermiston-Pendleton, OR",2017,134,26,160,88311,1.81177882709968
25840,"Hermiston-Pendleton, OR",2018,184,120,304,88888,3.420034200342
25860,"Hickory-Lenoir-Morganton, NC",1990,1135,284,1419,293198,4.83973287675905
25860,"Hickory-Lenoir-Morganton, NC",1991,1167,142,1309,295549,4.42904560665067
25860,"Hickory-Lenoir-Morganton, NC",1992,1309,124,1433,298294,4.80398532990942
25860,"Hickory-Lenoir-Morganton, NC",1993,1449,149,1598,301865,5.29375714309377
25860,"Hickory-Lenoir-Morganton, NC",1994,1365,182,1547,305742,5.05982167971688
25860,"Hickory-Lenoir-Morganton, NC",1995,1366,153,1519,309962,4.90060071879779
25860,"Hickory-Lenoir-Morganton, NC",1996,1747,291,2038,313941,6.4916656314403
25860,"Hickory-Lenoir-Morganton, NC",1997,1563,308,1871,318135,5.88115108365945
25860,"Hickory-Lenoir-Morganton, NC",1998,1700,609,2309,322025,7.17025075692881
25860,"Hickory-Lenoir-Morganton, NC",1999,1887,272,2159,325646,6.62989872438169
25860,"Hickory-Lenoir-Morganton, NC",2000,2004,186,2190,343247,6.38024512960055
25860,"Hickory-Lenoir-Morganton, NC",2001,1845,587,2432,346952,7.00961516290438
25860,"Hickory-Lenoir-Morganton, NC",2002,1706,169,1875,348299,5.38330572295643
25860,"Hickory-Lenoir-Morganton, NC",2003,1504,115,1619,349472,4.63270304917132
25860,"Hickory-Lenoir-Morganton, NC",2004,1575,310,1885,351224,5.36694531125436
25860,"Hickory-Lenoir-Morganton, NC",2005,1491,135,1626,354159,4.59115820860122
25860,"Hickory-Lenoir-Morganton, NC",2006,1489,64,1553,357492,4.34415315587482
25860,"Hickory-Lenoir-Morganton, NC",2007,1594,74,1668,360791,4.62317519006849
25860,"Hickory-Lenoir-Morganton, NC",2008,898,28,926,364003,2.54393507745815
25860,"Hickory-Lenoir-Morganton, NC",2009,589,12,601,365639,1.6436977455906
25860,"Hickory-Lenoir-Morganton, NC",2010,398,50,448,365597,1.2253929873604
25860,"Hickory-Lenoir-Morganton, NC",2011,336,44,380,364479,1.04258407205902
25860,"Hickory-Lenoir-Morganton, NC",2012,293,42,335,363685,0.921126799290595
25860,"Hickory-Lenoir-Morganton, NC",2013,426,2,428,363417,1.17771045383127
25860,"Hickory-Lenoir-Morganton, NC",2014,454,140,594,363085,1.6359805555173
25860,"Hickory-Lenoir-Morganton, NC",2015,538,267,805,363367,2.21539105092097
25860,"Hickory-Lenoir-Morganton, NC",2016,587,68,655,364818,1.7954157963697
25860,"Hickory-Lenoir-Morganton, NC",2017,725,155,880,367004,2.39779402949287
25860,"Hickory-Lenoir-Morganton, NC",2018,893,443,1336,368416,3.62633544688613
25880,"Hillsdale, MI",1990,139,69,208,43514,4.78007078181735
25880,"Hillsdale, MI",1991,232,2,234,44049,5.31226588571818
25880,"Hillsdale, MI",1992,201,98,299,44346,6.74243449240067
25880,"Hillsdale, MI",1993,181,9,190,44326,4.28642331814285
25880,"Hillsdale, MI",1994,239,4,243,44900,5.41202672605791
25880,"Hillsdale, MI",1995,219,0,219,45304,4.83401024192124
25880,"Hillsdale, MI",1996,257,0,257,45856,5.60450104675506
25880,"Hillsdale, MI",1997,301,6,307,46393,6.61737762162395
25880,"Hillsdale, MI",1998,286,0,286,46579,6.14010605637734
25880,"Hillsdale, MI",1999,307,8,315,47038,6.69671329563332
25880,"Hillsdale, MI",2000,263,68,331,46698,7.08809799134867
25880,"Hillsdale, MI",2001,249,52,301,46736,6.44043135912359
25880,"Hillsdale, MI",2002,258,2,260,47051,5.52591868398121
25880,"Hillsdale, MI",2003,274,6,280,47359,5.91228699930319
25880,"Hillsdale, MI",2004,241,14,255,47392,5.38065496286293
25880,"Hillsdale, MI",2005,199,6,205,47476,4.31797118544107
25880,"Hillsdale, MI",2006,134,3,137,47499,2.88427124781574
25880,"Hillsdale, MI",2007,91,0,91,47336,1.92242690552645
25880,"Hillsdale, MI",2008,46,0,46,46951,0.979744840365487
25880,"Hillsdale, MI",2009,36,0,36,46735,0.770300631218573
25880,"Hillsdale, MI",2010,46,0,46,46642,0.986235581664594
25880,"Hillsdale, MI",2011,28,0,28,46589,0.601000236107236
25880,"Hillsdale, MI",2012,35,8,43,46258,0.929568939426694
25880,"Hillsdale, MI",2013,38,0,38,46125,0.823848238482385
25880,"Hillsdale, MI",2014,34,0,34,45923,0.740369749363064
25880,"Hillsdale, MI",2015,54,52,106,45872,2.31077781653296
25880,"Hillsdale, MI",2016,55,57,112,45763,2.44739199790224
25880,"Hillsdale, MI",2017,48,40,88,45843,1.91959513993412
25880,"Hillsdale, MI",2018,66,0,66,45749,1.44265448425102
25900,"Hilo, HI",1990,2025,644,2669,121460,21.9743125308744
25900,"Hilo, HI",1991,2309,609,2918,126681,23.0342355996558
25900,"Hilo, HI",1992,1501,121,1622,130542,12.425119884788
25900,"Hilo, HI",1993,1540,184,1724,133477,12.916082920653
25900,"Hilo, HI",1994,1052,123,1175,135574,8.66685352648738
25900,"Hilo, HI",1995,1003,88,1091,137803,7.91709904719055
25900,"Hilo, HI",1996,726,77,803,138708,5.7891397756438
25900,"Hilo, HI",1997,649,69,718,140646,5.10501542880708
25900,"Hilo, HI",1998,759,53,812,141479,5.73936768000905
25900,"Hilo, HI",1999,1004,94,1098,142063,7.7289653182039
25900,"Hilo, HI",2000,1356,147,1503,149244,10.0707566133312
25900,"Hilo, HI",2001,1249,138,1387,151690,9.14364822994265
25900,"Hilo, HI",2002,1303,138,1441,154576,9.32227512679847
25900,"Hilo, HI",2003,1941,239,2180,158442,13.7589780487497
25900,"Hilo, HI",2004,2169,866,3035,162852,18.6365534350208
25900,"Hilo, HI",2005,2700,658,3358,168237,19.9599374691655
25900,"Hilo, HI",2006,2306,298,2604,173536,15.0055319933616
25900,"Hilo, HI",2007,1785,309,2094,177733,11.7817175201004
25900,"Hilo, HI",2008,1000,446,1446,181506,7.9666787874781
25900,"Hilo, HI",2009,647,34,681,183629,3.70856455135082
25900,"Hilo, HI",2010,660,442,1102,185358,5.94525189093538
25900,"Hilo, HI",2011,582,107,689,187066,3.68319202848193
25900,"Hilo, HI",2012,571,63,634,189164,3.35158909729124
25900,"Hilo, HI",2013,729,0,729,191466,3.8074645106703
25900,"Hilo, HI",2014,806,152,958,193736,4.94487343601602
25900,"Hilo, HI",2015,837,45,882,195941,4.5013549997193
25900,"Hilo, HI",2016,792,186,978,198126,4.9362526876836
25900,"Hilo, HI",2017,801,93,894,199503,4.48113562202072
25900,"Hilo, HI",2018,1035,8,1043,200983,5.18949363876547
25940,"Hilton Head Island-Bluffton-Beaufort, SC",1990,897,131,1028,102559,10.0234986690588
25940,"Hilton Head Island-Bluffton-Beaufort, SC",1991,786,143,929,104968,8.85031628686838
25940,"Hilton Head Island-Bluffton-Beaufort, SC",1992,915,230,1145,107627,10.6385944047497
25940,"Hilton Head Island-Bluffton-Beaufort, SC",1993,1021,251,1272,110847,11.4752767327939
25940,"Hilton Head Island-Bluffton-Beaufort, SC",1994,1313,582,1895,114285,16.5813536334602
25940,"Hilton Head Island-Bluffton-Beaufort, SC",1995,1521,620,2141,117504,18.2206563180828
25940,"Hilton Head Island-Bluffton-Beaufort, SC",1996,1814,701,2515,121279,20.7373081902061
25940,"Hilton Head Island-Bluffton-Beaufort, SC",1997,1843,641,2484,124992,19.8732718894009
25940,"Hilton Head Island-Bluffton-Beaufort, SC",1998,2062,514,2576,127875,20.1446725317693
25940,"Hilton Head Island-Bluffton-Beaufort, SC",1999,2367,662,3029,129150,23.4533488192025
25940,"Hilton Head Island-Bluffton-Beaufort, SC",2000,2058,703,2761,143027,19.3040474875373
25940,"Hilton Head Island-Bluffton-Beaufort, SC",2001,1890,287,2177,146574,14.852565939389
25940,"Hilton Head Island-Bluffton-Beaufort, SC",2002,2454,272,2726,150392,18.1259641470291
25940,"Hilton Head Island-Bluffton-Beaufort, SC",2003,2798,72,2870,152234,18.8525559336285
25940,"Hilton Head Island-Bluffton-Beaufort, SC",2004,2794,264,3058,157787,19.3805573336206
25940,"Hilton Head Island-Bluffton-Beaufort, SC",2005,4194,654,4848,163343,29.6798760889662
25940,"Hilton Head Island-Bluffton-Beaufort, SC",2006,3556,179,3735,169619,22.0199388040255
25940,"Hilton Head Island-Bluffton-Beaufort, SC",2007,2142,593,2735,174382,15.6839582066956
25940,"Hilton Head Island-Bluffton-Beaufort, SC",2008,1187,827,2014,180019,11.1877079641593
25940,"Hilton Head Island-Bluffton-Beaufort, SC",2009,416,18,434,183971,2.35906746171951
25940,"Hilton Head Island-Bluffton-Beaufort, SC",2010,362,50,412,187777,2.19409192819142
25940,"Hilton Head Island-Bluffton-Beaufort, SC",2011,418,219,637,189307,3.36490462581944
25940,"Hilton Head Island-Bluffton-Beaufort, SC",2012,512,87,599,193125,3.10161812297735
25940,"Hilton Head Island-Bluffton-Beaufort, SC",2013,1156,46,1202,197284,6.09273940106648
25940,"Hilton Head Island-Bluffton-Beaufort, SC",2014,1426,0,1426,201717,7.06930997387429
25940,"Hilton Head Island-Bluffton-Beaufort, SC",2015,1688,414,2102,207253,10.1421933578766
25940,"Hilton Head Island-Bluffton-Beaufort, SC",2016,1675,109,1784,211246,8.44513032199426
25940,"Hilton Head Island-Bluffton-Beaufort, SC",2017,2034,241,2275,214890,10.5868118572293
25940,"Hilton Head Island-Bluffton-Beaufort, SC",2018,2308,28,2336,217686,10.7310529845741
25980,"Hinesville, GA",1990,262,4,266,52846,5.03349354728835
25980,"Hinesville, GA",1991,441,16,457,53574,8.53025721432038
25980,"Hinesville, GA",1992,507,4,511,57358,8.90895777398096
25980,"Hinesville, GA",1993,542,0,542,56580,9.57935666313185
25980,"Hinesville, GA",1994,582,60,642,58746,10.9284036359922
25980,"Hinesville, GA",1995,810,70,880,58522,15.0370800724514
25980,"Hinesville, GA",1996,622,28,650,59035,11.0104175489117
25980,"Hinesville, GA",1997,329,124,453,60075,7.54057428214732
25980,"Hinesville, GA",1998,293,46,339,58972,5.74849080919758
25980,"Hinesville, GA",1999,263,53,316,59439,5.3163747707734
25980,"Hinesville, GA",2000,177,44,221,61811,3.57541537913964
25980,"Hinesville, GA",2001,197,136,333,61388,5.42451293412393
25980,"Hinesville, GA",2002,230,176,406,62505,6.49548036157107
25980,"Hinesville, GA",2003,264,72,336,60403,5.56263761733689
25980,"Hinesville, GA",2004,311,10,321,63254,5.07477787965978
25980,"Hinesville, GA",2005,335,2,337,64718,5.20720665039093
25980,"Hinesville, GA",2006,259,12,271,63047,4.29838057322315
25980,"Hinesville, GA",2007,211,264,475,63708,7.45589250957494
25980,"Hinesville, GA",2008,222,0,222,62635,3.54434421649238
25980,"Hinesville, GA",2009,135,252,387,67061,5.7708653315638
25980,"Hinesville, GA",2010,111,0,111,62765,1.76850155341353
25980,"Hinesville, GA",2011,201,0,201,65170,3.08424121528311
25980,"Hinesville, GA",2012,219,0,219,64415,3.39982923232166
25980,"Hinesville, GA",2013,192,0,192,62350,3.07939053728949
25980,"Hinesville, GA",2014,198,44,242,64107,3.77493877423682
25980,"Hinesville, GA",2015,467,78,545,79286,6.87384910324647
25980,"Hinesville, GA",2016,417,0,417,79898,5.21915442188791
25980,"Hinesville, GA",2017,443,62,505,80518,6.27188951538786
25980,"Hinesville, GA",2018,398,0,398,80495,4.94440648487484
26020,"Hobbs, NM",1990,0,0,0,55494,0
26020,"Hobbs, NM",1991,5,0,5,55275,0.0904568068747173
26020,"Hobbs, NM",1992,1,0,1,56298,0.0177626203417528
26020,"Hobbs, NM",1993,13,17,30,56490,0.531067445565587
26020,"Hobbs, NM",1994,15,0,15,56797,0.264098455904361
26020,"Hobbs, NM",1995,17,0,17,56352,0.301675184554231
26020,"Hobbs, NM",1996,15,0,15,56234,0.266742540100295
26020,"Hobbs, NM",1997,12,78,90,56073,1.60505055909261
26020,"Hobbs, NM",1998,11,42,53,56504,0.937986691207702
26020,"Hobbs, NM",1999,1,0,1,55947,0.0178740593776253
26020,"Hobbs, NM",2000,2,0,2,55264,0.0361899247249566
26020,"Hobbs, NM",2001,10,0,10,55377,0.180580385358542
26020,"Hobbs, NM",2002,12,0,12,56340,0.212992545260916
26020,"Hobbs, NM",2003,29,9,38,56643,0.670868421517222
26020,"Hobbs, NM",2004,47,60,107,57471,1.8618085643194
26020,"Hobbs, NM",2005,45,0,45,58331,0.771459429805764
26020,"Hobbs, NM",2006,58,10,68,59541,1.1420701701348701
26020,"Hobbs, NM",2007,113,18,131,61058,2.14550099905008
26020,"Hobbs, NM",2008,93,22,115,62737,1.83304907789662
26020,"Hobbs, NM",2009,17,8,25,64483,0.387699083479367
26020,"Hobbs, NM",2010,17,60,77,64599,1.19196891592749
26020,"Hobbs, NM",2011,20,8,28,65130,0.42990941194534
26020,"Hobbs, NM",2012,38,45,83,66382,1.25033894730499
26020,"Hobbs, NM",2013,61,40,101,68644,1.4713594778859
26020,"Hobbs, NM",2014,189,87,276,70211,3.9310079617154
26020,"Hobbs, NM",2015,175,245,420,71496,5.8744545149379
26020,"Hobbs, NM",2016,151,86,237,70254,3.37347339653258
26020,"Hobbs, NM",2017,82,0,82,69057,1.18742488089549
26020,"Hobbs, NM",2018,166,0,166,69611,2.38468058209191
26090,"Holland, MI",1990,403,46,449,90959,4.93628997680274
26090,"Holland, MI",1991,447,28,475,91902,5.16854910665709
26090,"Holland, MI",1992,482,87,569,93082,6.11288971014804
26090,"Holland, MI",1993,487,26,513,94482,5.42960563916937
26090,"Holland, MI",1994,547,54,601,95872,6.26877503337784
26090,"Holland, MI",1995,510,26,536,97412,5.5024021681107
26090,"Holland, MI",1996,653,34,687,98921,6.94493585790681
26090,"Holland, MI",1997,580,57,637,100485,6.33925461511668
26090,"Holland, MI",1998,679,25,704,101679,6.92375023357822
26090,"Holland, MI",1999,737,65,802,103492,7.74939125729525
26090,"Holland, MI",2000,642,47,689,105904,6.50589212872035
26090,"Holland, MI",2001,644,156,800,107367,7.45107900937905
26090,"Holland, MI",2002,628,46,674,108203,6.22903246675231
26090,"Holland, MI",2003,736,90,826,109192,7.56465675141036
26090,"Holland, MI",2004,833,93,926,110225,8.4009979587208
26090,"Holland, MI",2005,703,10,713,110865,6.43124520813602
26090,"Holland, MI",2006,623,58,681,111156,6.12652488394689
26090,"Holland, MI",2007,371,0,371,111427,3.32953413445574
26090,"Holland, MI",2008,297,0,297,111589,2.66155266200074
26090,"Holland, MI",2009,251,0,251,111252,2.25613921547478
26090,"Holland, MI",2010,148,4,152,111528,1.36288645003945
26090,"Holland, MI",2011,125,20,145,111158,1.30444952230159
26090,"Holland, MI",2012,205,0,205,111499,1.83858151194181
26090,"Holland, MI",2013,305,4,309,112013,2.75860837581352
26090,"Holland, MI",2014,348,0,348,113357,3.06994715809346
26090,"Holland, MI",2015,361,8,369,114136,3.23298521062592
26090,"Holland, MI",2016,331,18,349,114995,3.03491456150267
26090,"Holland, MI",2017,383,8,391,116433,3.35815447510585
26090,"Holland, MI",2018,434,2,436,117327,3.71610967637458
26140,"Homosassa Springs, FL",1990,1290,69,1359,94627,14.3616515370877
26140,"Homosassa Springs, FL",1991,1063,16,1079,97476,11.0693914399442
26140,"Homosassa Springs, FL",1992,1098,5,1103,100037,11.0259204094485
26140,"Homosassa Springs, FL",1993,1195,85,1280,101725,12.5829442123372
26140,"Homosassa Springs, FL",1994,1219,8,1227,104092,11.7876493870807
26140,"Homosassa Springs, FL",1995,1052,9,1061,107153,9.90172930295932
26140,"Homosassa Springs, FL",1996,967,0,967,109435,8.83629551788733
26140,"Homosassa Springs, FL",1997,1039,16,1055,111361,9.47369366295202
26140,"Homosassa Springs, FL",1998,1082,6,1088,113637,9.57434638366025
26140,"Homosassa Springs, FL",1999,1050,36,1086,115829,9.37589032107676
26140,"Homosassa Springs, FL",2000,1176,14,1190,118649,10.0295830559044
26140,"Homosassa Springs, FL",2001,1201,44,1245,121197,10.2725314983044
26140,"Homosassa Springs, FL",2002,1271,0,1271,123491,10.2922480180742
26140,"Homosassa Springs, FL",2003,1850,0,1850,126215,14.6575288198709
26140,"Homosassa Springs, FL",2004,2527,4,2531,129840,19.4932224276032
26140,"Homosassa Springs, FL",2005,3579,2,3581,133791,26.7656269853727
26140,"Homosassa Springs, FL",2006,2056,41,2097,137826,15.2148360976884
26140,"Homosassa Springs, FL",2007,933,31,964,140974,6.83814036630868
26140,"Homosassa Springs, FL",2008,750,20,770,142122,5.41788041260326
26140,"Homosassa Springs, FL",2009,480,4,484,141381,3.42337372065553
26140,"Homosassa Springs, FL",2010,187,12,199,141171,1.40963795680416
26140,"Homosassa Springs, FL",2011,142,0,142,139756,1.01605655571138
26140,"Homosassa Springs, FL",2012,171,5,176,139175,1.26459493443506
26140,"Homosassa Springs, FL",2013,201,0,201,138830,1.44781387308219
26140,"Homosassa Springs, FL",2014,233,0,233,138833,1.67827533799601
26140,"Homosassa Springs, FL",2015,354,24,378,140311,2.69401543713608
26140,"Homosassa Springs, FL",2016,371,145,516,142850,3.61218060903045
26140,"Homosassa Springs, FL",2017,433,113,546,145512,3.75226785419759
26140,"Homosassa Springs, FL",2018,884,0,884,147929,5.97583976096641
26220,"Hood River, OR",1990,59,16,75,16952,4.42425672487022
26220,"Hood River, OR",1991,54,0,54,16972,3.18171105349988
26220,"Hood River, OR",1992,48,2,50,17414,2.87125301481567
26220,"Hood River, OR",1993,58,45,103,17860,5.76707726763718
26220,"Hood River, OR",1994,70,18,88,18247,4.82271058256152
26220,"Hood River, OR",1995,68,26,94,18720,5.02136752136752
26220,"Hood River, OR",1996,61,50,111,19101,5.81121407256165
26220,"Hood River, OR",1997,64,8,72,19251,3.74006545114539
26220,"Hood River, OR",1998,77,4,81,19604,4.13180983472761
26220,"Hood River, OR",1999,99,12,111,19833,5.59673271819694
26220,"Hood River, OR",2000,88,21,109,20461,5.32720785885343
26220,"Hood River, OR",2001,109,17,126,20397,6.1773790263274
26220,"Hood River, OR",2002,143,0,143,20615,6.93669658016008
26220,"Hood River, OR",2003,156,10,166,20621,8.05004606954076
26220,"Hood River, OR",2004,155,4,159,20835,7.63138948884089
26220,"Hood River, OR",2005,166,0,166,21022,7.89648939206546
26220,"Hood River, OR",2006,141,44,185,21200,8.72641509433962
26220,"Hood River, OR",2007,151,0,151,21276,7.0971987215642
26220,"Hood River, OR",2008,54,5,59,21589,2.73287322247441
26220,"Hood River, OR",2009,43,6,49,22015,2.22575516693164
26220,"Hood River, OR",2010,48,40,88,22445,3.92069503230118
26220,"Hood River, OR",2011,58,14,72,22442,3.20827020764638
26220,"Hood River, OR",2012,74,4,78,22558,3.45775334692792
26220,"Hood River, OR",2013,90,13,103,22594,4.55873240683367
26220,"Hood River, OR",2014,74,14,88,22695,3.87750605860322
26220,"Hood River, OR",2015,82,16,98,22955,4.26922239163581
26220,"Hood River, OR",2016,105,0,105,23103,4.54486430333723
26220,"Hood River, OR",2017,83,24,107,23476,4.55784631112626
26220,"Hood River, OR",2018,112,28,140,23428,5.97575550623186
26300,"Hot Springs, AR",1990,50,20,70,73502,0.952355037958151
26300,"Hot Springs, AR",1991,57,8,65,74532,0.872108624483443
26300,"Hot Springs, AR",1992,86,8,94,75978,1.23720024217537
26300,"Hot Springs, AR",1993,79,8,87,77718,1.11943179186289
26300,"Hot Springs, AR",1994,82,36,118,79534,1.48364221590766
26300,"Hot Springs, AR",1995,108,20,128,80588,1.58832580533082
26300,"Hot Springs, AR",1996,130,55,185,81886,2.25923845345969
26300,"Hot Springs, AR",1997,109,267,376,82987,4.53083013002037
26300,"Hot Springs, AR",1998,101,10,111,83832,1.32407672487833
26300,"Hot Springs, AR",1999,117,5,122,84529,1.44329165138591
26300,"Hot Springs, AR",2000,105,0,105,88311,1.18897985528417
26300,"Hot Springs, AR",2001,113,0,113,89032,1.26920657741037
26300,"Hot Springs, AR",2002,125,0,125,89630,1.39462233627134
26300,"Hot Springs, AR",2003,129,0,129,90483,1.42568217234177
26300,"Hot Springs, AR",2004,140,0,140,91084,1.53704272978789
26300,"Hot Springs, AR",2005,159,0,159,92096,1.72645934676859
26300,"Hot Springs, AR",2006,135,0,135,94077,1.43499473835263
26300,"Hot Springs, AR",2007,96,0,96,94753,1.01316053317573
26300,"Hot Springs, AR",2008,54,0,54,95636,0.564640930193651
26300,"Hot Springs, AR",2009,38,0,38,95840,0.396494156928214
26300,"Hot Springs, AR",2010,38,0,38,96069,0.395549032466248
26300,"Hot Springs, AR",2011,37,0,37,96852,0.382026184281171
26300,"Hot Springs, AR",2012,44,0,44,96989,0.453659693367289
26300,"Hot Springs, AR",2013,41,0,41,97653,0.419853972740213
26300,"Hot Springs, AR",2014,43,0,43,97754,0.439879698017472
26300,"Hot Springs, AR",2015,59,0,59,97816,0.60317330498078
26300,"Hot Springs, AR",2016,45,0,45,98311,0.457731077905829
26300,"Hot Springs, AR",2017,38,0,38,98444,0.386006257364593
26300,"Hot Springs, AR",2018,51,40,91,99154,0.917764285858362
26340,"Houghton, MI",1990,61,57,118,37209,3.1712757666156
26340,"Houghton, MI",1991,84,0,84,37287,2.25279588060182
26340,"Houghton, MI",1992,97,0,97,37723,2.57137555337592
26340,"Houghton, MI",1993,107,0,107,37618,2.8443830081344
26340,"Houghton, MI",1994,125,0,125,37741,3.3120479054609002
26340,"Houghton, MI",1995,111,0,111,37937,2.92590347154493
26340,"Houghton, MI",1996,132,0,132,37981,3.47542192148706
26340,"Houghton, MI",1997,130,19,149,38019,3.91909308503643
26340,"Houghton, MI",1998,131,6,137,38058,3.59976877397656
26340,"Houghton, MI",1999,126,6,132,37757,3.49604046931695
26340,"Houghton, MI",2000,141,6,147,38238,3.84434332339558
26340,"Houghton, MI",2001,154,4,158,37965,4.16172790728302
26340,"Houghton, MI",2002,217,0,217,38124,5.69195257580527
26340,"Houghton, MI",2003,150,0,150,37968,3.95069532237674
26340,"Houghton, MI",2004,162,0,162,38279,4.23208547767705
26340,"Houghton, MI",2005,157,6,163,38237,4.26288673274577
26340,"Houghton, MI",2006,140,29,169,37852,4.46475747648737
26340,"Houghton, MI",2007,94,24,118,37943,3.10992804996969
26340,"Houghton, MI",2008,85,12,97,38411,2.52531826820442
26340,"Houghton, MI",2009,72,8,80,38509,2.07743644342881
26340,"Houghton, MI",2010,66,0,66,38899,1.69670171469704
26340,"Houghton, MI",2011,41,10,51,38952,1.30930375847197
26340,"Houghton, MI",2012,67,4,71,38908,1.82481751824818
26340,"Houghton, MI",2013,64,0,64,38814,1.64888957592621
26340,"Houghton, MI",2014,40,2,42,38642,1.08690026396149
26340,"Houghton, MI",2015,56,0,56,38406,1.45810550434828
26340,"Houghton, MI",2016,52,0,52,38571,1.34816312773846
26340,"Houghton, MI",2017,76,125,201,38499,5.2209148289566
26340,"Houghton, MI",2018,67,4,71,38332,1.85223833872483
26380,"Houma-Thibodaux, LA",1990,393,62,455,182852,2.48835123487848
26380,"Houma-Thibodaux, LA",1991,467,16,483,184455,2.61852484345775
26380,"Houma-Thibodaux, LA",1992,614,0,614,185555,3.30899194308965
26380,"Houma-Thibodaux, LA",1993,655,6,661,186076,3.55231195855457
26380,"Houma-Thibodaux, LA",1994,680,7,687,187070,3.67242208798845
26380,"Houma-Thibodaux, LA",1995,678,105,783,187966,4.16564697870892
26380,"Houma-Thibodaux, LA",1996,758,76,834,189279,4.40619403103355
26380,"Houma-Thibodaux, LA",1997,746,94,840,191340,4.39009093759799
26380,"Houma-Thibodaux, LA",1998,777,16,793,193673,4.09453047146479
26380,"Houma-Thibodaux, LA",1999,739,2,741,194582,3.80816313944764
26380,"Houma-Thibodaux, LA",2000,692,4,696,194531,3.57783592332328
26380,"Houma-Thibodaux, LA",2001,699,12,711,195360,3.63943488943489
26380,"Houma-Thibodaux, LA",2002,760,34,794,196692,4.03676814512029
26380,"Houma-Thibodaux, LA",2003,866,187,1053,198156,5.31399503421547
26380,"Houma-Thibodaux, LA",2004,890,5,895,199363,4.48929841545322
26380,"Houma-Thibodaux, LA",2005,942,5,947,200467,4.72396953114478
26380,"Houma-Thibodaux, LA",2006,1093,60,1153,204379,5.64147979978374
26380,"Houma-Thibodaux, LA",2007,684,38,722,205401,3.5150753891169
26380,"Houma-Thibodaux, LA",2008,575,290,865,207056,4.17761378564253
26380,"Houma-Thibodaux, LA",2009,527,28,555,207769,2.67123584365329
26380,"Houma-Thibodaux, LA",2010,359,6,365,208246,1.75273474640569
26380,"Houma-Thibodaux, LA",2011,382,8,390,208684,1.86885434436756
26380,"Houma-Thibodaux, LA",2012,561,8,569,208866,2.72423467677841
26380,"Houma-Thibodaux, LA",2013,562,12,574,209978,2.73361971254131
26380,"Houma-Thibodaux, LA",2014,634,30,664,211376,3.1413216259178
26380,"Houma-Thibodaux, LA",2015,613,50,663,212119,3.12560402415625
26380,"Houma-Thibodaux, LA",2016,458,224,682,211479,3.22490649189754
26380,"Houma-Thibodaux, LA",2017,431,6,437,209893,2.08201321625781
26380,"Houma-Thibodaux, LA",2018,475,30,505,209136,2.41469665672099
26420,"Houston-The Woodlands-Sugar Land, TX",1990,10963,2358,13321,3773266,3.53036335100679
26420,"Houston-The Woodlands-Sugar Land, TX",1991,13535,3699,17234,3872844,4.44995977116558
26420,"Houston-The Woodlands-Sugar Land, TX",1992,15159,3368,18527,3967636,4.66953117675109
26420,"Houston-The Woodlands-Sugar Land, TX",1993,15661,4011,19672,4043217,4.86543264929881
26420,"Houston-The Woodlands-Sugar Land, TX",1994,15757,6756,22513,4110610,5.47680271297934
26420,"Houston-The Woodlands-Sugar Land, TX",1995,15873,5833,21706,4174325,5.19988261575225
26420,"Houston-The Woodlands-Sugar Land, TX",1996,19463,4682,24145,4250512,5.68049213835886
26420,"Houston-The Woodlands-Sugar Land, TX",1997,20854,11507,32361,4332029,7.47017159857425
26420,"Houston-The Woodlands-Sugar Land, TX",1998,25414,21479,46893,4427204,10.5920124755941
26420,"Houston-The Woodlands-Sugar Land, TX",1999,25617,11088,36705,4524376,8.11272095864711
26420,"Houston-The Woodlands-Sugar Land, TX",2000,28169,7845,36014,4717507,7.6341169181095
26420,"Houston-The Woodlands-Sugar Land, TX",2001,30490,7117,37607,4817815,7.80582068842411
26420,"Houston-The Woodlands-Sugar Land, TX",2002,34685,12407,47092,4937081,9.53842969155256
26420,"Houston-The Woodlands-Sugar Land, TX",2003,39797,16761,56558,5036393,11.2298623240879
26420,"Houston-The Woodlands-Sugar Land, TX",2004,45092,10933,56025,5132602,10.9155161456119
26420,"Houston-The Woodlands-Sugar Land, TX",2005,51202,10920,62122,5233729,11.8695484615271
26420,"Houston-The Woodlands-Sugar Land, TX",2006,55159,16557,71716,5423615,13.2229149746064
26420,"Houston-The Woodlands-Sugar Land, TX",2007,42217,21057,63274,5540882,11.4194815915589
26420,"Houston-The Woodlands-Sugar Land, TX",2008,28188,14536,42724,5676381,7.52662656012695
26420,"Houston-The Woodlands-Sugar Land, TX",2009,22369,4957,27326,5826108,4.69026664112646
26420,"Houston-The Woodlands-Sugar Land, TX",2010,22328,5122,27450,5947409,4.61545523437181
26420,"Houston-The Woodlands-Sugar Land, TX",2011,22887,8382,31269,6056366,5.16299708439021
26420,"Houston-The Woodlands-Sugar Land, TX",2012,28621,14662,43283,6184861,6.99821709816922
26420,"Houston-The Woodlands-Sugar Land, TX",2013,34537,16791,51328,6330657,8.10784725819137
26420,"Houston-The Woodlands-Sugar Land, TX",2014,38315,25426,63741,6503618,9.80085238708669
26420,"Houston-The Woodlands-Sugar Land, TX",2015,36786,20115,56901,6676565,8.52249622373181
26420,"Houston-The Woodlands-Sugar Land, TX",2016,35367,9365,44732,6812260,6.56639646754528
26420,"Houston-The Woodlands-Sugar Land, TX",2017,36348,6047,42395,6905695,6.13913588711925
26420,"Houston-The Woodlands-Sugar Land, TX",2018,40321,16967,57288,6997384,8.18705962113841
26460,"Hudson, NY",1990,135,13,148,63042,2.34764125503632
26460,"Hudson, NY",1991,152,33,185,62935,2.93954079605943
26460,"Hudson, NY",1992,196,9,205,63170,3.24521133449422
26460,"Hudson, NY",1993,160,67,227,63344,3.58360697145744
26460,"Hudson, NY",1994,132,83,215,63440,3.3890290037831
26460,"Hudson, NY",1995,135,2,137,63656,2.15219303757698
26460,"Hudson, NY",1996,159,4,163,63466,2.5683042889106
26460,"Hudson, NY",1997,136,50,186,63322,2.93736773949022
26460,"Hudson, NY",1998,177,52,229,63150,3.62628661916073
26460,"Hudson, NY",1999,194,4,198,62988,3.14345589636121
26460,"Hudson, NY",2000,186,4,190,63046,3.01367255654601
26460,"Hudson, NY",2001,241,0,241,62953,3.82825282353502
26460,"Hudson, NY",2002,301,66,367,63182,5.80861637808237
26460,"Hudson, NY",2003,316,6,322,63304,5.08656640970555
26460,"Hudson, NY",2004,356,4,360,63646,5.65628633378374
26460,"Hudson, NY",2005,323,12,335,63717,5.25762355415352
26460,"Hudson, NY",2006,224,122,346,63427,5.45509010358365
26460,"Hudson, NY",2007,223,14,237,63430,3.73640233328078
26460,"Hudson, NY",2008,116,12,128,63253,2.02361943307037
26460,"Hudson, NY",2009,98,8,106,63023,1.68192564619266
26460,"Hudson, NY",2010,67,0,67,63026,1.06305334306477
26460,"Hudson, NY",2011,59,3,62,62512,0.991809572562068
26460,"Hudson, NY",2012,69,36,105,62435,1.68174901897974
26460,"Hudson, NY",2013,69,82,151,62160,2.42921492921493
26460,"Hudson, NY",2014,78,19,97,61938,1.5660822112435
26460,"Hudson, NY",2015,84,125,209,61453,3.40097310139456
26460,"Hudson, NY",2016,71,74,145,60882,2.38165631878059
26460,"Hudson, NY",2017,92,6,98,60408,1.62230168189644
26460,"Hudson, NY",2018,93,4,97,59916,1.61893317310902
26500,"Huntingdon, PA",1990,158,0,158,44200,3.57466063348416
26500,"Huntingdon, PA",1991,130,24,154,44294,3.4767688625999
26500,"Huntingdon, PA",1992,143,59,202,44380,4.55159981973862
26500,"Huntingdon, PA",1993,166,8,174,44748,3.88844194153929
26500,"Huntingdon, PA",1994,139,10,149,44545,3.34493209114379
26500,"Huntingdon, PA",1995,150,4,154,44782,3.43888169353758
26500,"Huntingdon, PA",1996,145,20,165,45053,3.66235322841986
26500,"Huntingdon, PA",1997,145,2,147,44732,3.28623803988196
26500,"Huntingdon, PA",1998,173,0,173,44736,3.86713161659514
26500,"Huntingdon, PA",1999,175,2,177,44832,3.94807280513919
26500,"Huntingdon, PA",2000,178,2,180,45620,3.94563787812363
26500,"Huntingdon, PA",2001,172,0,172,45594,3.77242619642935
26500,"Huntingdon, PA",2002,189,0,189,45705,4.13521496553988
26500,"Huntingdon, PA",2003,175,10,185,45797,4.03956591043081
26500,"Huntingdon, PA",2004,207,6,213,45790,4.65167067045206
26500,"Huntingdon, PA",2005,174,0,174,45771,3.80153372222586
26500,"Huntingdon, PA",2006,119,0,119,45684,2.60485071359776
26500,"Huntingdon, PA",2007,113,0,113,45802,2.46714117287455
26500,"Huntingdon, PA",2008,110,2,112,45853,2.44258827121453
26500,"Huntingdon, PA",2009,74,0,74,45896,1.61234094474464
26500,"Huntingdon, PA",2010,93,6,99,46003,2.1520335630285
26500,"Huntingdon, PA",2011,65,10,75,46006,1.63022214493762
26500,"Huntingdon, PA",2012,49,8,57,45941,1.2407217953462
26500,"Huntingdon, PA",2013,62,0,62,45843,1.35244203040813
26500,"Huntingdon, PA",2014,65,0,65,45737,1.42116885672432
26500,"Huntingdon, PA",2015,48,0,48,45485,1.05529295372101
26500,"Huntingdon, PA",2016,52,0,52,45343,1.14681428224864
26500,"Huntingdon, PA",2017,47,0,47,45374,1.0358355005069
26500,"Huntingdon, PA",2018,49,0,49,45168,1.08483882394616
26540,"Huntington, IN",1990,102,18,120,35487,3.38151999323696
26540,"Huntington, IN",1991,114,4,118,35770,3.29885378809058
26540,"Huntington, IN",1992,144,6,150,35774,4.19298932185386
26540,"Huntington, IN",1993,149,0,149,36151,4.12160106221128
26540,"Huntington, IN",1994,165,116,281,36364,7.72742272577274
26540,"Huntington, IN",1995,162,4,166,36752,4.51676099259904
26540,"Huntington, IN",1996,178,2,180,36934,4.87355823902096
26540,"Huntington, IN",1997,203,0,203,37162,5.46256929121145
26540,"Huntington, IN",1998,171,50,221,37292,5.92620401158425
26540,"Huntington, IN",1999,160,0,160,37401,4.27796048234004
26540,"Huntington, IN",2000,153,0,153,38068,4.0191236734265
26540,"Huntington, IN",2001,150,0,150,37877,3.96018692082266
26540,"Huntington, IN",2002,176,0,176,37992,4.63255422194146
26540,"Huntington, IN",2003,166,0,166,37875,4.38283828382838
26540,"Huntington, IN",2004,153,0,153,37768,4.05104850667232
26540,"Huntington, IN",2005,139,0,139,37650,3.69189907038513
26540,"Huntington, IN",2006,94,0,94,37601,2.49993351240659
26540,"Huntington, IN",2007,71,10,81,37447,2.16305712073063
26540,"Huntington, IN",2008,64,11,75,37244,2.01374718075395
26540,"Huntington, IN",2009,29,0,29,37205,0.779465125655154
26540,"Huntington, IN",2010,44,35,79,37117,2.12840477409273
26540,"Huntington, IN",2011,34,0,34,37164,0.914863846733398
26540,"Huntington, IN",2012,37,48,85,36979,2.2986019091917
26540,"Huntington, IN",2013,50,0,50,36779,1.3594714375051
26540,"Huntington, IN",2014,53,0,53,36610,1.44769188746244
26540,"Huntington, IN",2015,55,0,55,36514,1.50627156707016
26540,"Huntington, IN",2016,71,0,71,36288,1.956569664903
26540,"Huntington, IN",2017,65,6,71,36239,1.95921521013273
26540,"Huntington, IN",2018,85,0,85,36240,2.34547461368653
26580,"Huntington-Ashland, WV-KY-OH",1990,216,35,251,352459,0.712139568006491
26580,"Huntington-Ashland, WV-KY-OH",1991,473,23,496,354447,1.39936295130161
26580,"Huntington-Ashland, WV-KY-OH",1992,517,17,534,356251,1.4989431608613
26580,"Huntington-Ashland, WV-KY-OH",1993,610,109,719,359215,2.00158679342455
26580,"Huntington-Ashland, WV-KY-OH",1994,597,50,647,360303,1.79571083227173
26580,"Huntington-Ashland, WV-KY-OH",1995,414,381,795,361044,2.2019476850467
26580,"Huntington-Ashland, WV-KY-OH",1996,543,156,699,361073,1.9358966192432
26580,"Huntington-Ashland, WV-KY-OH",1997,462,285,747,361021,2.06913171255966
26580,"Huntington-Ashland, WV-KY-OH",1998,465,325,790,360280,2.19273898079272
26580,"Huntington-Ashland, WV-KY-OH",1999,513,156,669,359578,1.86051426950481
26580,"Huntington-Ashland, WV-KY-OH",2000,498,75,573,362183,1.58207315086572
26580,"Huntington-Ashland, WV-KY-OH",2001,412,145,557,360868,1.54350067060532
26580,"Huntington-Ashland, WV-KY-OH",2002,449,91,540,360609,1.49746678535477
26580,"Huntington-Ashland, WV-KY-OH",2003,441,26,467,361922,1.29033327623079
26580,"Huntington-Ashland, WV-KY-OH",2004,491,155,646,361774,1.78564518179858
26580,"Huntington-Ashland, WV-KY-OH",2005,559,355,914,361864,2.52581080184821
26580,"Huntington-Ashland, WV-KY-OH",2006,587,303,890,362868,2.45268251816087
26580,"Huntington-Ashland, WV-KY-OH",2007,494,125,619,363249,1.70406525551344
26580,"Huntington-Ashland, WV-KY-OH",2008,297,401,698,363898,1.9181199127228
26580,"Huntington-Ashland, WV-KY-OH",2009,230,104,334,364731,0.91574338347988
26580,"Huntington-Ashland, WV-KY-OH",2010,258,122,380,364985,1.04113867693193
26580,"Huntington-Ashland, WV-KY-OH",2011,238,159,397,365024,1.0875997194705
26580,"Huntington-Ashland, WV-KY-OH",2012,269,156,425,364924,1.16462605912464
26580,"Huntington-Ashland, WV-KY-OH",2013,298,170,468,364027,1.28561892387103
26580,"Huntington-Ashland, WV-KY-OH",2014,230,128,358,362954,0.986350887440282
26580,"Huntington-Ashland, WV-KY-OH",2015,200,91,291,361050,0.805982550893228
26580,"Huntington-Ashland, WV-KY-OH",2016,196,54,250,358761,0.696842744891446
26580,"Huntington-Ashland, WV-KY-OH",2017,234,30,264,355582,0.742444780669438
26580,"Huntington-Ashland, WV-KY-OH",2018,224,36,260,352823,0.736913409840061
26620,"Huntsville, AL",1990,1479,485,1964,294455,6.66994956784568
26620,"Huntsville, AL",1991,1089,234,1323,302576,4.37245518481307
26620,"Huntsville, AL",1992,1464,457,1921,312143,6.15423059302948
26620,"Huntsville, AL",1993,1357,638,1995,322461,6.18679468214761
26620,"Huntsville, AL",1994,954,42,996,327570,3.04057148090484
26620,"Huntsville, AL",1995,757,0,757,327967,2.30815905258761
26620,"Huntsville, AL",1996,897,50,947,330389,2.86631818855955
26620,"Huntsville, AL",1997,1176,439,1615,333607,4.84102551804968
26620,"Huntsville, AL",1998,1160,612,1772,340394,5.20573218094326
26620,"Huntsville, AL",1999,1156,32,1188,343937,3.45412095819874
26620,"Huntsville, AL",2000,1058,152,1210,343972,3.51772818717803
26620,"Huntsville, AL",2001,1005,624,1629,348453,4.67494898881628
26620,"Huntsville, AL",2002,1199,460,1659,354116,4.68490551118842
26620,"Huntsville, AL",2003,1213,1184,2397,359920,6.65981329184263
26620,"Huntsville, AL",2004,3425,264,3689,365248,10.0999868582443
26620,"Huntsville, AL",2005,3423,18,3441,372777,9.23071970641966
26620,"Huntsville, AL",2006,4154,316,4470,382821,11.676475428464
26620,"Huntsville, AL",2007,3280,1183,4463,391922,11.3874699557565
26620,"Huntsville, AL",2008,2425,739,3164,402361,7.86358518842532
26620,"Huntsville, AL",2009,2293,695,2988,412182,7.24922485698065
26620,"Huntsville, AL",2010,2275,0,2275,419266,5.4261495089036504
26620,"Huntsville, AL",2011,2015,4,2019,425069,4.74981708851975
26620,"Huntsville, AL",2012,1927,420,2347,430026,5.45780952779599
26620,"Huntsville, AL",2013,1944,306,2250,435543,5.16596524338584
26620,"Huntsville, AL",2014,1784,1033,2817,440403,6.39641419336381
26620,"Huntsville, AL",2015,2121,486,2607,444560,5.86422530142163
26620,"Huntsville, AL",2016,2320,672,2992,449662,6.65388669711917
26620,"Huntsville, AL",2017,2577,382,2959,455741,6.49272284038522
26620,"Huntsville, AL",2018,2870,71,2941,462693,6.35626646610171
26660,"Huntsville, TX",1990,13,0,13,62315,0.208617507823157
26660,"Huntsville, TX",1991,64,0,64,63222,1.01230584290279
26660,"Huntsville, TX",1992,158,3,161,64037,2.51417149460468
26660,"Huntsville, TX",1993,101,4,105,64913,1.61754964336882
26660,"Huntsville, TX",1994,109,2,111,65636,1.69114510329697
26660,"Huntsville, TX",1995,179,44,223,66307,3.36314416275808
26660,"Huntsville, TX",1996,293,256,549,66483,8.25775010152971
26660,"Huntsville, TX",1997,211,0,211,66911,3.15344263275097
26660,"Huntsville, TX",1998,226,100,326,67575,4.82426933037366
26660,"Huntsville, TX",1999,226,0,226,68099,3.31869777823463
26660,"Huntsville, TX",2000,56,0,56,75561,0.741123066131999
26660,"Huntsville, TX",2001,109,217,326,76296,4.27283212750341
26660,"Huntsville, TX",2002,74,108,182,76249,2.38691654972524
26660,"Huntsville, TX",2003,80,18,98,77765,1.26020703401273
26660,"Huntsville, TX",2004,153,203,356,78797,4.51793850019671
26660,"Huntsville, TX",2005,85,198,283,80071,3.53436325261331
26660,"Huntsville, TX",2006,54,180,234,79967,2.92620706041242
26660,"Huntsville, TX",2007,64,608,672,79942,8.40609441845338
26660,"Huntsville, TX",2008,56,0,56,80106,0.699073727311313
26660,"Huntsville, TX",2009,58,0,58,81220,0.714109825166215
26660,"Huntsville, TX",2010,205,428,633,82972,7.62907968953382
26660,"Huntsville, TX",2011,52,0,52,83091,0.625819884223321
26660,"Huntsville, TX",2012,50,24,74,82977,0.891813394073056
26660,"Huntsville, TX",2013,67,0,67,83860,0.798950632005724
26660,"Huntsville, TX",2014,86,142,228,84386,2.70186997843244
26660,"Huntsville, TX",2015,159,0,159,85405,1.86171769802705
26660,"Huntsville, TX",2016,157,0,157,86439,1.81630976758176
26660,"Huntsville, TX",2017,183,246,429,87093,4.9257690055458
26660,"Huntsville, TX",2018,194,361,555,87220,6.3632194450814
26700,"Huron, SD",1990,24,55,79,18276,4.32260888597067
26700,"Huron, SD",1991,18,0,18,18030,0.998336106489185
26700,"Huron, SD",1992,32,12,44,17962,2.44961585569536
26700,"Huron, SD",1993,44,24,68,17936,3.79125780553078
26700,"Huron, SD",1994,43,59,102,18058,5.64846605382656
26700,"Huron, SD",1995,36,22,58,18110,3.20265046935395
26700,"Huron, SD",1996,35,20,55,18098,3.03900983534092
26700,"Huron, SD",1997,25,30,55,17924,3.06851149297032
26700,"Huron, SD",1998,18,4,22,17123,1.28482158500263
26700,"Huron, SD",1999,28,44,72,16684,4.31551186765764
26700,"Huron, SD",2000,29,0,29,17030,1.70287727539636
26700,"Huron, SD",2001,20,8,28,16952,1.65172251061822
26700,"Huron, SD",2002,48,0,48,16767,2.8627661477903
26700,"Huron, SD",2003,26,0,26,16504,1.57537566650509
26700,"Huron, SD",2004,27,4,31,16370,1.89370800244349
26700,"Huron, SD",2005,49,8,57,16304,3.49607458292444
26700,"Huron, SD",2006,52,0,52,16149,3.22001362313456
26700,"Huron, SD",2007,27,3,30,16489,1.81939474801383
26700,"Huron, SD",2008,41,0,41,16810,2.4390243902439
26700,"Huron, SD",2009,39,2,41,17288,2.37158722813512
26700,"Huron, SD",2010,31,0,31,17406,1.780995059175
26700,"Huron, SD",2011,30,46,76,17704,4.29281518300949
26700,"Huron, SD",2012,32,6,38,17992,2.11204979991107
26700,"Huron, SD",2013,22,9,31,18202,1.70310954840127
26700,"Huron, SD",2014,23,0,23,18057,1.27374425430581
26700,"Huron, SD",2015,20,6,26,18120,1.43487858719647
26700,"Huron, SD",2016,19,4,23,18210,1.26304228445909
26700,"Huron, SD",2017,18,89,107,18602,5.75206966992796
26700,"Huron, SD",2018,17,0,17,18883,0.900280675740084
26740,"Hutchinson, KS",1990,49,74,123,62365,1.97226008177664
26740,"Hutchinson, KS",1991,61,34,95,62280,1.52536929993577
26740,"Hutchinson, KS",1992,73,16,89,62201,1.43084516326104
26740,"Hutchinson, KS",1993,75,18,93,62438,1.48947756174125
26740,"Hutchinson, KS",1994,94,50,144,62307,2.31113679040878
26740,"Hutchinson, KS",1995,111,146,257,62708,4.0983606557377
26740,"Hutchinson, KS",1996,152,81,233,62930,3.70252661687589
26740,"Hutchinson, KS",1997,123,62,185,63001,2.9364613260107
26740,"Hutchinson, KS",1998,137,10,147,63236,2.32462521348599
26740,"Hutchinson, KS",1999,119,58,177,63581,2.78385052138217
26740,"Hutchinson, KS",2000,112,16,128,64731,1.97741422193385
26740,"Hutchinson, KS",2001,130,0,130,64584,2.01288244766506
26740,"Hutchinson, KS",2002,96,30,126,64163,1.96374857784081
26740,"Hutchinson, KS",2003,118,2,120,63990,1.87529301453352
26740,"Hutchinson, KS",2004,100,0,100,63779,1.56791420373477
26740,"Hutchinson, KS",2005,139,48,187,63778,2.93204553294239
26740,"Hutchinson, KS",2006,119,40,159,63822,2.49130393908057
26740,"Hutchinson, KS",2007,74,66,140,63683,2.19838889499552
26740,"Hutchinson, KS",2008,51,0,51,63974,0.797198862037703
26740,"Hutchinson, KS",2009,67,21,88,64196,1.37080191912269
26740,"Hutchinson, KS",2010,59,4,63,64548,0.976017847183491
26740,"Hutchinson, KS",2011,43,8,51,64420,0.791679602607886
26740,"Hutchinson, KS",2012,41,40,81,64199,1.26170189566816
26740,"Hutchinson, KS",2013,60,71,131,64072,2.04457485329005
26740,"Hutchinson, KS",2014,35,12,47,63699,0.737845178103267
26740,"Hutchinson, KS",2015,45,102,147,63591,2.31164787469925
26740,"Hutchinson, KS",2016,37,16,53,63184,0.83881995441884
26740,"Hutchinson, KS",2017,40,0,40,62688,0.638080653394589
26740,"Hutchinson, KS",2018,35,29,64,62342,1.02659523274839
26780,"Hutchinson, MN",1990,109,16,125,32103,3.89371709809052
26780,"Hutchinson, MN",1991,121,6,127,32229,3.94055043594278
26780,"Hutchinson, MN",1992,154,4,158,32483,4.86408275097743
26780,"Hutchinson, MN",1993,168,122,290,32768,8.85009765625
26780,"Hutchinson, MN",1994,148,140,288,32961,8.73759898061345
26780,"Hutchinson, MN",1995,139,10,149,33120,4.4987922705314
26780,"Hutchinson, MN",1996,153,95,248,33569,7.38776847686854
26780,"Hutchinson, MN",1997,119,137,256,33719,7.59215872356831
26780,"Hutchinson, MN",1998,152,144,296,34095,8.68162487168206
26780,"Hutchinson, MN",1999,162,96,258,34424,7.49477108993725
26780,"Hutchinson, MN",2000,166,24,190,34854,5.45131118379526
26780,"Hutchinson, MN",2001,222,16,238,35144,6.77213749146369
26780,"Hutchinson, MN",2002,250,18,268,35408,7.56891098056936
26780,"Hutchinson, MN",2003,282,12,294,35541,8.27213640584114
26780,"Hutchinson, MN",2004,273,55,328,35923,9.1306405367035
26780,"Hutchinson, MN",2005,261,2,263,36250,7.2551724137931
26780,"Hutchinson, MN",2006,160,2,162,36749,4.40828321859098
26780,"Hutchinson, MN",2007,73,0,73,36961,1.97505478747869
26780,"Hutchinson, MN",2008,49,0,49,36917,1.32730178508546
26780,"Hutchinson, MN",2009,22,65,87,36662,2.3730292946375
26780,"Hutchinson, MN",2010,16,0,16,36590,0.437277944793659
26780,"Hutchinson, MN",2011,21,0,21,36340,0.577875619152449
26780,"Hutchinson, MN",2012,20,0,20,35931,0.556622415184659
26780,"Hutchinson, MN",2013,27,0,27,35900,0.752089136490251
26780,"Hutchinson, MN",2014,37,0,37,35776,1.03421288014311
26780,"Hutchinson, MN",2015,45,0,45,35824,1.25614113443502
26780,"Hutchinson, MN",2016,50,2,52,35767,1.45385411133167
26780,"Hutchinson, MN",2017,56,58,114,35883,3.17699189031017
26780,"Hutchinson, MN",2018,72,62,134,35873,3.7353998829203
26820,"Idaho Falls, ID",1990,496,9,505,92132,5.48126600963834
26820,"Idaho Falls, ID",1991,510,17,527,94886,5.55403326096579
26820,"Idaho Falls, ID",1992,492,227,719,97609,7.36612402544847
26820,"Idaho Falls, ID",1993,472,144,616,99275,6.20498614958449
26820,"Idaho Falls, ID",1994,394,18,412,100754,4.08916767572503
26820,"Idaho Falls, ID",1995,320,75,395,101318,3.89861623798338
26820,"Idaho Falls, ID",1996,450,84,534,101444,5.26398801309097
26820,"Idaho Falls, ID",1997,515,99,614,102247,6.00506616331042
26820,"Idaho Falls, ID",1998,671,43,714,103285,6.91291087766859
26820,"Idaho Falls, ID",1999,716,285,1001,104432,9.58518461774169
26820,"Idaho Falls, ID",2000,579,86,665,105055,6.33001760982343
26820,"Idaho Falls, ID",2001,669,96,765,106082,7.21140249995287
26820,"Idaho Falls, ID",2002,726,221,947,107768,8.78739514512657
26820,"Idaho Falls, ID",2003,1024,164,1188,109937,10.8061889991541
26820,"Idaho Falls, ID",2004,1359,386,1745,113168,15.4195532305952
26820,"Idaho Falls, ID",2005,1471,448,1919,116208,16.5134930469503
26820,"Idaho Falls, ID",2006,1373,161,1534,119981,12.7853576816329
26820,"Idaho Falls, ID",2007,1223,271,1494,124203,12.028694959059
26820,"Idaho Falls, ID",2008,465,55,520,128353,4.05132719920843
26820,"Idaho Falls, ID",2009,324,8,332,131621,2.5223938429278
26820,"Idaho Falls, ID",2010,311,80,391,133808,2.92209733349277
26820,"Idaho Falls, ID",2011,269,7,276,134950,2.0452019266395
26820,"Idaho Falls, ID",2012,381,0,381,136171,2.79795257433668
26820,"Idaho Falls, ID",2013,485,50,535,136850,3.90938984289368
26820,"Idaho Falls, ID",2014,474,8,482,137860,3.49630059480632
26820,"Idaho Falls, ID",2015,682,180,862,139620,6.17390058730841
26820,"Idaho Falls, ID",2016,833,48,881,142664,6.17534907194527
26820,"Idaho Falls, ID",2017,903,282,1185,145792,8.12801799824407
26820,"Idaho Falls, ID",2018,990,47,1037,148904,6.96421855692258
26860,"Indiana, PA",1990,103,56,159,89933,1.76798283166357
26860,"Indiana, PA",1991,140,24,164,90019,1.82183761205968
26860,"Indiana, PA",1992,101,106,207,90242,2.29383214024512
26860,"Indiana, PA",1993,114,108,222,90369,2.45659462868904
26860,"Indiana, PA",1994,95,34,129,90163,1.43074210041813
26860,"Indiana, PA",1995,146,95,241,90122,2.6741528150729
26860,"Indiana, PA",1996,123,41,164,89874,1.82477690989608
26860,"Indiana, PA",1997,137,25,162,89181,1.81653042688465
26860,"Indiana, PA",1998,163,103,266,88421,3.008335124009
26860,"Indiana, PA",1999,135,54,189,87656,2.15615588208451
26860,"Indiana, PA",2000,135,200,335,89518,3.74226412565071
26860,"Indiana, PA",2001,152,52,204,89265,2.28533019660561
26860,"Indiana, PA",2002,146,23,169,89133,1.8960429919334
26860,"Indiana, PA",2003,194,95,289,89346,3.23461598728538
26860,"Indiana, PA",2004,103,137,240,89041,2.69538751810963
26860,"Indiana, PA",2005,43,18,61,88760,0.687246507435782
26860,"Indiana, PA",2006,193,48,241,88716,2.71653365796474
26860,"Indiana, PA",2007,162,76,238,88520,2.68865793041121
26860,"Indiana, PA",2008,75,18,93,88807,1.04721474658529
26860,"Indiana, PA",2009,58,60,118,88836,1.32829033274799
26860,"Indiana, PA",2010,74,14,88,88865,0.990266134023519
26860,"Indiana, PA",2011,31,42,73,88619,0.823751114320857
26860,"Indiana, PA",2012,41,325,366,88220,4.14871911131263
26860,"Indiana, PA",2013,58,176,234,88142,2.65480701595153
26860,"Indiana, PA",2014,54,0,54,87423,0.617686421193507
26860,"Indiana, PA",2015,53,0,53,86773,0.61078907033293794
26860,"Indiana, PA",2016,69,2,71,85200,0.833333333333333
26860,"Indiana, PA",2017,48,2,50,84879,0.589073858080326
26860,"Indiana, PA",2018,44,2,46,84501,0.544372255949634
26900,"Indianapolis-Carmel-Anderson, IN",1990,6724,2148,8872,1430002,6.20418712701101
26900,"Indianapolis-Carmel-Anderson, IN",1991,6891,997,7888,1450817,5.43693656746509
26900,"Indianapolis-Carmel-Anderson, IN",1992,8922,1410,10332,1468939,7.03364809566633
26900,"Indianapolis-Carmel-Anderson, IN",1993,9302,1495,10797,1487913,7.25647265666743
26900,"Indianapolis-Carmel-Anderson, IN",1994,10372,1951,12323,1506248,8.18125567635608
26900,"Indianapolis-Carmel-Anderson, IN",1995,10643,3370,14013,1522747,9.20244794440574
26900,"Indianapolis-Carmel-Anderson, IN",1996,11162,3069,14231,1539205,9.24568202416182
26900,"Indianapolis-Carmel-Anderson, IN",1997,11011,2615,13626,1554736,8.7641889040969
26900,"Indianapolis-Carmel-Anderson, IN",1998,12921,3645,16566,1569710,10.5535417370087
26900,"Indianapolis-Carmel-Anderson, IN",1999,14145,2291,16436,1588014,10.3500346974271
26900,"Indianapolis-Carmel-Anderson, IN",2000,12860,2676,15536,1663995,9.33656651612535
26900,"Indianapolis-Carmel-Anderson, IN",2001,15084,2474,17558,1687209,10.4065352899374
26900,"Indianapolis-Carmel-Anderson, IN",2002,13412,3516,16928,1708018,9.91090257831006
26900,"Indianapolis-Carmel-Anderson, IN",2003,13130,3235,16365,1729297,9.46338309729329
26900,"Indianapolis-Carmel-Anderson, IN",2004,12822,3088,15910,1750639,9.08811011293591
26900,"Indianapolis-Carmel-Anderson, IN",2005,13060,3128,16188,1772959,9.13049878762002
26900,"Indianapolis-Carmel-Anderson, IN",2006,9634,2035,11669,1800724,6.48017130887354
26900,"Indianapolis-Carmel-Anderson, IN",2007,7332,1209,8541,1826515,4.67611818134535
26900,"Indianapolis-Carmel-Anderson, IN",2008,4469,2608,7077,1850321,3.82474176102417
26900,"Indianapolis-Carmel-Anderson, IN",2009,3662,2007,5669,1873460,3.02595198189446
26900,"Indianapolis-Carmel-Anderson, IN",2010,3869,2132,6001,1892647,3.17069162923673
26900,"Indianapolis-Carmel-Anderson, IN",2011,3687,1647,5334,1910646,2.79172593981303
26900,"Indianapolis-Carmel-Anderson, IN",2012,4070,992,5062,1929653,2.62326957230134
26900,"Indianapolis-Carmel-Anderson, IN",2013,5107,3137,8244,1953149,4.22087613387407
26900,"Indianapolis-Carmel-Anderson, IN",2014,4965,3041,8006,1970816,4.06227674222251
26900,"Indianapolis-Carmel-Anderson, IN",2015,5172,3563,8735,1985844,4.39863352811198
26900,"Indianapolis-Carmel-Anderson, IN",2016,5828,1945,7773,2005404,3.87602697511324
26900,"Indianapolis-Carmel-Anderson, IN",2017,6755,2324,9079,2026723,4.47964522038779
26900,"Indianapolis-Carmel-Anderson, IN",2018,7291,1603,8894,2048703,4.34128324115306
26940,"Indianola, MS",1990,50,0,50,35058,1.42620799817445
26940,"Indianola, MS",1991,70,0,70,35759,1.95754914846612
26940,"Indianola, MS",1992,42,0,42,36060,1.16472545757072
26940,"Indianola, MS",1993,76,0,76,36115,2.10438875813374
26940,"Indianola, MS",1994,59,2,61,35862,1.70096480954771
26940,"Indianola, MS",1995,48,0,48,36230,1.32486889318245
26940,"Indianola, MS",1996,35,16,51,35314,1.44418644163788
26940,"Indianola, MS",1997,29,0,29,34354,0.844152063806253
26940,"Indianola, MS",1998,36,8,44,33550,1.31147540983607
26940,"Indianola, MS",1999,50,0,50,33138,1.50884181302432
26940,"Indianola, MS",2000,35,0,35,34249,1.02192764752256
26940,"Indianola, MS",2001,40,0,40,34042,1.17501909406028
26940,"Indianola, MS",2002,46,0,46,33676,1.36595795225086
26940,"Indianola, MS",2003,49,0,49,33453,1.46474157773593
26940,"Indianola, MS",2004,79,0,79,32349,2.44211567590961
26940,"Indianola, MS",2005,57,0,57,31724,1.79674694237801
26940,"Indianola, MS",2006,18,33,51,31464,1.62090007627765
26940,"Indianola, MS",2007,18,0,18,31463,0.572100562565553
26940,"Indianola, MS",2008,9,0,9,30614,0.293983144966355
26940,"Indianola, MS",2009,4,0,4,29574,0.135253939270981
26940,"Indianola, MS",2010,8,0,8,28981,0.276042924674787
26940,"Indianola, MS",2011,10,28,38,28517,1.33253848581548
26940,"Indianola, MS",2012,5,0,5,28406,0.176019150883616
26940,"Indianola, MS",2013,4,0,4,27907,0.143333213888988
26940,"Indianola, MS",2014,7,0,7,27407,0.255409202028679
26940,"Indianola, MS",2015,8,0,8,26879,0.297630120168161
26940,"Indianola, MS",2016,9,0,9,26495,0.339686733345914
26940,"Indianola, MS",2017,6,0,6,26146,0.229480608888549
26940,"Indianola, MS",2018,11,0,11,25735,0.427433456382359
26960,"Ionia, MI",1990,114,80,194,57105,3.39725067857456
26960,"Ionia, MI",1991,99,102,201,62385,3.22192834816062
26960,"Ionia, MI",1992,113,92,205,62667,3.27125919542981
26960,"Ionia, MI",1993,135,38,173,63453,2.72642743447906
26960,"Ionia, MI",1994,141,12,153,63810,2.39774330042313
26960,"Ionia, MI",1995,203,6,209,64394,3.24564400409976
26960,"Ionia, MI",1996,252,6,258,65090,3.96374251037026
26960,"Ionia, MI",1997,241,4,245,66040,3.70987280436099
26960,"Ionia, MI",1998,279,0,279,66677,4.18435142552904
26960,"Ionia, MI",1999,402,62,464,67073,6.91783579085474
26960,"Ionia, MI",2000,370,54,424,61712,6.87062483795696
26960,"Ionia, MI",2001,226,72,298,62079,4.80033505694357
26960,"Ionia, MI",2002,263,51,314,63265,4.96324982217656
26960,"Ionia, MI",2003,287,57,344,63781,5.39345573133065
26960,"Ionia, MI",2004,278,12,290,64562,4.49180632570243
26960,"Ionia, MI",2005,304,64,368,64745,5.68383658969805
26960,"Ionia, MI",2006,204,26,230,65157,3.52993538683488
26960,"Ionia, MI",2007,141,23,164,65189,2.51576186166378
26960,"Ionia, MI",2008,73,0,73,65167,1.12019887366305
26960,"Ionia, MI",2009,35,0,35,63858,0.548091077077265
26960,"Ionia, MI",2010,28,0,28,63842,0.438582751166943
26960,"Ionia, MI",2011,23,0,23,63853,0.360202339749111
26960,"Ionia, MI",2012,30,0,30,63879,0.469637909172028
26960,"Ionia, MI",2013,40,0,40,63988,0.625117209476777
26960,"Ionia, MI",2014,53,0,53,64231,0.825146735999751
26960,"Ionia, MI",2015,59,0,59,64046,0.921212878243762
26960,"Ionia, MI",2016,85,0,85,64164,1.32473037840534
26960,"Ionia, MI",2017,93,0,93,64229,1.44794407510626
26960,"Ionia, MI",2018,116,0,116,64210,1.80657218501791
26980,"Iowa City, IA",1990,407,269,676,116080,5.82356995175741
26980,"Iowa City, IA",1991,493,243,736,116648,6.30958096152527
26980,"Iowa City, IA",1992,601,418,1019,118222,8.6193771040923
26980,"Iowa City, IA",1993,683,335,1018,119260,8.53597182626195
26980,"Iowa City, IA",1994,689,546,1235,120716,10.230623943802
26980,"Iowa City, IA",1995,490,390,880,121777,7.22632352578894
26980,"Iowa City, IA",1996,462,476,938,122168,7.67795167310589
26980,"Iowa City, IA",1997,460,316,776,122918,6.31315185733578
26980,"Iowa City, IA",1998,591,274,865,123579,6.99957112454381
26980,"Iowa City, IA",1999,690,411,1101,124986,8.80898660649993
26980,"Iowa City, IA",2000,583,622,1205,132173,9.11683929395565
26980,"Iowa City, IA",2001,658,588,1246,134610,9.25637025481019
26980,"Iowa City, IA",2002,785,546,1331,136056,9.78273652025636
26980,"Iowa City, IA",2003,995,560,1555,137863,11.2793135213944
26980,"Iowa City, IA",2004,948,414,1362,140149,9.71822845685663
26980,"Iowa City, IA",2005,931,357,1288,141650,9.09283445111189
26980,"Iowa City, IA",2006,722,368,1090,143698,7.58535261451099
26980,"Iowa City, IA",2007,647,172,819,146129,5.60463699881612
26980,"Iowa City, IA",2008,621,213,834,148799,5.60487637685737
26980,"Iowa City, IA",2009,617,112,729,151556,4.81010319617831
26980,"Iowa City, IA",2010,440,113,553,153030,3.61367052211985
26980,"Iowa City, IA",2011,444,318,762,155888,4.88812480755414
26980,"Iowa City, IA",2012,569,226,795,159001,4.9999685536569
26980,"Iowa City, IA",2013,515,554,1069,162105,6.59449122482342
26980,"Iowa City, IA",2014,641,463,1104,164777,6.69996419403193
26980,"Iowa City, IA",2015,483,844,1327,167078,7.94239816133782
26980,"Iowa City, IA",2016,595,1326,1921,168995,11.3672002130241
26980,"Iowa City, IA",2017,638,689,1327,171470,7.73896308392139
26980,"Iowa City, IA",2018,511,856,1367,173401,7.88346087969504
27020,"Iron Mountain, MI-WI",1990,167,12,179,31537,5.67587278434854
27020,"Iron Mountain, MI-WI",1991,172,46,218,31782,6.85922849411617
27020,"Iron Mountain, MI-WI",1992,155,6,161,32023,5.02763638634731
27020,"Iron Mountain, MI-WI",1993,159,8,167,32140,5.196017423771
27020,"Iron Mountain, MI-WI",1994,181,4,185,32258,5.73501147002294
27020,"Iron Mountain, MI-WI",1995,177,2,179,32388,5.52673829813511
27020,"Iron Mountain, MI-WI",1996,152,0,152,32376,4.69483568075117
27020,"Iron Mountain, MI-WI",1997,143,35,178,32376,5.4978996787744
27020,"Iron Mountain, MI-WI",1998,155,2,157,32262,4.86640629843159
27020,"Iron Mountain, MI-WI",1999,103,0,103,32071,3.21162420878675
27020,"Iron Mountain, MI-WI",2000,104,2,106,32536,3.25792967789525
27020,"Iron Mountain, MI-WI",2001,76,0,76,32172,2.36230262339923
27020,"Iron Mountain, MI-WI",2002,74,2,76,32087,2.36856047620532
27020,"Iron Mountain, MI-WI",2003,103,0,103,31903,3.22853650126947
27020,"Iron Mountain, MI-WI",2004,113,0,113,32121,3.51794776003238
27020,"Iron Mountain, MI-WI",2005,131,0,131,31892,4.10761319453154
27020,"Iron Mountain, MI-WI",2006,102,0,102,31745,3.21310442589384
27020,"Iron Mountain, MI-WI",2007,88,6,94,31563,2.9781706428413
27020,"Iron Mountain, MI-WI",2008,79,0,79,31186,2.53318796896043
27020,"Iron Mountain, MI-WI",2009,69,24,93,30851,3.01448899549447
27020,"Iron Mountain, MI-WI",2010,60,0,60,30556,1.96360780206833
27020,"Iron Mountain, MI-WI",2011,59,4,63,30446,2.06923733823819
27020,"Iron Mountain, MI-WI",2012,57,0,57,30537,1.86658807348463
27020,"Iron Mountain, MI-WI",2013,59,2,61,30398,2.00671096782683
27020,"Iron Mountain, MI-WI",2014,51,8,59,30243,1.9508646628972
27020,"Iron Mountain, MI-WI",2015,45,0,45,30001,1.49995000166661
27020,"Iron Mountain, MI-WI",2016,42,2,44,29810,1.4760147601476
27020,"Iron Mountain, MI-WI",2017,49,12,61,29784,2.04807950577491
27020,"Iron Mountain, MI-WI",2018,44,11,55,29704,1.85160247778077
27060,"Ithaca, NY",1990,228,63,291,94279,3.08658343851759
27060,"Ithaca, NY",1991,225,135,360,95474,3.77066007499424
27060,"Ithaca, NY",1992,238,27,265,96029,2.75958304262254
27060,"Ithaca, NY",1993,215,28,243,96622,2.51495518618948
27060,"Ithaca, NY",1994,401,258,659,97067,6.78912503734534
27060,"Ithaca, NY",1995,169,47,216,97688,2.21112112030137
27060,"Ithaca, NY",1996,156,69,225,97268,2.31319652917712
27060,"Ithaca, NY",1997,128,40,168,97343,1.72585599375404
27060,"Ithaca, NY",1998,164,147,311,97320,3.19564323879984
27060,"Ithaca, NY",1999,145,254,399,98108,4.06694663024422
27060,"Ithaca, NY",2000,165,391,556,96608,5.75521695925803
27060,"Ithaca, NY",2001,187,112,299,97458,3.06798826161013
27060,"Ithaca, NY",2002,208,191,399,98227,4.06201960764352
27060,"Ithaca, NY",2003,218,118,336,99049,3.39226039636947
27060,"Ithaca, NY",2004,220,21,241,99531,2.42135616039224
27060,"Ithaca, NY",2005,224,116,340,99433,3.41938792956061
27060,"Ithaca, NY",2006,162,145,307,99651,3.08075182386529
27060,"Ithaca, NY",2007,158,115,273,99910,2.73245921329196
27060,"Ithaca, NY",2008,122,109,231,100383,2.301186455874
27060,"Ithaca, NY",2009,100,27,127,101497,1.25126851039932
27060,"Ithaca, NY",2010,113,40,153,101725,1.50405505038093
27060,"Ithaca, NY",2011,102,51,153,101801,1.50293219123584
27060,"Ithaca, NY",2012,112,157,269,102719,2.61879496490425
27060,"Ithaca, NY",2013,115,105,220,103553,2.12451594835495
27060,"Ithaca, NY",2014,140,161,301,103385,2.91144750205542
27060,"Ithaca, NY",2015,138,141,279,103018,2.70826457512279
27060,"Ithaca, NY",2016,121,454,575,102938,5.58588665021664
27060,"Ithaca, NY",2017,115,353,468,102678,4.55793840939637
27060,"Ithaca, NY",2018,155,650,805,102793,7.83127255746987
27100,"Jackson, MI",1990,452,132,584,150134,3.88985839316877
27100,"Jackson, MI",1991,420,34,454,151069,3.00524925696205
27100,"Jackson, MI",1992,485,100,585,151517,3.86095289637466
27100,"Jackson, MI",1993,479,105,584,152522,3.82895582276655
27100,"Jackson, MI",1994,590,31,621,152391,4.07504380179932
27100,"Jackson, MI",1995,545,89,634,153442,4.1318543814601
27100,"Jackson, MI",1996,687,29,716,154445,4.63595454692609
27100,"Jackson, MI",1997,575,120,695,155517,4.46896480770591
27100,"Jackson, MI",1998,651,67,718,156207,4.59646494715346
27100,"Jackson, MI",1999,745,262,1007,157333,6.40043728906205
27100,"Jackson, MI",2000,688,231,919,158679,5.79156662192225
27100,"Jackson, MI",2001,727,218,945,159772,5.91467841674386
27100,"Jackson, MI",2002,653,275,928,160893,5.76780841926
27100,"Jackson, MI",2003,673,158,831,162119,5.12586433422363
27100,"Jackson, MI",2004,688,16,704,162140,4.34192672998643
27100,"Jackson, MI",2005,669,228,897,163047,5.50148116800677
27100,"Jackson, MI",2006,498,89,587,163387,3.592697093404
27100,"Jackson, MI",2007,214,116,330,163316,2.02062259668373
27100,"Jackson, MI",2008,104,126,230,160825,1.43012591325975
27100,"Jackson, MI",2009,64,63,127,160114,0.793184855790249
27100,"Jackson, MI",2010,63,0,63,160125,0.39344262295082
27100,"Jackson, MI",2011,55,2,57,159656,0.3570175878138
27100,"Jackson, MI",2012,78,0,78,159966,0.487603615768351
27100,"Jackson, MI",2013,91,54,145,159637,0.908310729968616
27100,"Jackson, MI",2014,89,0,89,159437,0.558214216273512
27100,"Jackson, MI",2015,111,6,117,159292,0.734500163222259
27100,"Jackson, MI",2016,136,0,136,158321,0.859014281112424
27100,"Jackson, MI",2017,183,10,193,158690,1.21620770054824
27100,"Jackson, MI",2018,156,16,172,158823,1.08296657285154
27140,"Jackson, MS",1990,1188,157,1345,473423,2.84101110423448
27140,"Jackson, MS",1991,1523,199,1722,476541,3.61354007315215
27140,"Jackson, MS",1992,1944,291,2235,480709,4.64938247463642
27140,"Jackson, MS",1993,2518,267,2785,484484,5.7483838475574
27140,"Jackson, MS",1994,2391,1136,3527,489656,7.20301599490254
27140,"Jackson, MS",1995,2396,786,3182,494133,6.43956181837683
27140,"Jackson, MS",1996,2346,586,2932,500491,5.85824720124837
27140,"Jackson, MS",1997,2382,379,2761,505503,5.46188647742941
27140,"Jackson, MS",1998,2516,1248,3764,511391,7.36031725235681
27140,"Jackson, MS",1999,2613,1378,3991,514445,7.75787499149569
27140,"Jackson, MS",2000,2031,283,2314,526339,4.39640611849017
27140,"Jackson, MS",2001,2336,352,2688,528292,5.08809522006769
27140,"Jackson, MS",2002,2493,948,3441,530930,6.48108036841015
27140,"Jackson, MS",2003,3063,508,3571,535600,6.66728902165795
27140,"Jackson, MS",2004,3409,1100,4509,542144,8.3169785149333
27140,"Jackson, MS",2005,3493,42,3535,547444,6.45728147536552
27140,"Jackson, MS",2006,3528,198,3726,556877,6.6908850607944
27140,"Jackson, MS",2007,2881,167,3048,559153,5.45110193453312
27140,"Jackson, MS",2008,2077,50,2127,561812,3.78596398795327
27140,"Jackson, MS",2009,1184,6,1190,564376,2.10852339575035
27140,"Jackson, MS",2010,1305,88,1393,568869,2.44871842199171
27140,"Jackson, MS",2011,1209,153,1362,574272,2.37169842861919
27140,"Jackson, MS",2012,1390,36,1426,576649,2.47290812955541
27140,"Jackson, MS",2013,1596,243,1839,577522,3.1842942779669
27140,"Jackson, MS",2014,1954,8,1962,578856,3.38944400679962
27140,"Jackson, MS",2015,1569,0,1569,579595,2.70706269032687
27140,"Jackson, MS",2016,1669,4,1673,581230,2.87837861087693
27140,"Jackson, MS",2017,1671,72,1743,581552,2.99715244724461
27140,"Jackson, MS",2018,1325,16,1341,580166,2.31140742477153
27160,"Jackson, OH",1990,61,0,61,30239,2.01726247561097
27160,"Jackson, OH",1991,72,0,72,30726,2.34329232571763
27160,"Jackson, OH",1992,78,9,87,31248,2.78417818740399
27160,"Jackson, OH",1993,99,19,118,31558,3.73914696748843
27160,"Jackson, OH",1994,96,46,142,31871,4.45546107746855
27160,"Jackson, OH",1995,120,14,134,31957,4.19313452451732
27160,"Jackson, OH",1996,99,40,139,32269,4.30753974402678
27160,"Jackson, OH",1997,114,25,139,32422,4.28721238665104
27160,"Jackson, OH",1998,126,18,144,32597,4.41758444028592
27160,"Jackson, OH",1999,123,5,128,32683,3.91640914236759
27160,"Jackson, OH",2000,150,36,186,32633,5.69975178500291
27160,"Jackson, OH",2001,130,4,134,32670,4.10162228344046
27160,"Jackson, OH",2002,90,3,93,32846,2.83139499482433
27160,"Jackson, OH",2003,116,8,124,32880,3.77128953771289
27160,"Jackson, OH",2004,110,4,114,33025,3.45193035579107
27160,"Jackson, OH",2005,89,0,89,33242,2.67733590036701
27160,"Jackson, OH",2006,87,3,90,33135,2.71616115889543
27160,"Jackson, OH",2007,84,0,84,33144,2.53439536567705
27160,"Jackson, OH",2008,58,4,62,33164,1.86949704498854
27160,"Jackson, OH",2009,41,20,61,33115,1.84206552921637
27160,"Jackson, OH",2010,40,0,40,33254,1.20286281349612
27160,"Jackson, OH",2011,38,0,38,33127,1.14710055241948
27160,"Jackson, OH",2012,44,0,44,32874,1.33844375494312
27160,"Jackson, OH",2013,41,0,41,32809,1.24965710628181
27160,"Jackson, OH",2014,57,0,57,32770,1.73939578883125
27160,"Jackson, OH",2015,65,0,65,32560,1.9963144963145
27160,"Jackson, OH",2016,69,0,69,32521,2.12170597460103
27160,"Jackson, OH",2017,62,0,62,32385,1.91446657403119
27160,"Jackson, OH",2018,62,0,62,32384,1.9145256916996
27180,"Jackson, TN",1990,461,13,474,104460,4.53762205628949
27180,"Jackson, TN",1991,500,16,516,105502,4.8909025421319
27180,"Jackson, TN",1992,500,2,502,106718,4.70398620663806
27180,"Jackson, TN",1993,578,27,605,108120,5.59563448020718
27180,"Jackson, TN",1994,656,280,936,109303,8.56335141761891
27180,"Jackson, TN",1995,678,442,1120,110815,10.1069349817263
27180,"Jackson, TN",1996,571,136,707,111968,6.31430408688197
27180,"Jackson, TN",1997,704,28,732,113052,6.47489650780172
27180,"Jackson, TN",1998,742,232,974,114500,8.50655021834061
27180,"Jackson, TN",1999,878,52,930,115716,8.03691797158561
27180,"Jackson, TN",2000,663,0,663,122142,5.42810826742644
27180,"Jackson, TN",2001,592,218,810,123387,6.56471103114591
27180,"Jackson, TN",2002,614,74,688,123890,5.553313423198
27180,"Jackson, TN",2003,621,142,763,123886,6.15888800994463
27180,"Jackson, TN",2004,710,20,730,125351,5.82364719866615
27180,"Jackson, TN",2005,747,2,749,126192,5.93540002535818
27180,"Jackson, TN",2006,647,96,743,127602,5.8227927461952
27180,"Jackson, TN",2007,442,104,546,128134,4.26116409383926
27180,"Jackson, TN",2008,371,60,431,128445,3.35552181867725
27180,"Jackson, TN",2009,256,0,256,129164,1.98197640209346
27180,"Jackson, TN",2010,250,0,250,130032,1.92260366678971
27180,"Jackson, TN",2011,174,0,174,129735,1.34119551393225
27180,"Jackson, TN",2012,233,287,520,130169,3.99480675122341
27180,"Jackson, TN",2013,212,0,212,130421,1.62550509503838
27180,"Jackson, TN",2014,205,0,205,129869,1.57851373306948
27180,"Jackson, TN",2015,206,8,214,129276,1.65537300040224
27180,"Jackson, TN",2016,270,8,278,129115,2.15311931224103
27180,"Jackson, TN",2017,268,172,440,129186,3.40594182032109
27180,"Jackson, TN",2018,280,0,280,129209,2.16703170831753
27220,"Jackson, WY-ID",1990,246,88,334,14727,22.6794323351667
27220,"Jackson, WY-ID",1991,139,24,163,15388,10.5926696126852
27220,"Jackson, WY-ID",1992,334,34,368,16100,22.8571428571429
27220,"Jackson, WY-ID",1993,370,17,387,16909,22.8872198237625
27220,"Jackson, WY-ID",1994,441,48,489,17497,27.9476481682574
27220,"Jackson, WY-ID",1995,321,47,368,18172,20.2509355051728
27220,"Jackson, WY-ID",1996,282,27,309,18706,16.5187640329306
27220,"Jackson, WY-ID",1997,270,22,292,19185,15.2202241334376
27220,"Jackson, WY-ID",1998,385,6,391,19697,19.8507386911712
27220,"Jackson, WY-ID",1999,346,123,469,20262,23.1467772184385
27220,"Jackson, WY-ID",2000,429,113,542,24479,22.1414273458883
27220,"Jackson, WY-ID",2001,317,109,426,25108,16.9667038394137
27220,"Jackson, WY-ID",2002,323,92,415,25686,16.1566612162267
27220,"Jackson, WY-ID",2003,323,124,447,26259,17.0227350622644
27220,"Jackson, WY-ID",2004,420,126,546,26927,20.2770453448212
27220,"Jackson, WY-ID",2005,430,148,578,27446,21.0595350870801
27220,"Jackson, WY-ID",2006,562,165,727,28284,25.7035779946259
27220,"Jackson, WY-ID",2007,603,179,782,29404,26.5950210855666
27220,"Jackson, WY-ID",2008,347,50,397,30615,12.9674995917034
27220,"Jackson, WY-ID",2009,101,27,128,31273,4.09298756115499
27220,"Jackson, WY-ID",2010,89,42,131,31448,4.16560671584838
27220,"Jackson, WY-ID",2011,71,58,129,31576,4.08538130225488
27220,"Jackson, WY-ID",2012,101,31,132,31751,4.15734937482284
27220,"Jackson, WY-ID",2013,156,35,191,32722,5.83705152496791
27220,"Jackson, WY-ID",2014,163,10,173,33220,5.20770620108368
27220,"Jackson, WY-ID",2015,263,66,329,33748,9.74872585042077
27220,"Jackson, WY-ID",2016,246,33,279,34313,8.1310290560429
27220,"Jackson, WY-ID",2017,297,73,370,34696,10.6640534931981
27220,"Jackson, WY-ID",2018,294,82,376,34721,10.8291811871778
27260,"Jacksonville, FL",1990,6079,2177,8256,931326,8.86477989447304
27260,"Jacksonville, FL",1991,5959,1462,7421,951259,7.80124025107778
27260,"Jacksonville, FL",1992,6811,545,7356,969792,7.5851316570976
27260,"Jacksonville, FL",1993,7089,491,7580,979082,7.74194602699263
27260,"Jacksonville, FL",1994,7269,1384,8653,989470,8.74508575297887
27260,"Jacksonville, FL",1995,6550,2122,8672,1001980,8.65486337052636
27260,"Jacksonville, FL",1996,7536,3831,11367,1029624,11.0399524486609
27260,"Jacksonville, FL",1997,7046,1599,8645,1050345,8.23062898381008
27260,"Jacksonville, FL",1998,7725,1802,9527,1064280,8.95159168639832
27260,"Jacksonville, FL",1999,8147,3554,11701,1075459,10.8800056534001
27260,"Jacksonville, FL",2000,7966,2716,10682,1126282,9.48430322068541
27260,"Jacksonville, FL",2001,9722,3028,12750,1148091,11.105391471582
27260,"Jacksonville, FL",2002,10989,3372,14361,1171363,12.2600765091607
27260,"Jacksonville, FL",2003,12784,3037,15821,1193042,13.2610587053934
27260,"Jacksonville, FL",2004,14683,4643,19326,1222866,15.8038574954247
27260,"Jacksonville, FL",2005,18610,6478,25088,1249072,20.0853113351352
27260,"Jacksonville, FL",2006,11500,5467,16967,1282311,13.2315795466154
27260,"Jacksonville, FL",2007,7348,3580,10928,1306788,8.3624887893063
27260,"Jacksonville, FL",2008,5149,1814,6963,1322728,5.26412081697824
27260,"Jacksonville, FL",2009,3323,1343,4666,1334972,3.49520439380002
27260,"Jacksonville, FL",2010,3387,219,3606,1348889,2.67331114717371
27260,"Jacksonville, FL",2011,3245,666,3911,1361845,2.87183930623529
27260,"Jacksonville, FL",2012,4579,2587,7166,1377551,5.20198526225163
27260,"Jacksonville, FL",2013,6281,1077,7358,1393454,5.28040394587837
27260,"Jacksonville, FL",2014,6299,1482,7781,1416551,5.49291906892163
27260,"Jacksonville, FL",2015,7253,2418,9671,1444715,6.69405384452989
27260,"Jacksonville, FL",2016,8597,3171,11768,1476120,7.97225157846246
27260,"Jacksonville, FL",2017,9833,3126,12959,1504841,8.61154101994829
27260,"Jacksonville, FL",2018,10755,4695,15450,1534701,10.0671075343015
27300,"Jacksonville, IL",1990,38,6,44,42042,1.0465724751439
27300,"Jacksonville, IL",1991,48,2,50,41986,1.19087314819225
27300,"Jacksonville, IL",1992,63,4,67,41944,1.59736791913027
27300,"Jacksonville, IL",1993,73,53,126,42115,2.99180814436661
27300,"Jacksonville, IL",1994,62,10,72,42085,1.71082333372936
27300,"Jacksonville, IL",1995,35,20,55,41950,1.31108462455304
27300,"Jacksonville, IL",1996,43,22,65,41796,1.55517274380323
27300,"Jacksonville, IL",1997,37,4,41,41365,0.991176115073129
27300,"Jacksonville, IL",1998,32,26,58,41062,1.41249817349374
27300,"Jacksonville, IL",1999,23,4,27,40838,0.661148929918213
27300,"Jacksonville, IL",2000,14,8,22,42187,0.521487662075995
27300,"Jacksonville, IL",2001,20,2,22,41944,0.524508868968148
27300,"Jacksonville, IL",2002,30,162,192,41767,4.59693059113654
27300,"Jacksonville, IL",2003,18,2,20,41748,0.479064865382773
27300,"Jacksonville, IL",2004,19,2,21,36332,0.578002862490367
27300,"Jacksonville, IL",2005,12,8,20,36101,0.554001274202931
27300,"Jacksonville, IL",2006,19,62,81,35966,2.25212700884168
27300,"Jacksonville, IL",2007,19,22,41,35936,1.14091718610864
27300,"Jacksonville, IL",2008,10,0,10,35761,0.279634238416152
27300,"Jacksonville, IL",2009,11,0,11,35602,0.308971406100781
27300,"Jacksonville, IL",2010,8,0,8,35505,0.225320377411632
27300,"Jacksonville, IL",2011,5,0,5,35479,0.140928436539925
27300,"Jacksonville, IL",2012,9,22,31,35313,0.877863676266531
27300,"Jacksonville, IL",2013,2,2,4,34999,0.114288979685134
27300,"Jacksonville, IL",2014,2,0,2,34672,0.0576834333179511
27300,"Jacksonville, IL",2015,7,4,11,34665,0.317322948218664
27300,"Jacksonville, IL",2016,6,0,6,34616,0.173330251906633
27300,"Jacksonville, IL",2017,5,0,5,34199,0.146203105353958
27300,"Jacksonville, IL",2018,3,25,28,33976,0.824111137273369
27340,"Jacksonville, NC",1990,470,62,532,149864,3.54988522927454
27340,"Jacksonville, NC",1991,469,12,481,150163,3.20318587135313
27340,"Jacksonville, NC",1992,587,24,611,144323,4.23355944651927
27340,"Jacksonville, NC",1993,665,18,683,144814,4.71639482370489
27340,"Jacksonville, NC",1994,708,76,784,142911,5.48593180371
27340,"Jacksonville, NC",1995,622,54,676,142503,4.74375978049585
27340,"Jacksonville, NC",1996,713,119,832,142963,5.81968761147989
27340,"Jacksonville, NC",1997,666,160,826,141403,5.84146022361619
27340,"Jacksonville, NC",1998,842,106,948,143202,6.62001927347383
27340,"Jacksonville, NC",1999,693,277,970,141233,6.86808323833665
27340,"Jacksonville, NC",2000,634,281,915,150678,6.0725520646677
27340,"Jacksonville, NC",2001,787,380,1167,151068,7.72499801413933
27340,"Jacksonville, NC",2002,980,62,1042,153397,6.7928316720666
27340,"Jacksonville, NC",2003,1040,8,1048,150481,6.96433436779394
27340,"Jacksonville, NC",2004,1294,566,1860,158837,11.7101179196283
27340,"Jacksonville, NC",2005,1658,160,1818,157205,11.5645176680131
27340,"Jacksonville, NC",2006,1690,355,2045,161185,12.6872847969724
27340,"Jacksonville, NC",2007,1539,97,1636,163256,10.0210712010585
27340,"Jacksonville, NC",2008,1122,114,1236,169059,7.31105708657924
27340,"Jacksonville, NC",2009,1519,617,2136,173064,12.342254888365
27340,"Jacksonville, NC",2010,2134,241,2375,186889,12.7080780570285
27340,"Jacksonville, NC",2011,1871,160,2031,184962,10.980633859928
27340,"Jacksonville, NC",2012,2007,253,2260,190669,11.853001798929
27340,"Jacksonville, NC",2013,1332,326,1658,192351,8.61965885282634
27340,"Jacksonville, NC",2014,1045,36,1081,191820,5.63549160671463
27340,"Jacksonville, NC",2015,856,38,894,193037,4.63123649870232
27340,"Jacksonville, NC",2016,785,18,803,192184,4.1782874745036
27340,"Jacksonville, NC",2017,917,88,1005,194838,5.15813137067718
27340,"Jacksonville, NC",2018,1018,18,1036,197683,5.24071366784195
27380,"Jacksonville, TX",1990,31,0,31,41004,0.756023802555848
27380,"Jacksonville, TX",1991,21,42,63,40734,1.54661953159523
27380,"Jacksonville, TX",1992,18,20,38,40675,0.934234787953288
27380,"Jacksonville, TX",1993,16,28,44,40850,1.07711138310894
27380,"Jacksonville, TX",1994,32,22,54,40717,1.3262273743154
27380,"Jacksonville, TX",1995,38,2,40,42089,0.950367079284374
27380,"Jacksonville, TX",1996,41,2,43,42452,1.01290869688118
27380,"Jacksonville, TX",1997,46,0,46,42824,1.0741640201756
27380,"Jacksonville, TX",1998,50,0,50,43317,1.15428122907865
27380,"Jacksonville, TX",1999,25,2,27,43692,0.617962098324636
27380,"Jacksonville, TX",2000,43,2,45,46790,0.961743962385125
27380,"Jacksonville, TX",2001,76,0,76,47007,1.61678047950305
27380,"Jacksonville, TX",2002,49,8,57,47136,1.20926680244399
27380,"Jacksonville, TX",2003,22,10,32,47832,0.669008195350393
27380,"Jacksonville, TX",2004,27,8,35,48315,0.724412708268654
27380,"Jacksonville, TX",2005,28,4,32,48751,0.65639679186068
27380,"Jacksonville, TX",2006,25,8,33,49162,0.671250152556853
27380,"Jacksonville, TX",2007,17,86,103,49669,2.07372807988886
27380,"Jacksonville, TX",2008,32,74,106,49976,2.12101808868257
27380,"Jacksonville, TX",2009,10,10,20,50447,0.396455686165679
27380,"Jacksonville, TX",2010,16,14,30,50944,0.588881909547739
27380,"Jacksonville, TX",2011,68,6,74,51093,1.44833930283992
27380,"Jacksonville, TX",2012,18,2,20,51292,0.389924354675193
27380,"Jacksonville, TX",2013,13,2,15,51111,0.293478898867171
27380,"Jacksonville, TX",2014,6,0,6,51219,0.117144028583143
27380,"Jacksonville, TX",2015,5,0,5,51594,0.0969104934682327
27380,"Jacksonville, TX",2016,6,0,6,51926,0.115549050571968
27380,"Jacksonville, TX",2017,7,0,7,52182,0.134145874056188
27380,"Jacksonville, TX",2018,16,0,16,52592,0.304228780042592
27420,"Jamestown, ND",1990,10,0,10,22123,0.452018261537766
27420,"Jamestown, ND",1991,16,29,45,21980,2.04731574158326
27420,"Jamestown, ND",1992,26,18,44,21791,2.01918223119637
27420,"Jamestown, ND",1993,12,0,12,21734,0.552130302751449
27420,"Jamestown, ND",1994,37,3,40,21678,1.84518867054156
27420,"Jamestown, ND",1995,56,24,80,21384,3.74111485222596
27420,"Jamestown, ND",1996,25,0,25,21192,1.17969044922612
27420,"Jamestown, ND",1997,28,6,34,21076,1.61320933763522
27420,"Jamestown, ND",1998,33,27,60,20989,2.85864024012578
27420,"Jamestown, ND",1999,21,58,79,21061,3.75100897393286
27420,"Jamestown, ND",2000,24,27,51,21887,2.33015031754009
27420,"Jamestown, ND",2001,20,0,20,21664,0.923190546528804
27420,"Jamestown, ND",2002,17,12,29,21525,1.3472706155633
27420,"Jamestown, ND",2003,28,0,28,21345,1.3117826188803
27420,"Jamestown, ND",2004,32,16,48,21175,2.2668240850059
27420,"Jamestown, ND",2005,30,8,38,21132,1.7982207079311
27420,"Jamestown, ND",2006,34,44,78,21115,3.69405635803931
27420,"Jamestown, ND",2007,28,0,28,20876,1.3412531136233
27420,"Jamestown, ND",2008,32,17,49,20812,2.35441091677878
27420,"Jamestown, ND",2009,25,35,60,21009,2.85591889190347
27420,"Jamestown, ND",2010,19,64,83,21137,3.92676349529261
27420,"Jamestown, ND",2011,18,0,18,21020,0.856327307326356
27420,"Jamestown, ND",2012,20,0,20,20974,0.953561552398207
27420,"Jamestown, ND",2013,35,12,47,21080,2.22960151802657
27420,"Jamestown, ND",2014,43,0,43,21118,2.03617766833981
27420,"Jamestown, ND",2015,65,0,65,21050,3.08788598574822
27420,"Jamestown, ND",2016,48,0,48,21077,2.27736395122646
27420,"Jamestown, ND",2017,23,0,23,21160,1.08695652173913
27420,"Jamestown, ND",2018,11,0,11,20917,0.525888033656834
27460,"Jamestown-Dunkirk-Fredonia, NY",1990,226,11,237,141978,1.66927270422178
27460,"Jamestown-Dunkirk-Fredonia, NY",1991,201,97,298,142299,2.0941819689527
27460,"Jamestown-Dunkirk-Fredonia, NY",1992,192,46,238,141917,1.67703657771796
27460,"Jamestown-Dunkirk-Fredonia, NY",1993,238,59,297,142138,2.08951863681774
27460,"Jamestown-Dunkirk-Fredonia, NY",1994,209,82,291,141746,2.05296798498723
27460,"Jamestown-Dunkirk-Fredonia, NY",1995,193,32,225,140952,1.59628809807594
27460,"Jamestown-Dunkirk-Fredonia, NY",1996,206,25,231,140587,1.64311067168373
27460,"Jamestown-Dunkirk-Fredonia, NY",1997,190,27,217,139360,1.55711825487945
27460,"Jamestown-Dunkirk-Fredonia, NY",1998,171,36,207,138332,1.49639996530087
27460,"Jamestown-Dunkirk-Fredonia, NY",1999,201,26,227,137357,1.65262782384589
27460,"Jamestown-Dunkirk-Fredonia, NY",2000,208,28,236,139593,1.69062918627725
27460,"Jamestown-Dunkirk-Fredonia, NY",2001,240,33,273,138730,1.96785122179774
27460,"Jamestown-Dunkirk-Fredonia, NY",2002,260,32,292,138346,2.11065010914663
27460,"Jamestown-Dunkirk-Fredonia, NY",2003,280,93,373,137587,2.71101194153517
27460,"Jamestown-Dunkirk-Fredonia, NY",2004,242,23,265,137174,1.93185297505358
27460,"Jamestown-Dunkirk-Fredonia, NY",2005,206,240,446,136139,3.27606343516553
27460,"Jamestown-Dunkirk-Fredonia, NY",2006,190,15,205,135640,1.51135358301386
27460,"Jamestown-Dunkirk-Fredonia, NY",2007,164,2,166,135481,1.22526405916697
27460,"Jamestown-Dunkirk-Fredonia, NY",2008,141,40,181,135229,1.33847029853064
27460,"Jamestown-Dunkirk-Fredonia, NY",2009,120,37,157,135197,1.1612683713396
27460,"Jamestown-Dunkirk-Fredonia, NY",2010,130,0,130,134725,0.964928558174058
27460,"Jamestown-Dunkirk-Fredonia, NY",2011,88,41,129,134198,0.961266188765853
27460,"Jamestown-Dunkirk-Fredonia, NY",2012,102,59,161,133302,1.20778382919986
27460,"Jamestown-Dunkirk-Fredonia, NY",2013,101,4,105,132848,0.79037697217873
27460,"Jamestown-Dunkirk-Fredonia, NY",2014,69,143,212,131750,1.60910815939279
27460,"Jamestown-Dunkirk-Fredonia, NY",2015,79,0,79,130634,0.604743022490317
27460,"Jamestown-Dunkirk-Fredonia, NY",2016,67,8,75,129350,0.579822187862389
27460,"Jamestown-Dunkirk-Fredonia, NY",2017,90,32,122,128609,0.948611683474718
27460,"Jamestown-Dunkirk-Fredonia, NY",2018,133,2,135,127939,1.05519036415792
27500,"Janesville-Beloit, WI",1990,359,259,618,139855,4.41886239319295
27500,"Janesville-Beloit, WI",1991,343,213,556,141198,3.9377328290769
27500,"Janesville-Beloit, WI",1992,519,271,790,142865,5.52969586672733
27500,"Janesville-Beloit, WI",1993,548,259,807,144317,5.59185681520542
27500,"Janesville-Beloit, WI",1994,647,456,1103,145910,7.55945445822768
27500,"Janesville-Beloit, WI",1995,541,496,1037,148091,7.00245119554868
27500,"Janesville-Beloit, WI",1996,561,386,947,149832,6.32041219499172
27500,"Janesville-Beloit, WI",1997,514,277,791,150027,5.27238430415859
27500,"Janesville-Beloit, WI",1998,565,165,730,150695,4.8442217724543
27500,"Janesville-Beloit, WI",1999,611,378,989,151396,6.53253718724405
27500,"Janesville-Beloit, WI",2000,528,320,848,152464,5.56196872704376
27500,"Janesville-Beloit, WI",2001,496,340,836,153174,5.4578453262303
27500,"Janesville-Beloit, WI",2002,577,395,972,153628,6.32697164579374
27500,"Janesville-Beloit, WI",2003,639,349,988,154268,6.40443902818472
27500,"Janesville-Beloit, WI",2004,716,380,1096,155685,7.03985611972894
27500,"Janesville-Beloit, WI",2005,676,320,996,156761,6.35362111749734
27500,"Janesville-Beloit, WI",2006,571,187,758,158538,4.78118810632151
27500,"Janesville-Beloit, WI",2007,410,67,477,159912,2.9828905898244
27500,"Janesville-Beloit, WI",2008,222,33,255,160647,1.58733122934135
27500,"Janesville-Beloit, WI",2009,157,56,213,160411,1.32783911327777
27500,"Janesville-Beloit, WI",2010,101,10,111,160272,0.692572626534891
27500,"Janesville-Beloit, WI",2011,95,4,99,159864,0.619276384927188
27500,"Janesville-Beloit, WI",2012,121,4,125,160065,0.780932746071908
27500,"Janesville-Beloit, WI",2013,114,28,142,160355,0.885535218733435
27500,"Janesville-Beloit, WI",2014,123,20,143,160950,0.88847468157813
27500,"Janesville-Beloit, WI",2015,184,32,216,161052,1.34118173012443
27500,"Janesville-Beloit, WI",2016,229,28,257,161394,1.59237642043694
27500,"Janesville-Beloit, WI",2017,242,136,378,162320,2.32873336619024
27500,"Janesville-Beloit, WI",2018,310,30,340,163129,2.08424007993674
27540,"Jasper, IN",1990,219,8,227,49156,4.61795101310115
27540,"Jasper, IN",1991,183,84,267,49634,5.3793770399323
27540,"Jasper, IN",1992,229,32,261,49884,5.23213856146259
27540,"Jasper, IN",1993,231,44,275,50343,5.46252706433864
27540,"Jasper, IN",1994,245,18,263,50701,5.18727441273348
27540,"Jasper, IN",1995,259,80,339,51236,6.61644156452494
27540,"Jasper, IN",1996,230,54,284,51464,5.51842064355666
27540,"Jasper, IN",1997,240,14,254,51838,4.89988039662024
27540,"Jasper, IN",1998,290,22,312,52539,5.93844572603209
27540,"Jasper, IN",1999,286,14,300,53000,5.66037735849057
27540,"Jasper, IN",2000,269,54,323,52718,6.12693956523389
27540,"Jasper, IN",2001,231,4,235,53047,4.43003374366128
27540,"Jasper, IN",2002,212,10,222,53228,4.17073720598181
27540,"Jasper, IN",2003,213,42,255,53517,4.76484107853579
27540,"Jasper, IN",2004,284,34,318,53997,5.88921606755931
27540,"Jasper, IN",2005,250,0,250,54144,4.61731678486998
27540,"Jasper, IN",2006,120,4,124,54605,2.2708543173702
27540,"Jasper, IN",2007,174,2,176,54775,3.21314468279325
27540,"Jasper, IN",2008,132,28,160,55002,2.90898512781353
27540,"Jasper, IN",2009,91,26,117,54733,2.13765004658981
27540,"Jasper, IN",2010,105,10,115,54635,2.10487782556969
27540,"Jasper, IN",2011,104,2,106,54760,1.93571950328707
27540,"Jasper, IN",2012,68,35,103,54706,1.88279164991043
27540,"Jasper, IN",2013,111,16,127,54780,2.31836436655714
27540,"Jasper, IN",2014,134,10,144,54797,2.62788108838075
27540,"Jasper, IN",2015,66,47,113,54728,2.06475661453004
27540,"Jasper, IN",2016,79,6,85,54819,1.55055728853135
27540,"Jasper, IN",2017,96,12,108,54823,1.96997610491947
27540,"Jasper, IN",2018,70,2,72,54975,1.30968622100955
27600,"Jefferson, GA",1990,159,10,169,30168,5.60196234420578
27600,"Jefferson, GA",1991,146,8,154,30769,5.00503753778153
27600,"Jefferson, GA",1992,173,12,185,31391,5.89340893886783
27600,"Jefferson, GA",1993,206,18,224,32040,6.99126092384519
27600,"Jefferson, GA",1994,222,16,238,33026,7.20644340822382
27600,"Jefferson, GA",1995,319,25,344,33875,10.1549815498155
27600,"Jefferson, GA",1996,385,84,469,35183,13.3303015660973
27600,"Jefferson, GA",1997,463,10,473,36433,12.9827354321631
27600,"Jefferson, GA",1998,480,22,502,37745,13.2997748046099
27600,"Jefferson, GA",1999,617,19,636,39114,16.260162601626
27600,"Jefferson, GA",2000,766,98,864,41845,20.6476281515115
27600,"Jefferson, GA",2001,762,10,772,43367,17.801554177139302
27600,"Jefferson, GA",2002,908,4,912,44940,20.2937249666222
27600,"Jefferson, GA",2003,835,6,841,46230,18.191650443435
27600,"Jefferson, GA",2004,1515,8,1523,48288,31.5399271040424
27600,"Jefferson, GA",2005,1445,12,1457,50607,28.7904835299464
27600,"Jefferson, GA",2006,1378,10,1388,54037,25.6861039658012
27600,"Jefferson, GA",2007,819,0,819,57521,14.2382781940509
27600,"Jefferson, GA",2008,329,0,329,59420,5.53685627734769
27600,"Jefferson, GA",2009,148,0,148,60052,2.46453074002531
27600,"Jefferson, GA",2010,82,0,82,60695,1.35101738199193
27600,"Jefferson, GA",2011,116,0,116,60966,1.9026998654988
27600,"Jefferson, GA",2012,70,0,70,60840,1.15055884286654
27600,"Jefferson, GA",2013,292,56,348,61271,5.67968533237584
27600,"Jefferson, GA",2014,455,0,455,62103,7.3265381704587504
27600,"Jefferson, GA",2015,564,48,612,63436,9.64751875906425
27600,"Jefferson, GA",2016,873,0,873,65100,13.4101382488479
27600,"Jefferson, GA",2017,866,80,946,67716,13.9701104613385
27600,"Jefferson, GA",2018,885,320,1205,70422,17.1111300445883
27620,"Jefferson City, MO",1990,140,23,163,120976,1.34737468588811
27620,"Jefferson City, MO",1991,299,58,357,122435,2.91583289092171
27620,"Jefferson City, MO",1992,388,61,449,123589,3.63300941022259
27620,"Jefferson City, MO",1993,373,90,463,124886,3.70738113159201
27620,"Jefferson City, MO",1994,426,71,497,113905,4.36328519380185
27620,"Jefferson City, MO",1995,566,35,601,115815,5.18931053835859
27620,"Jefferson City, MO",1996,512,178,690,117565,5.86909369285076
27620,"Jefferson City, MO",1997,870,279,1149,118983,9.65684173369305
27620,"Jefferson City, MO",1998,571,198,769,119939,6.41159255955111
27620,"Jefferson City, MO",1999,669,82,751,120663,6.22394603150924
27620,"Jefferson City, MO",2000,489,270,759,127259,5.96421471172962
27620,"Jefferson City, MO",2001,410,222,632,127945,4.93962249404041
27620,"Jefferson City, MO",2002,439,217,656,129117,5.08066327439454
27620,"Jefferson City, MO",2003,421,75,496,129856,3.81961557417447
27620,"Jefferson City, MO",2004,500,46,546,142637,3.82789879203853
27620,"Jefferson City, MO",2005,512,62,574,144450,3.97369331948771
27620,"Jefferson City, MO",2006,397,106,503,145654,3.45338953959383
27620,"Jefferson City, MO",2007,238,13,251,146455,1.7138370147827
27620,"Jefferson City, MO",2008,202,29,231,147792,1.56300746995778
27620,"Jefferson City, MO",2009,203,110,313,148880,2.10236432025793
27620,"Jefferson City, MO",2010,181,41,222,149964,1.48035528526846
27620,"Jefferson City, MO",2011,183,28,211,150368,1.40322409023196
27620,"Jefferson City, MO",2012,207,19,226,150353,1.50312930237508
27620,"Jefferson City, MO",2013,240,35,275,150638,1.82556858163279
27620,"Jefferson City, MO",2014,171,69,240,150704,1.59252574583289
27620,"Jefferson City, MO",2015,166,104,270,150902,1.78924069926177
27620,"Jefferson City, MO",2016,162,160,322,151360,2.12737843551797
27620,"Jefferson City, MO",2017,243,79,322,151298,2.12825020819839
27620,"Jefferson City, MO",2018,225,24,249,151520,1.64334741288279
27700,"Jesup, GA",1990,34,68,102,22448,4.54383464005702
27700,"Jesup, GA",1991,37,0,37,23205,1.59448394742512
27700,"Jesup, GA",1992,37,0,37,23743,1.55835404119109
27700,"Jesup, GA",1993,30,0,30,23884,1.25607100988109
27700,"Jesup, GA",1994,8,4,12,24054,0.498877525567473
27700,"Jesup, GA",1995,7,6,13,24573,0.529035933748423
27700,"Jesup, GA",1996,12,0,12,24644,0.486933939295569
27700,"Jesup, GA",1997,10,0,10,24983,0.400272185085858
27700,"Jesup, GA",1998,12,8,20,25405,0.787246604999016
27700,"Jesup, GA",1999,9,4,13,25687,0.506092576011212
27700,"Jesup, GA",2000,9,4,13,26596,0.488795307565047
27700,"Jesup, GA",2001,14,0,14,26888,0.520678369532877
27700,"Jesup, GA",2002,16,0,16,27308,0.585908891167424
27700,"Jesup, GA",2003,17,0,17,27860,0.610193826274228
27700,"Jesup, GA",2004,19,0,19,28227,0.67311439401991
27700,"Jesup, GA",2005,21,0,21,28522,0.736273753593717
27700,"Jesup, GA",2006,20,0,20,28929,0.691347782501988
27700,"Jesup, GA",2007,17,0,17,29421,0.577818564970599
27700,"Jesup, GA",2008,11,0,11,30042,0.366154050995273
27700,"Jesup, GA",2009,9,2,11,30016,0.366471215351812
27700,"Jesup, GA",2010,1,2,3,30075,0.0997506234413965
27700,"Jesup, GA",2011,1,2,3,30294,0.0990295107942167
27700,"Jesup, GA",2012,2,50,52,30323,1.71486990073542
27700,"Jesup, GA",2013,1,0,1,29993,0.0333411129263495
27700,"Jesup, GA",2014,4,0,4,29893,0.133810591108286
27700,"Jesup, GA",2015,21,0,21,29422,0.713751614438175
27700,"Jesup, GA",2016,31,0,31,29953,1.03495476246119
27700,"Jesup, GA",2017,42,0,42,29760,1.41129032258065
27700,"Jesup, GA",2018,56,4,60,29808,2.01288244766506
27740,"Johnson City, TN",1990,189,72,261,160778,1.62335642936223
27740,"Johnson City, TN",1991,216,115,331,162250,2.04006163328197
27740,"Johnson City, TN",1992,302,116,418,163328,2.55926724137931
27740,"Johnson City, TN",1993,366,167,533,164901,3.23224237572847
27740,"Johnson City, TN",1994,351,81,432,166412,2.59596663702137
27740,"Johnson City, TN",1995,438,101,539,168028,3.20779870021663
27740,"Johnson City, TN",1996,411,181,592,169929,3.4838079433175
27740,"Johnson City, TN",1997,420,200,620,171729,3.61033954661123
27740,"Johnson City, TN",1998,372,235,607,172708,3.51460268198346
27740,"Johnson City, TN",1999,314,138,452,173527,2.60478196476629
27740,"Johnson City, TN",2000,246,262,508,181944,2.7920678890208
27740,"Johnson City, TN",2001,271,125,396,182187,2.17359087091834
27740,"Johnson City, TN",2002,673,74,747,183973,4.06037842509499
27740,"Johnson City, TN",2003,737,207,944,186040,5.07417759621587
27740,"Johnson City, TN",2004,871,214,1085,187317,5.79231997095832
27740,"Johnson City, TN",2005,946,319,1265,189182,6.68668266536986
27740,"Johnson City, TN",2006,1283,157,1440,191943,7.50222722370704
27740,"Johnson City, TN",2007,876,90,966,193819,4.98403149330045
27740,"Johnson City, TN",2008,598,455,1053,196242,5.36582382976121
27740,"Johnson City, TN",2009,478,27,505,197698,2.55440115732076
27740,"Johnson City, TN",2010,398,343,741,199008,3.72346840328027
27740,"Johnson City, TN",2011,357,42,399,199531,1.9996892713413
27740,"Johnson City, TN",2012,330,274,604,200281,3.01576285319127
27740,"Johnson City, TN",2013,452,392,844,200362,4.2123756001637
27740,"Johnson City, TN",2014,458,248,706,199954,3.53081208677996
27740,"Johnson City, TN",2015,547,142,689,200281,3.44016656597481
27740,"Johnson City, TN",2016,458,75,533,201332,2.64736852561937
27740,"Johnson City, TN",2017,638,58,696,201844,3.4482075266047
27740,"Johnson City, TN",2018,458,177,635,202719,3.1324148205151
27780,"Johnstown, PA",1990,209,44,253,162934,1.55277597063842
27780,"Johnstown, PA",1991,219,52,271,162451,1.66819533274649
27780,"Johnstown, PA",1992,198,0,198,162206,1.2206700122067
27780,"Johnstown, PA",1993,186,11,197,161713,1.21820756525449
27780,"Johnstown, PA",1994,224,14,238,160693,1.48108505037556
27780,"Johnstown, PA",1995,182,7,189,159804,1.1826988060374
27780,"Johnstown, PA",1996,182,2,184,158486,1.16098582840125
27780,"Johnstown, PA",1997,158,7,165,157282,1.04907109523022
27780,"Johnstown, PA",1998,201,0,201,155552,1.29217239251183
27780,"Johnstown, PA",1999,214,0,214,153776,1.39163458537093
27780,"Johnstown, PA",2000,211,9,220,152107,1.44635026658865
27780,"Johnstown, PA",2001,194,11,205,150902,1.35849756795801
27780,"Johnstown, PA",2002,211,2,213,149831,1.42160167121624
27780,"Johnstown, PA",2003,235,2,237,148836,1.59235668789809
27780,"Johnstown, PA",2004,312,8,320,147886,2.16382889523011
27780,"Johnstown, PA",2005,238,8,246,146975,1.67375403980269
27780,"Johnstown, PA",2006,175,57,232,146093,1.58802954282546
27780,"Johnstown, PA",2007,158,16,174,145283,1.19766249320292
27780,"Johnstown, PA",2008,115,149,264,144646,1.82514552770211
27780,"Johnstown, PA",2009,94,0,94,144186,0.651935694172805
27780,"Johnstown, PA",2010,117,0,117,143450,0.815615196932729
27780,"Johnstown, PA",2011,62,0,62,142551,0.434932059403301
27780,"Johnstown, PA",2012,71,0,71,141513,0.501720689971946
27780,"Johnstown, PA",2013,70,0,70,138806,0.504300966816996
27780,"Johnstown, PA",2014,59,2,61,137520,0.443571844095404
27780,"Johnstown, PA",2015,47,0,47,136029,0.345514559395423
27780,"Johnstown, PA",2016,164,0,164,134416,1.22009284608975
27780,"Johnstown, PA",2017,81,2,83,133054,0.623806875403971
27780,"Johnstown, PA",2018,66,0,66,131730,0.501024823502619
27860,"Jonesboro, AR",1990,362,63,425,93902,4.525995186471
27860,"Jonesboro, AR",1991,323,193,516,93723,5.50558560865529
27860,"Jonesboro, AR",1992,483,15,498,95101,5.23653799644588
27860,"Jonesboro, AR",1993,508,121,629,96626,6.50963508786455
27860,"Jonesboro, AR",1994,471,342,813,97143,8.36910533955097
27860,"Jonesboro, AR",1995,405,61,466,98659,4.72333998925592
27860,"Jonesboro, AR",1996,460,524,984,100025,9.83754061484629
27860,"Jonesboro, AR",1997,440,329,769,101045,7.61047058241378
27860,"Jonesboro, AR",1998,480,80,560,102057,5.48712974122304
27860,"Jonesboro, AR",1999,410,491,901,102555,8.78552971576227
27860,"Jonesboro, AR",2000,331,46,377,108136,3.48635052156544
27860,"Jonesboro, AR",2001,414,72,486,108774,4.46797948039053
27860,"Jonesboro, AR",2002,496,37,533,109191,4.88135469040489
27860,"Jonesboro, AR",2003,547,143,690,110177,6.26265009938553
27860,"Jonesboro, AR",2004,528,32,560,111370,5.02828409805154
27860,"Jonesboro, AR",2005,571,39,610,112570,5.41885049302656
27860,"Jonesboro, AR",2006,529,151,680,114629,5.93218121068839
27860,"Jonesboro, AR",2007,553,58,611,116163,5.25985038265196
27860,"Jonesboro, AR",2008,576,15,591,117915,5.0120849764661
27860,"Jonesboro, AR",2009,427,19,446,120114,3.71313918444145
27860,"Jonesboro, AR",2010,403,208,611,121258,5.03884279800096
27860,"Jonesboro, AR",2011,348,417,765,122837,6.22776524988399
27860,"Jonesboro, AR",2012,450,538,988,124282,7.94966286348787
27860,"Jonesboro, AR",2013,385,272,657,125829,5.22137186181246
27860,"Jonesboro, AR",2014,377,303,680,126813,5.36222627017735
27860,"Jonesboro, AR",2015,402,80,482,128435,3.75287110211391
27860,"Jonesboro, AR",2016,569,459,1028,129837,7.9176197848071
27860,"Jonesboro, AR",2017,512,354,866,131158,6.60272343280623
27860,"Jonesboro, AR",2018,551,292,843,132532,6.36072797513053
27900,"Joplin, MO",1990,252,66,318,135078,2.35419535379558
27900,"Joplin, MO",1991,277,30,307,135993,2.25746913444074
27900,"Joplin, MO",1992,307,146,453,137565,3.29298876894559
27900,"Joplin, MO",1993,372,279,651,139650,4.66165413533835
27900,"Joplin, MO",1994,413,296,709,141677,5.00434085984316
27900,"Joplin, MO",1995,453,289,742,143578,5.1679226622463
27900,"Joplin, MO",1996,477,261,738,145614,5.0681939923359
27900,"Joplin, MO",1997,453,68,521,147335,3.53615909322293
27900,"Joplin, MO",1998,403,124,527,148862,3.54019158683882
27900,"Joplin, MO",1999,470,136,606,149935,4.04175142561777
27900,"Joplin, MO",2000,400,81,481,157665,3.05077220689436
27900,"Joplin, MO",2001,411,93,504,158567,3.17846714637976
27900,"Joplin, MO",2002,602,33,635,160092,3.96646928016391
27900,"Joplin, MO",2003,481,118,599,162037,3.69668655924264
27900,"Joplin, MO",2004,656,59,715,163997,4.3598358506558
27900,"Joplin, MO",2005,582,124,706,166160,4.24891670678864
27900,"Joplin, MO",2006,409,119,528,168701,3.12979768940315
27900,"Joplin, MO",2007,326,71,397,171224,2.31860019623417
27900,"Joplin, MO",2008,212,55,267,172744,1.5456397906729
27900,"Joplin, MO",2009,153,65,218,174394,1.25004300606672
27900,"Joplin, MO",2010,144,58,202,175835,1.14880427673671
27900,"Joplin, MO",2011,189,121,310,173828,1.78337206894171
27900,"Joplin, MO",2012,176,103,279,174393,1.59983485575683
27900,"Joplin, MO",2013,363,103,466,175139,2.66074375210547
27900,"Joplin, MO",2014,332,76,408,175867,2.31993495084354
27900,"Joplin, MO",2015,445,86,531,176699,3.00511038545776
27900,"Joplin, MO",2016,383,39,422,177401,2.37879155134413
27900,"Joplin, MO",2017,445,320,765,178330,4.28979980934223
27900,"Joplin, MO",2018,457,183,640,178902,3.5773775586634
27920,"Junction City, KS",1990,35,6,41,30455,1.34624856345428
27920,"Junction City, KS",1991,33,8,41,29354,1.39674320365197
27920,"Junction City, KS",1992,45,7,52,32838,1.58353127474268
27920,"Junction City, KS",1993,41,6,47,30910,1.52054351342608
27920,"Junction City, KS",1994,34,18,52,30955,1.67985785818123
27920,"Junction City, KS",1995,17,0,17,29623,0.573878405293184
27920,"Junction City, KS",1996,22,10,32,26127,1.22478661920619
27920,"Junction City, KS",1997,25,36,61,25120,2.42834394904459
27920,"Junction City, KS",1998,33,36,69,25235,2.73429760253616
27920,"Junction City, KS",1999,25,0,25,24862,1.00555063953021
27920,"Junction City, KS",2000,41,2,43,27845,1.54426288382115
27920,"Junction City, KS",2001,30,16,46,27821,1.65342726717228
27920,"Junction City, KS",2002,28,0,28,27679,1.01159723978467
27920,"Junction City, KS",2003,44,7,51,27532,1.85238994624437
27920,"Junction City, KS",2004,64,0,64,27149,2.35736122877454
27920,"Junction City, KS",2005,61,0,61,27099,2.25100557216133
27920,"Junction City, KS",2006,1264,422,1686,27708,60.8488523170204
27920,"Junction City, KS",2007,260,854,1114,27951,39.8554613430646
27920,"Junction City, KS",2008,239,180,419,30276,13.8393446954684
27920,"Junction City, KS",2009,178,240,418,31537,13.2542727589815
27920,"Junction City, KS",2010,136,93,229,35240,6.49829738933031
27920,"Junction City, KS",2011,114,73,187,35290,5.29895154434684
27920,"Junction City, KS",2012,118,7,125,37902,3.29797899846974
27920,"Junction City, KS",2013,141,0,141,36802,3.83131351556981
27920,"Junction City, KS",2014,141,0,141,36451,3.86820663356287
27920,"Junction City, KS",2015,32,0,32,36660,0.872885979268958
27920,"Junction City, KS",2016,17,0,17,35136,0.483834244080146
27920,"Junction City, KS",2017,12,0,12,33633,0.356792436000357
27920,"Junction City, KS",2018,12,0,12,32594,0.368165920107995
27980,"Kahului-Wailuku-Lahaina, HI",1990,1128,748,1876,101469,18.4884053257645
27980,"Kahului-Wailuku-Lahaina, HI",1991,700,993,1693,104909,16.1377956133411
27980,"Kahului-Wailuku-Lahaina, HI",1992,816,178,994,107425,9.25296718640912
27980,"Kahului-Wailuku-Lahaina, HI",1993,661,210,871,110291,7.89728989672775
27980,"Kahului-Wailuku-Lahaina, HI",1994,528,342,870,112581,7.72776933940896
27980,"Kahului-Wailuku-Lahaina, HI",1995,475,114,589,115181,5.11369062605812
27980,"Kahului-Wailuku-Lahaina, HI",1996,544,210,754,117426,6.42106518147599
27980,"Kahului-Wailuku-Lahaina, HI",1997,532,67,599,118955,5.03551763271826
27980,"Kahului-Wailuku-Lahaina, HI",1998,574,67,641,120281,5.32918748597035
27980,"Kahului-Wailuku-Lahaina, HI",1999,647,247,894,121245,7.37349993814178
27980,"Kahului-Wailuku-Lahaina, HI",2000,904,239,1143,128933,8.8650694546780109
27980,"Kahului-Wailuku-Lahaina, HI",2001,778,277,1055,132290,7.97490362083302
27980,"Kahului-Wailuku-Lahaina, HI",2002,787,397,1184,134450,8.80624767571588
27980,"Kahului-Wailuku-Lahaina, HI",2003,877,211,1088,137469,7.91451163535052
27980,"Kahului-Wailuku-Lahaina, HI",2004,1104,379,1483,140508,10.5545591710081
27980,"Kahului-Wailuku-Lahaina, HI",2005,967,592,1559,143334,10.876693596774
27980,"Kahului-Wailuku-Lahaina, HI",2006,1008,390,1398,145667,9.59723204294727
27980,"Kahului-Wailuku-Lahaina, HI",2007,1050,251,1301,148012,8.7898278517958
27980,"Kahului-Wailuku-Lahaina, HI",2008,527,227,754,151325,4.9826532298034
27980,"Kahului-Wailuku-Lahaina, HI",2009,273,115,388,153300,2.53098499673842
27980,"Kahului-Wailuku-Lahaina, HI",2010,210,67,277,155006,1.78702759893165
27980,"Kahului-Wailuku-Lahaina, HI",2011,196,14,210,156911,1.33833829368241
27980,"Kahului-Wailuku-Lahaina, HI",2012,246,260,506,158888,3.18463320074518
27980,"Kahului-Wailuku-Lahaina, HI",2013,333,20,353,161016,2.19232871267452
27980,"Kahului-Wailuku-Lahaina, HI",2014,324,14,338,163064,2.07280576951381
27980,"Kahului-Wailuku-Lahaina, HI",2015,332,170,502,164042,3.06019190207386
27980,"Kahului-Wailuku-Lahaina, HI",2016,256,311,567,165624,3.42341689610201
27980,"Kahului-Wailuku-Lahaina, HI",2017,489,372,861,166403,5.17418556155839
27980,"Kahului-Wailuku-Lahaina, HI",2018,372,466,838,167207,5.0117519003391
28020,"Kalamazoo-Portage, MI",1990,849,156,1005,294064,3.41762337450351
28020,"Kalamazoo-Portage, MI",1991,898,95,993,295227,3.36351349978152
28020,"Kalamazoo-Portage, MI",1992,994,132,1126,297707,3.78224227176385
28020,"Kalamazoo-Portage, MI",1993,1169,164,1333,300175,4.44074289997501
28020,"Kalamazoo-Portage, MI",1994,1195,370,1565,301102,5.19757424394391
28020,"Kalamazoo-Portage, MI",1995,1221,520,1741,302467,5.75599982808042
28020,"Kalamazoo-Portage, MI",1996,1261,299,1560,304224,5.12780056800252
28020,"Kalamazoo-Portage, MI",1997,1227,529,1756,304809,5.76098474782569
28020,"Kalamazoo-Portage, MI",1998,1326,257,1583,305541,5.18097407549232
28020,"Kalamazoo-Portage, MI",1999,1382,151,1533,306425,5.00285551113649
28020,"Kalamazoo-Portage, MI",2000,1319,615,1934,315250,6.13481363996828
28020,"Kalamazoo-Portage, MI",2001,1351,272,1623,316512,5.12776766757658
28020,"Kalamazoo-Portage, MI",2002,1420,290,1710,318714,5.36531184698507
28020,"Kalamazoo-Portage, MI",2003,1532,930,2462,320856,7.67322412546438
28020,"Kalamazoo-Portage, MI",2004,1558,309,1867,319746,5.83900971396046
28020,"Kalamazoo-Portage, MI",2005,1541,69,1610,320268,5.02703985412217
28020,"Kalamazoo-Portage, MI",2006,1095,344,1439,321197,4.48011656397787
28020,"Kalamazoo-Portage, MI",2007,710,290,1000,322070,3.10491508057255
28020,"Kalamazoo-Portage, MI",2008,454,173,627,323363,1.93899734972771
28020,"Kalamazoo-Portage, MI",2009,385,16,401,325604,1.23155735187528
28020,"Kalamazoo-Portage, MI",2010,351,16,367,326893,1.12269152291423
28020,"Kalamazoo-Portage, MI",2011,337,14,351,328503,1.06848339284573
28020,"Kalamazoo-Portage, MI",2012,432,38,470,330642,1.42147700534112
28020,"Kalamazoo-Portage, MI",2013,511,58,569,332636,1.71057853028536
28020,"Kalamazoo-Portage, MI",2014,511,50,561,334198,1.6786455933309
28020,"Kalamazoo-Portage, MI",2015,501,122,623,334780,1.8609235916124
28020,"Kalamazoo-Portage, MI",2016,563,161,724,336581,2.15104239395569
28020,"Kalamazoo-Portage, MI",2017,579,457,1036,338347,3.06194528102806
28020,"Kalamazoo-Portage, MI",2018,471,108,579,340318,1.70134991390405
28060,"Kalispell, MT",1990,78,112,190,59529,3.19172168186934
28060,"Kalispell, MT",1991,124,111,235,60816,3.86411470665614
28060,"Kalispell, MT",1992,229,94,323,62794,5.14380354810969
28060,"Kalispell, MT",1993,369,87,456,65178,6.99622572033508
28060,"Kalispell, MT",1994,374,220,594,67280,8.82877526753864
28060,"Kalispell, MT",1995,280,71,351,69477,5.05203160758237
28060,"Kalispell, MT",1996,203,54,257,70980,3.62073823612285
28060,"Kalispell, MT",1997,194,51,245,71722,3.41596720671482
28060,"Kalispell, MT",1998,153,40,193,71896,2.68443306998999
28060,"Kalispell, MT",1999,213,42,255,72894,3.49823030702115
28060,"Kalispell, MT",2000,188,46,234,74774,3.12943001578089
28060,"Kalispell, MT",2001,221,82,303,76171,3.9778918486038
28060,"Kalispell, MT",2002,296,130,426,77583,5.49089362360311
28060,"Kalispell, MT",2003,333,115,448,79643,5.62510201775423
28060,"Kalispell, MT",2004,389,295,684,81247,8.41877238544192
28060,"Kalispell, MT",2005,511,213,724,83320,8.68939030244839
28060,"Kalispell, MT",2006,422,117,539,85759,6.28505462983477
28060,"Kalispell, MT",2007,278,153,431,88245,4.8841294124313
28060,"Kalispell, MT",2008,189,63,252,90260,2.79193441169953
28060,"Kalispell, MT",2009,78,8,86,90910,0.945990540094599
28060,"Kalispell, MT",2010,85,69,154,90867,1.6947846853093
28060,"Kalispell, MT",2011,88,10,98,91263,1.07381962021849
28060,"Kalispell, MT",2012,105,59,164,91595,1.79049074731153
28060,"Kalispell, MT",2013,197,30,227,92936,2.44254110355513
28060,"Kalispell, MT",2014,180,53,233,94577,2.46360108694503
28060,"Kalispell, MT",2015,149,132,281,95852,2.93160288778534
28060,"Kalispell, MT",2016,187,129,316,97785,3.23157948560618
28060,"Kalispell, MT",2017,224,137,361,100092,3.60668185269552
28060,"Kalispell, MT",2018,234,232,466,102106,4.56388459052357
28100,"Kankakee, IL",1990,245,204,449,96528,4.65150008287751
28100,"Kankakee, IL",1991,330,50,380,97436,3.89999589474116
28100,"Kankakee, IL",1992,348,54,402,98918,4.06397217897653
28100,"Kankakee, IL",1993,402,122,524,100332,5.22266076625603
28100,"Kankakee, IL",1994,419,238,657,101164,6.49440512435254
28100,"Kankakee, IL",1995,374,159,533,101217,5.26591382870466
28100,"Kankakee, IL",1996,333,201,534,101454,5.26346915843634
28100,"Kankakee, IL",1997,290,217,507,101971,4.97200184366143
28100,"Kankakee, IL",1998,326,124,450,102107,4.40714152800494
28100,"Kankakee, IL",1999,314,62,376,102423,3.67105044765336
28100,"Kankakee, IL",2000,313,76,389,103842,3.74607576895668
28100,"Kankakee, IL",2001,405,48,453,104490,4.33534309503302
28100,"Kankakee, IL",2002,379,89,468,104932,4.46003125833873
28100,"Kankakee, IL",2003,583,88,671,105794,6.34251469837609
28100,"Kankakee, IL",2004,543,108,651,106744,6.098703440006
28100,"Kankakee, IL",2005,725,102,827,107917,7.66329679290566
28100,"Kankakee, IL",2006,590,40,630,109735,5.74110356768579
28100,"Kankakee, IL",2007,382,26,408,111499,3.65922564327931
28100,"Kankakee, IL",2008,168,26,194,112658,1.72202595465923
28100,"Kankakee, IL",2009,94,2,96,113107,0.848753834864332
28100,"Kankakee, IL",2010,59,12,71,113419,0.62599740784172
28100,"Kankakee, IL",2011,54,8,62,113513,0.546192947063332
28100,"Kankakee, IL",2012,66,6,72,112980,0.637280934678704
28100,"Kankakee, IL",2013,112,0,112,112752,0.993330495246204
28100,"Kankakee, IL",2014,115,12,127,111907,1.13487091960288
28100,"Kankakee, IL",2015,89,0,89,111758,0.796363571287962
28100,"Kankakee, IL",2016,86,0,86,111074,0.774258602373193
28100,"Kankakee, IL",2017,88,110,198,110544,1.79114198871038
28100,"Kankakee, IL",2018,101,56,157,110024,1.42696139024213
28140,"Kansas City, MO-KS",1990,6289,1227,7516,1618740,4.64311748644007
28140,"Kansas City, MO-KS",1991,6857,806,7663,1635696,4.68485586563762
28140,"Kansas City, MO-KS",1992,8837,831,9668,1651831,5.85289899511512
28140,"Kansas City, MO-KS",1993,8924,907,9831,1671822,5.88041071358075
28140,"Kansas City, MO-KS",1994,9211,1673,10884,1691183,6.43573167421858
28140,"Kansas City, MO-KS",1995,8338,2917,11255,1707191,6.59270110960051
28140,"Kansas City, MO-KS",1996,9753,2657,12410,1729361,7.17606098437515
28140,"Kansas City, MO-KS",1997,9454,4160,13614,1751877,7.77109351855182
28140,"Kansas City, MO-KS",1998,10182,3689,13871,1771692,7.82923894220892
28140,"Kansas City, MO-KS",1999,11271,5160,16431,1790785,9.17530580164565
28140,"Kansas City, MO-KS",2000,9265,3640,12905,1817929,7.09873707939089
28140,"Kansas City, MO-KS",2001,9763,5218,14981,1837551,8.1526988910784
28140,"Kansas City, MO-KS",2002,10802,3068,13870,1858778,7.46189162987726
28140,"Kansas City, MO-KS",2003,11737,2997,14734,1875142,7.85753825576943
28140,"Kansas City, MO-KS",2004,12427,2491,14918,1892097,7.88437379267553
28140,"Kansas City, MO-KS",2005,11963,3034,14997,1909428,7.85418460397564
28140,"Kansas City, MO-KS",2006,8592,4483,13075,1931764,6.76842512853537
28140,"Kansas City, MO-KS",2007,5929,2095,8024,1954688,4.10500294676184
28140,"Kansas City, MO-KS",2008,2556,2688,5244,1973888,2.65668568834706
28140,"Kansas City, MO-KS",2009,1824,1541,3365,1994834,1.68685715202368
28140,"Kansas City, MO-KS",2010,2125,556,2681,2013373,1.33159628146399
28140,"Kansas City, MO-KS",2011,2338,924,3262,2025319,1.61061047667059
28140,"Kansas City, MO-KS",2012,3274,1682,4956,2038570,2.43111592930338
28140,"Kansas City, MO-KS",2013,4201,3303,7504,2053939,3.65346780016349
28140,"Kansas City, MO-KS",2014,4170,4031,8201,2069384,3.96301508081632
28140,"Kansas City, MO-KS",2015,4547,4407,8954,2085979,4.2924689078845
28140,"Kansas City, MO-KS",2016,5292,5097,10389,2106882,4.9309833203758
28140,"Kansas City, MO-KS",2017,5951,3900,9851,2127259,4.63084184859483
28140,"Kansas City, MO-KS",2018,5608,4660,10268,2143651,4.78995881325832
28180,"Kapaa, HI",1990,858,338,1196,51629,23.1652753297565
28180,"Kapaa, HI",1991,491,18,509,53134,9.5795535815109
28180,"Kapaa, HI",1992,518,87,605,53989,11.205986404638
28180,"Kapaa, HI",1993,497,121,618,54801,11.2771664750643
28180,"Kapaa, HI",1994,432,239,671,55601,12.0681282710743
28180,"Kapaa, HI",1995,298,92,390,55976,6.96727168786623
28180,"Kapaa, HI",1996,303,67,370,56377,6.56296007236994
28180,"Kapaa, HI",1997,284,40,324,56195,5.76563751223418
28180,"Kapaa, HI",1998,252,18,270,56117,4.81137623180142
28180,"Kapaa, HI",1999,261,30,291,56319,5.16699515261279
28180,"Kapaa, HI",2000,263,27,290,58568,4.95150935664527
28180,"Kapaa, HI",2001,325,48,373,59075,6.31400761743546
28180,"Kapaa, HI",2002,508,96,604,59981,10.0698554542272
28180,"Kapaa, HI",2003,485,58,543,60805,8.93018666228106
28180,"Kapaa, HI",2004,432,0,432,62095,6.95708189065142
28180,"Kapaa, HI",2005,895,28,923,62863,14.6827227462896
28180,"Kapaa, HI",2006,556,366,922,63465,14.5276924288978
28180,"Kapaa, HI",2007,495,138,633,64490,9.81547526748333
28180,"Kapaa, HI",2008,203,274,477,65603,7.27100894776154
28180,"Kapaa, HI",2009,220,292,512,66518,7.69716467723022
28180,"Kapaa, HI",2010,170,2,172,67213,2.55902875931739
28180,"Kapaa, HI",2011,120,0,120,67898,1.76735691772954
28180,"Kapaa, HI",2012,129,0,129,68691,1.87797528060445
28180,"Kapaa, HI",2013,159,0,159,69660,2.28251507321275
28180,"Kapaa, HI",2014,192,0,192,70324,2.7302201239975
28180,"Kapaa, HI",2015,205,0,205,71074,2.88431775332752
28180,"Kapaa, HI",2016,150,16,166,71575,2.31924554662941
28180,"Kapaa, HI",2017,216,96,312,71780,4.34661465589301
28180,"Kapaa, HI",2018,202,166,368,72133,5.10168716121609
28260,"Kearney, NE",1990,87,14,101,44186,2.28579187978093
28260,"Kearney, NE",1991,115,99,214,44533,4.80542519030831
28260,"Kearney, NE",1992,139,204,343,44989,7.62408588766143
28260,"Kearney, NE",1993,174,175,349,45557,7.6607327084751
28260,"Kearney, NE",1994,165,152,317,45709,6.93517687982673
28260,"Kearney, NE",1995,116,201,317,46111,6.87471536075991
28260,"Kearney, NE",1996,128,166,294,46720,6.29280821917808
28260,"Kearney, NE",1997,109,70,179,46839,3.82160165673904
28260,"Kearney, NE",1998,122,167,289,47203,6.12249221447789
28260,"Kearney, NE",1999,126,153,279,47227,5.90763758019777
28260,"Kearney, NE",2000,167,54,221,49199,4.49196121872396
28260,"Kearney, NE",2001,177,11,188,49260,3.81648396264718
28260,"Kearney, NE",2002,217,0,217,49734,4.3632122893795
28260,"Kearney, NE",2003,278,91,369,50051,7.37248007032826
28260,"Kearney, NE",2004,397,24,421,50529,8.33184903718656
28260,"Kearney, NE",2005,210,94,304,50829,5.98083771075567
28260,"Kearney, NE",2006,175,20,195,51259,3.80420999239158
28260,"Kearney, NE",2007,131,10,141,51684,2.72811701880659
28260,"Kearney, NE",2008,108,32,140,51897,2.69765111663487
28260,"Kearney, NE",2009,85,6,91,52446,1.73511802616024
28260,"Kearney, NE",2010,107,30,137,52651,2.60203984729635
28260,"Kearney, NE",2011,137,5,142,53366,2.66087021699209
28260,"Kearney, NE",2012,155,54,209,54147,3.8598629656306
28260,"Kearney, NE",2013,182,150,332,54487,6.09319654229449
28260,"Kearney, NE",2014,166,124,290,54792,5.29274346619945
28260,"Kearney, NE",2015,183,41,224,55171,4.06010404016603
28260,"Kearney, NE",2016,146,82,228,55773,4.08799956968426
28260,"Kearney, NE",2017,133,45,178,56015,3.17772025350353
28260,"Kearney, NE",2018,193,10,203,56159,3.61473672964262
28300,"Keene, NH",1990,259,99,358,70223,5.09804480013671
28300,"Keene, NH",1991,176,15,191,70494,2.70945044968366
28300,"Keene, NH",1992,199,26,225,70601,3.18692369796462
28300,"Keene, NH",1993,190,12,202,70891,2.84944492248663
28300,"Keene, NH",1994,186,83,269,70567,3.81198010401462
28300,"Keene, NH",1995,172,28,200,70850,2.82286520818631
28300,"Keene, NH",1996,170,0,170,71375,2.38178633975482
28300,"Keene, NH",1997,157,90,247,71839,3.43824385083311
28300,"Keene, NH",1998,191,5,196,72042,2.72063518503095
28300,"Keene, NH",1999,271,42,313,72210,4.33457969810276
28300,"Keene, NH",2000,255,29,284,73953,3.84027693264641
28300,"Keene, NH",2001,237,6,243,74372,3.26735868337546
28300,"Keene, NH",2002,315,22,337,75047,4.49051927458792
28300,"Keene, NH",2003,367,17,384,76135,5.04367242398371
28300,"Keene, NH",2004,304,117,421,76709,5.48827386616955
28300,"Keene, NH",2005,324,7,331,77061,4.29529852973618
28300,"Keene, NH",2006,276,24,300,77658,3.86309201885189
28300,"Keene, NH",2007,193,5,198,77745,2.54678757476365
28300,"Keene, NH",2008,128,0,128,77472,1.65220983064849
28300,"Keene, NH",2009,84,38,122,77302,1.57822566039688
28300,"Keene, NH",2010,88,14,102,77057,1.32369544622812
28300,"Keene, NH",2011,67,12,79,76927,1.02694762567109
28300,"Keene, NH",2012,43,50,93,76902,1.20933135679176
28300,"Keene, NH",2013,57,48,105,76714,1.36872018145319
28300,"Keene, NH",2014,66,75,141,76424,1.84497016643986
28300,"Keene, NH",2015,61,151,212,76261,2.77992683022777
28300,"Keene, NH",2016,88,111,199,75950,2.6201448321264
28300,"Keene, NH",2017,96,8,104,76185,1.36509811642712
28300,"Keene, NH",2018,102,60,162,76493,2.11784084818219
28340,"Kendallville, IN",1990,212,2,214,38010,5.63009734280453
28340,"Kendallville, IN",1991,165,12,177,38286,4.62309982761323
28340,"Kendallville, IN",1992,168,8,176,38636,4.55533699140698
28340,"Kendallville, IN",1993,168,92,260,39404,6.59831489188915
28340,"Kendallville, IN",1994,245,43,288,39984,7.20288115246098
28340,"Kendallville, IN",1995,318,24,342,40778,8.38687527588406
28340,"Kendallville, IN",1996,299,110,409,41462,9.86445419902561
28340,"Kendallville, IN",1997,208,31,239,41953,5.69685123829047
28340,"Kendallville, IN",1998,226,20,246,42618,5.772208925806
28340,"Kendallville, IN",1999,200,8,208,43272,4.80680347568867
28340,"Kendallville, IN",2000,221,23,244,46640,5.23156089193825
28340,"Kendallville, IN",2001,239,19,258,47110,5.4765442581193
28340,"Kendallville, IN",2002,199,10,209,46884,4.4578107669994
28340,"Kendallville, IN",2003,212,36,248,46917,5.28593047296289
28340,"Kendallville, IN",2004,198,10,208,46996,4.42590858796493
28340,"Kendallville, IN",2005,232,26,258,47292,5.45546815529053
28340,"Kendallville, IN",2006,165,6,171,47470,3.60227512112913
28340,"Kendallville, IN",2007,159,8,167,47419,3.52179506105148
28340,"Kendallville, IN",2008,79,0,79,47561,1.66102478921806
28340,"Kendallville, IN",2009,72,0,72,47574,1.51343170639425
28340,"Kendallville, IN",2010,66,0,66,47455,1.39079127594563
28340,"Kendallville, IN",2011,73,2,75,47298,1.58569072688063
28340,"Kendallville, IN",2012,67,0,67,47197,1.41958175307753
28340,"Kendallville, IN",2013,76,6,82,47253,1.73533955516052
28340,"Kendallville, IN",2014,85,2,87,47380,1.83621781342339
28340,"Kendallville, IN",2015,88,4,92,47531,1.93557888535903
28340,"Kendallville, IN",2016,105,6,111,47426,2.34048833972926
28340,"Kendallville, IN",2017,109,0,109,47384,2.30035455005909
28340,"Kendallville, IN",2018,151,0,151,47532,3.17680720356812
28380,"Kennett, MO",1990,24,0,24,33129,0.724440822240333
28380,"Kennett, MO",1991,32,24,56,32830,1.70575692963753
28380,"Kennett, MO",1992,43,6,49,32928,1.48809523809524
28380,"Kennett, MO",1993,38,0,38,32942,1.15354259000668
28380,"Kennett, MO",1994,47,10,57,32765,1.73966122386693
28380,"Kennett, MO",1995,37,3,40,32812,1.2190661952944
28380,"Kennett, MO",1996,38,2,40,33026,1.21116695936535
28380,"Kennett, MO",1997,32,0,32,32840,0.97442143727162
28380,"Kennett, MO",1998,33,4,37,32679,1.1322255882983
28380,"Kennett, MO",1999,23,22,45,32502,1.38453018275798
28380,"Kennett, MO",2000,34,14,48,33148,1.44805116447448
28380,"Kennett, MO",2001,26,53,79,33006,2.39350421135551
28380,"Kennett, MO",2002,22,8,30,32871,0.912658574427307
28380,"Kennett, MO",2003,24,4,28,32723,0.855667267671057
28380,"Kennett, MO",2004,25,0,25,32420,0.771128932757557
28380,"Kennett, MO",2005,18,0,18,32581,0.552469230533133
28380,"Kennett, MO",2006,18,0,18,32388,0.555761393108559
28380,"Kennett, MO",2007,20,2,22,32255,0.682064796155635
28380,"Kennett, MO",2008,12,0,12,32158,0.373157534672554
28380,"Kennett, MO",2009,3,0,3,31977,0.0938174312787316
28380,"Kennett, MO",2010,3,0,3,31945,0.0939114102363437
28380,"Kennett, MO",2011,14,0,14,32002,0.437472657958878
28380,"Kennett, MO",2012,21,0,21,31837,0.659609887866319
28380,"Kennett, MO",2013,14,0,14,31717,0.441403663650408
28380,"Kennett, MO",2014,15,0,15,31296,0.479294478527607
28380,"Kennett, MO",2015,17,0,17,30818,0.551625673307807
28380,"Kennett, MO",2016,17,0,17,30518,0.55704829936431
28380,"Kennett, MO",2017,19,0,19,30086,0.631522967493186
28380,"Kennett, MO",2018,19,0,19,29423,0.645753322230908
28420,"Kennewick-Richland, WA",1990,434,44,478,151243,3.1604768485153
28420,"Kennewick-Richland, WA",1991,475,19,494,155536,3.17611356856291
28420,"Kennewick-Richland, WA",1992,975,56,1031,160826,6.41065499359556
28420,"Kennewick-Richland, WA",1993,1308,359,1667,166796,9.99424446629416
28420,"Kennewick-Richland, WA",1994,1272,1058,2330,173220,13.4511026440365
28420,"Kennewick-Richland, WA",1995,514,516,1030,178291,5.77707231436248
28420,"Kennewick-Richland, WA",1996,792,88,880,178964,4.91719004939541
28420,"Kennewick-Richland, WA",1997,768,155,923,180813,5.10472145255043
28420,"Kennewick-Richland, WA",1998,836,13,849,182727,4.64627559145611
28420,"Kennewick-Richland, WA",1999,963,54,1017,184981,5.49786194257789
28420,"Kennewick-Richland, WA",2000,966,52,1018,192696,5.28293270228754
28420,"Kennewick-Richland, WA",2001,1381,164,1545,196420,7.86579778026678
28420,"Kennewick-Richland, WA",2002,1893,354,2247,202688,11.0860041048311
28420,"Kennewick-Richland, WA",2003,1916,333,2249,209043,10.7585520682348
28420,"Kennewick-Richland, WA",2004,2217,1047,3264,213854,15.2627493523619
28420,"Kennewick-Richland, WA",2005,2164,286,2450,219086,11.18282318359
28420,"Kennewick-Richland, WA",2006,1714,10,1724,224149,7.69131247518392
28420,"Kennewick-Richland, WA",2007,1396,207,1603,229255,6.99221391027459
28420,"Kennewick-Richland, WA",2008,1082,19,1101,237348,4.63875827898276
28420,"Kennewick-Richland, WA",2009,1080,11,1091,245600,4.44218241042345
28420,"Kennewick-Richland, WA",2010,1573,449,2022,255548,7.91240784510151
28420,"Kennewick-Richland, WA",2011,1339,358,1697,263494,6.44037435387523
28420,"Kennewick-Richland, WA",2012,1271,354,1625,268120,6.0607190810085
28420,"Kennewick-Richland, WA",2013,1085,220,1305,270856,4.81805830404348
28420,"Kennewick-Richland, WA",2014,1078,186,1264,274285,4.60834533423264
28420,"Kennewick-Richland, WA",2015,1221,243,1464,279095,5.24552571704975
28420,"Kennewick-Richland, WA",2016,1448,439,1887,283967,6.64513834353992
28420,"Kennewick-Richland, WA",2017,1457,352,1809,290570,6.22569432494752
28420,"Kennewick-Richland, WA",2018,1558,343,1901,296224,6.41744085556876
28500,"Kerrville, TX",1990,43,0,43,36357,1.18271584564183
28500,"Kerrville, TX",1991,49,0,49,36743,1.33358734997142
28500,"Kerrville, TX",1992,63,0,63,37682,1.6718857810095
28500,"Kerrville, TX",1993,119,0,119,38246,3.11143649009047
28500,"Kerrville, TX",1994,151,88,239,39200,6.0969387755102
28500,"Kerrville, TX",1995,107,0,107,40255,2.65805490001242
28500,"Kerrville, TX",1996,110,0,110,41351,2.66015332156417
28500,"Kerrville, TX",1997,74,4,78,41933,1.86011017575656
28500,"Kerrville, TX",1998,69,2,71,42738,1.6612850390753
28500,"Kerrville, TX",1999,90,0,90,43106,2.08787639771726
28500,"Kerrville, TX",2000,79,88,167,43848,3.80861156723226
28500,"Kerrville, TX",2001,74,31,105,44331,2.36854571293226
28500,"Kerrville, TX",2002,89,0,89,44894,1.98244754310153
28500,"Kerrville, TX",2003,88,0,88,45278,1.94354874331905
28500,"Kerrville, TX",2004,104,0,104,46054,2.25821861293264
28500,"Kerrville, TX",2005,88,0,88,46809,1.87998034566002
28500,"Kerrville, TX",2006,0,0,0,47840,0
28500,"Kerrville, TX",2007,0,0,0,48352,0
28500,"Kerrville, TX",2008,69,0,69,48852,1.41242937853107
28500,"Kerrville, TX",2009,46,0,46,49427,0.930665425779432
28500,"Kerrville, TX",2010,41,0,41,49622,0.826246422957559
28500,"Kerrville, TX",2011,41,0,41,49617,0.826329685390088
28500,"Kerrville, TX",2012,43,0,43,49701,0.865173738958975
28500,"Kerrville, TX",2013,51,0,51,49775,1.02461074836765
28500,"Kerrville, TX",2014,65,26,91,50334,1.80792307386657
28500,"Kerrville, TX",2015,63,0,63,50854,1.23884060250914
28500,"Kerrville, TX",2016,60,0,60,51384,1.16767865483419
28500,"Kerrville, TX",2017,40,96,136,51850,2.62295081967213
28500,"Kerrville, TX",2018,50,87,137,52405,2.6142543650415
28540,"Ketchikan, AK",1990,84,63,147,13951,10.5368790767687
28540,"Ketchikan, AK",1991,50,6,56,14110,3.96881644223955
28540,"Ketchikan, AK",1992,42,6,48,14469,3.31743727970143
28540,"Ketchikan, AK",1993,31,28,59,14512,4.06560088202867
28540,"Ketchikan, AK",1994,45,16,61,14603,4.17722385811135
28540,"Ketchikan, AK",1995,64,20,84,14676,5.72363041700736
28540,"Ketchikan, AK",1996,46,24,70,14827,4.72111688136508
28540,"Ketchikan, AK",1997,24,10,34,14623,2.32510428776585
28540,"Ketchikan, AK",1998,36,2,38,14213,2.67360866812073
28540,"Ketchikan, AK",1999,43,14,57,14125,4.0353982300885
28540,"Ketchikan, AK",2000,31,8,39,14000,2.78571428571429
28540,"Ketchikan, AK",2001,30,33,63,13796,4.56654102638446
28540,"Ketchikan, AK",2002,17,8,25,13599,1.8383704684168
28540,"Ketchikan, AK",2003,29,0,29,13335,2.17472815898013
28540,"Ketchikan, AK",2004,40,2,42,13244,3.17124735729387
28540,"Ketchikan, AK",2005,20,9,29,13305,2.17963171739947
28540,"Ketchikan, AK",2006,39,0,39,13492,2.8906018381263
28540,"Ketchikan, AK",2007,38,6,44,13341,3.2981035904355
28540,"Ketchikan, AK",2008,35,10,45,13326,3.37685727149932
28540,"Ketchikan, AK",2009,20,0,20,13294,1.5044380923725
28540,"Ketchikan, AK",2010,15,2,17,13566,1.2531328320802
28540,"Ketchikan, AK",2011,14,27,41,13665,3.00036589828028
28540,"Ketchikan, AK",2012,19,4,23,13723,1.67601836333163
28540,"Ketchikan, AK",2013,24,16,40,13716,2.91630212890055
28540,"Ketchikan, AK",2014,28,9,37,13801,2.68096514745308
28540,"Ketchikan, AK",2015,18,6,24,13706,1.75105793083321
28540,"Ketchikan, AK",2016,32,6,38,13714,2.77089106023042
28540,"Ketchikan, AK",2017,22,8,30,13882,2.16107189165826
28540,"Ketchikan, AK",2018,35,12,47,13918,3.37692197154764
28580,"Key West, FL",1990,678,113,791,78238,10.1101766405072
28580,"Key West, FL",1991,553,155,708,78986,8.9636138049781
28580,"Key West, FL",1992,446,82,528,79665,6.62775371869704
28580,"Key West, FL",1993,284,114,398,82167,4.84379373714508
28580,"Key West, FL",1994,286,60,346,81575,4.24149555623659
28580,"Key West, FL",1995,406,135,541,81439,6.64300887781039
28580,"Key West, FL",1996,416,4,420,81332,5.16401908228004
28580,"Key West, FL",1997,364,156,520,80897,6.42792686997046
28580,"Key West, FL",1998,383,12,395,80810,4.88800890978839
28580,"Key West, FL",1999,391,16,407,79942,5.09119111355733
28580,"Key West, FL",2000,195,8,203,79470,2.5544230527243
28580,"Key West, FL",2001,230,2,232,79038,2.93529694577292
28580,"Key West, FL",2002,232,103,335,78755,4.25369817789347
28580,"Key West, FL",2003,236,194,430,78497,5.47791635349122
28580,"Key West, FL",2004,376,7,383,77616,4.93454957740672
28580,"Key West, FL",2005,506,32,538,75819,7.09584668750577
28580,"Key West, FL",2006,430,27,457,73793,6.19299933598038
28580,"Key West, FL",2007,259,10,269,72906,3.68968260499822
28580,"Key West, FL",2008,215,45,260,72730,3.57486594252715
28580,"Key West, FL",2009,114,2,116,72627,1.59720214245391
28580,"Key West, FL",2010,125,146,271,73220,3.70117454247473
28580,"Key West, FL",2011,99,36,135,73963,1.82523694279572
28580,"Key West, FL",2012,132,89,221,74568,2.96373779637378
28580,"Key West, FL",2013,143,36,179,75834,2.36041880950497
28580,"Key West, FL",2014,152,36,188,76284,2.46447485711289
28580,"Key West, FL",2015,203,59,262,76696,3.41608428079691
28580,"Key West, FL",2016,208,12,220,76982,2.8578109168377
28580,"Key West, FL",2017,191,56,247,76636,3.22302834177149
28580,"Key West, FL",2018,306,247,553,75027,7.37067988857345
28620,"Kill Devil Hills, NC",1990,348,39,387,26789,14.446227929374
28620,"Kill Devil Hills, NC",1991,371,31,402,26905,14.9414606950381
28620,"Kill Devil Hills, NC",1992,453,20,473,27459,17.2256819257803
28620,"Kill Devil Hills, NC",1993,531,8,539,28178,19.1283980410249
28620,"Kill Devil Hills, NC",1994,538,55,593,28922,20.5034229997925
28620,"Kill Devil Hills, NC",1995,501,56,557,29865,18.6505943412021
28620,"Kill Devil Hills, NC",1996,524,47,571,30620,18.647942521228
28620,"Kill Devil Hills, NC",1997,554,38,592,31655,18.7016269151793
28620,"Kill Devil Hills, NC",1998,665,35,700,32825,21.3252094440213
28620,"Kill Devil Hills, NC",1999,800,25,825,33731,24.4582135127924
28620,"Kill Devil Hills, NC",2000,908,21,929,34275,27.1043034281546
28620,"Kill Devil Hills, NC",2001,957,48,1005,34992,28.7208504801097
28620,"Kill Devil Hills, NC",2002,1156,20,1176,36133,32.5464257050342
28620,"Kill Devil Hills, NC",2003,841,33,874,37041,23.5954752841446
28620,"Kill Devil Hills, NC",2004,846,45,891,37485,23.7695078031213
28620,"Kill Devil Hills, NC",2005,714,35,749,37634,19.9022160812032
28620,"Kill Devil Hills, NC",2006,429,52,481,37802,12.7241944870642
28620,"Kill Devil Hills, NC",2007,309,145,454,37943,11.9653163956461
28620,"Kill Devil Hills, NC",2008,209,26,235,37906,6.19954624597689
28620,"Kill Devil Hills, NC",2009,124,7,131,38037,3.44401503798933
28620,"Kill Devil Hills, NC",2010,140,2,142,38397,3.69820558897831
28620,"Kill Devil Hills, NC",2011,158,0,158,38492,4.1047490387613
28620,"Kill Devil Hills, NC",2012,235,0,235,38505,6.10310349305285
28620,"Kill Devil Hills, NC",2013,213,0,213,38914,5.4736084699594
28620,"Kill Devil Hills, NC",2014,220,15,235,39014,6.02347875121751
28620,"Kill Devil Hills, NC",2015,267,2,269,39569,6.79825115620814
28620,"Kill Devil Hills, NC",2016,310,16,326,39790,8.19301331992963
28620,"Kill Devil Hills, NC",2017,309,0,309,40298,7.66787433619534
28620,"Kill Devil Hills, NC",2018,340,0,340,40632,8.36778893482969
28660,"Killeen-Temple, TX",1990,259,2,261,269281,0.969247737493548
28660,"Killeen-Temple, TX",1991,445,9,454,264493,1.71649155176129
28660,"Killeen-Temple, TX",1992,1310,8,1318,268611,4.90672384973065
28660,"Killeen-Temple, TX",1993,1769,30,1799,283361,6.3487918238572
28660,"Killeen-Temple, TX",1994,1522,86,1608,303337,5.30103482265599
28660,"Killeen-Temple, TX",1995,1608,588,2196,307559,7.14009344548526
28660,"Killeen-Temple, TX",1996,1495,721,2216,311762,7.10798622025776
28660,"Killeen-Temple, TX",1997,1177,659,1836,313836,5.85018927082935
28660,"Killeen-Temple, TX",1998,1247,431,1678,316163,5.30738891015078
28660,"Killeen-Temple, TX",1999,1277,289,1566,315199,4.9682898740161
28660,"Killeen-Temple, TX",2000,1411,486,1897,332989,5.69688488208319
28660,"Killeen-Temple, TX",2001,1613,712,2325,336409,6.91123008005137
28660,"Killeen-Temple, TX",2002,1873,1111,2984,341231,8.74480923479989
28660,"Killeen-Temple, TX",2003,1965,710,2675,342865,7.80190453968763
28660,"Killeen-Temple, TX",2004,2534,1114,3648,349745,10.4304564754321
28660,"Killeen-Temple, TX",2005,3405,827,4232,357533,11.8366696221048
28660,"Killeen-Temple, TX",2006,2808,1765,4573,365460,12.512997318448
28660,"Killeen-Temple, TX",2007,2487,722,3209,380804,8.42690728038571
28660,"Killeen-Temple, TX",2008,1814,589,2403,392237,6.12639807055428
28660,"Killeen-Temple, TX",2009,2022,318,2340,395375,5.91843186847929
28660,"Killeen-Temple, TX",2010,1958,283,2241,408276,5.48893395644123
28660,"Killeen-Temple, TX",2011,1815,393,2208,412347,5.35471338460083
28660,"Killeen-Temple, TX",2012,2058,588,2646,423508,6.2478158618019
28660,"Killeen-Temple, TX",2013,2114,340,2454,423997,5.78777680030755
28660,"Killeen-Temple, TX",2014,2115,256,2371,426499,5.55921584810281
28660,"Killeen-Temple, TX",2015,1840,470,2310,432750,5.33795493934142
28660,"Killeen-Temple, TX",2016,1782,546,2328,436744,5.33035370835089
28660,"Killeen-Temple, TX",2017,1789,667,2456,443653,5.53585797909628
28660,"Killeen-Temple, TX",2018,2070,390,2460,451679,5.44634574554053
28700,"Kingsport-Bristol-Bristol, TN-VA",1990,939,130,1069,276001,3.87317437255662
28700,"Kingsport-Bristol-Bristol, TN-VA",1991,914,185,1099,277822,3.95577024137757
28700,"Kingsport-Bristol-Bristol, TN-VA",1992,1138,270,1408,280423,5.02098615306162
28700,"Kingsport-Bristol-Bristol, TN-VA",1993,1131,256,1387,282419,4.91114266391426
28700,"Kingsport-Bristol-Bristol, TN-VA",1994,1320,216,1536,283050,5.4266030736619
28700,"Kingsport-Bristol-Bristol, TN-VA",1995,1247,286,1533,285308,5.37314060594165
28700,"Kingsport-Bristol-Bristol, TN-VA",1996,1152,97,1249,286820,4.35464751412035
28700,"Kingsport-Bristol-Bristol, TN-VA",1997,1139,118,1257,288033,4.36408328212392
28700,"Kingsport-Bristol-Bristol, TN-VA",1998,1055,253,1308,289216,4.52257136534632
28700,"Kingsport-Bristol-Bristol, TN-VA",1999,1170,181,1351,289846,4.66109589230143
28700,"Kingsport-Bristol-Bristol, TN-VA",2000,955,38,993,298534,3.32625429599309
28700,"Kingsport-Bristol-Bristol, TN-VA",2001,1013,43,1056,298648,3.53593528166939
28700,"Kingsport-Bristol-Bristol, TN-VA",2002,1080,226,1306,299267,4.3639960303007
28700,"Kingsport-Bristol-Bristol, TN-VA",2003,1117,133,1250,300370,4.16153410793355
28700,"Kingsport-Bristol-Bristol, TN-VA",2004,1366,79,1445,300668,4.80596538374553
28700,"Kingsport-Bristol-Bristol, TN-VA",2005,1162,233,1395,302519,4.61128061377963
28700,"Kingsport-Bristol-Bristol, TN-VA",2006,1163,244,1407,304535,4.62015860245949
28700,"Kingsport-Bristol-Bristol, TN-VA",2007,1041,214,1255,306805,4.09054611235149
28700,"Kingsport-Bristol-Bristol, TN-VA",2008,575,124,699,308069,2.26897221077096
28700,"Kingsport-Bristol-Bristol, TN-VA",2009,489,65,554,309293,1.79118182435425
28700,"Kingsport-Bristol-Bristol, TN-VA",2010,434,30,464,309483,1.49927459666605
28700,"Kingsport-Bristol-Bristol, TN-VA",2011,340,45,385,308991,1.24599098355616
28700,"Kingsport-Bristol-Bristol, TN-VA",2012,333,106,439,308545,1.42280704597384
28700,"Kingsport-Bristol-Bristol, TN-VA",2013,415,2,417,307806,1.35474942008928
28700,"Kingsport-Bristol-Bristol, TN-VA",2014,316,24,340,307197,1.1067816417478
28700,"Kingsport-Bristol-Bristol, TN-VA",2015,419,286,705,306183,2.30254455668669
28700,"Kingsport-Bristol-Bristol, TN-VA",2016,379,613,992,305721,3.24478854903654
28700,"Kingsport-Bristol-Bristol, TN-VA",2017,469,319,788,306253,2.573036019239
28700,"Kingsport-Bristol-Bristol, TN-VA",2018,503,53,556,306616,1.81334307407311
28740,"Kingston, NY",1990,588,56,644,165806,3.88405727175132
28740,"Kingston, NY",1991,476,66,542,167636,3.23319573361331
28740,"Kingston, NY",1992,466,72,538,168631,3.19039796953111
28740,"Kingston, NY",1993,355,67,422,169336,2.49208673879152
28740,"Kingston, NY",1994,321,25,346,168014,2.05935219684074
28740,"Kingston, NY",1995,279,91,370,167140,2.21371305492402
28740,"Kingston, NY",1996,290,12,302,166978,1.80862149504725
28740,"Kingston, NY",1997,268,53,321,166910,1.92319213947636
28740,"Kingston, NY",1998,333,132,465,166833,2.78721835608063
28740,"Kingston, NY",1999,443,107,550,167228,3.28892290764704
28740,"Kingston, NY",2000,510,38,548,177810,3.08194139812159
28740,"Kingston, NY",2001,538,34,572,178440,3.20555929163865
28740,"Kingston, NY",2002,718,130,848,180128,4.70776336827145
28740,"Kingston, NY",2003,694,111,805,180942,4.4489394391573
28740,"Kingston, NY",2004,807,57,864,181847,4.75124692736201
28740,"Kingston, NY",2005,767,143,910,182438,4.98799592190224
28740,"Kingston, NY",2006,531,71,602,182845,3.29240613634499
28740,"Kingston, NY",2007,418,178,596,182818,3.26007285934645
28740,"Kingston, NY",2008,270,248,518,183174,2.82791225828993
28740,"Kingston, NY",2009,171,116,287,182638,1.57141449205532
28740,"Kingston, NY",2010,154,180,334,182409,1.8310500030152
28740,"Kingston, NY",2011,128,102,230,182430,1.26075755084142
28740,"Kingston, NY",2012,144,70,214,181535,1.17883603712783
28740,"Kingston, NY",2013,137,14,151,180701,0.835634556532615
28740,"Kingston, NY",2014,161,128,289,180419,1.60182685859028
28740,"Kingston, NY",2015,148,159,307,179692,1.70847895287492
28740,"Kingston, NY",2016,148,104,252,179080,1.40719231628323
28740,"Kingston, NY",2017,201,135,336,178723,1.88000425239057
28740,"Kingston, NY",2018,193,59,252,178599,1.41098214435691
28780,"Kingsville, TX",1990,6,0,6,30071,0.199527784243956
28780,"Kingsville, TX",1991,28,0,28,29973,0.934174090014346
28780,"Kingsville, TX",1992,6,0,6,30343,0.197739182018917
28780,"Kingsville, TX",1993,15,0,15,30597,0.490244141582508
28780,"Kingsville, TX",1994,18,0,18,30529,0.589603327983229
28780,"Kingsville, TX",1995,32,0,32,30196,1.05974301231951
28780,"Kingsville, TX",1996,20,0,20,30244,0.661288189392937
28780,"Kingsville, TX",1997,11,0,11,30183,0.364443560944903
28780,"Kingsville, TX",1998,11,0,11,30162,0.364697301239971
28780,"Kingsville, TX",1999,12,0,12,29745,0.403429147755925
28780,"Kingsville, TX",2000,11,0,11,31590,0.34821145932257
28780,"Kingsville, TX",2001,11,0,11,31315,0.351269359731758
28780,"Kingsville, TX",2002,8,0,8,31413,0.254671632763506
28780,"Kingsville, TX",2003,9,0,9,31339,0.287182105363924
28780,"Kingsville, TX",2004,6,0,6,31362,0.191314329443275
28780,"Kingsville, TX",2005,7,0,7,31242,0.224057358683823
28780,"Kingsville, TX",2006,40,0,40,31149,1.2841503740088
28780,"Kingsville, TX",2007,33,0,33,31370,1.05196047178833
28780,"Kingsville, TX",2008,26,0,26,31555,0.82395816827761
28780,"Kingsville, TX",2009,30,0,30,31876,0.941146944409587
28780,"Kingsville, TX",2010,19,0,19,32034,0.593119810201661
28780,"Kingsville, TX",2011,18,23,41,32033,1.27993007211313
28780,"Kingsville, TX",2012,19,32,51,32105,1.58853761096402
28780,"Kingsville, TX",2013,37,386,423,32031,13.2059567294184
28780,"Kingsville, TX",2014,36,0,36,31910,1.1281729865246
28780,"Kingsville, TX",2015,44,11,55,31487,1.74675262806873
28780,"Kingsville, TX",2016,9,0,9,31447,0.286195821541006
28780,"Kingsville, TX",2017,5,0,5,31152,0.16050333846944
28780,"Kingsville, TX",2018,6,0,6,31129,0.19274631372675
28820,"Kinston, NC",1990,127,30,157,57346,2.73776723747079
28820,"Kinston, NC",1991,88,18,106,57568,1.84130072262368
28820,"Kinston, NC",1992,121,14,135,57891,2.3319686997979
28820,"Kinston, NC",1993,151,19,170,58319,2.9150019719131
28820,"Kinston, NC",1994,142,55,197,58563,3.36389870737496
28820,"Kinston, NC",1995,153,7,160,59017,2.71108324719996
28820,"Kinston, NC",1996,129,24,153,59013,2.59264907732195
28820,"Kinston, NC",1997,144,18,162,58951,2.74804498651422
28820,"Kinston, NC",1998,152,66,218,58822,3.70609635850532
28820,"Kinston, NC",1999,155,8,163,58726,2.77560194802983
28820,"Kinston, NC",2000,194,48,242,59556,4.06340251192155
28820,"Kinston, NC",2001,150,10,160,59421,2.69265074636913
28820,"Kinston, NC",2002,142,6,148,59293,2.49607879513602
28820,"Kinston, NC",2003,105,16,121,59142,2.04592337087011
28820,"Kinston, NC",2004,89,32,121,59088,2.04779312212294
28820,"Kinston, NC",2005,75,2,77,59195,1.3007855393192
28820,"Kinston, NC",2006,76,8,84,59203,1.41884701788761
28820,"Kinston, NC",2007,79,8,87,59072,1.4727789815818
28820,"Kinston, NC",2008,52,8,60,59398,1.01013502138119
28820,"Kinston, NC",2009,40,0,40,59421,0.673162686592282
28820,"Kinston, NC",2010,32,0,32,59492,0.537887447051704
28820,"Kinston, NC",2011,35,55,90,59409,1.51492198151795
28820,"Kinston, NC",2012,35,2,37,59115,0.625898672079844
28820,"Kinston, NC",2013,43,2,45,58737,0.766126972776955
28820,"Kinston, NC",2014,30,24,54,58261,0.926863596574037
28820,"Kinston, NC",2015,38,0,38,57994,0.655240197261786
28820,"Kinston, NC",2016,51,61,112,57263,1.95588774601401
28820,"Kinston, NC",2017,25,4,29,56641,0.511996610229339
28820,"Kinston, NC",2018,29,64,93,55976,1.6614263255681
28860,"Kirksville, MO",1990,14,0,14,24565,0.569916547934052
28860,"Kirksville, MO",1991,30,0,30,28700,1.04529616724739
28860,"Kirksville, MO",1992,20,6,26,28744,0.904536598942388
28860,"Kirksville, MO",1993,29,64,93,28860,3.22245322245322
28860,"Kirksville, MO",1994,32,58,90,28923,3.11171040348512
28860,"Kirksville, MO",1995,46,60,106,28991,3.6563071297989
28860,"Kirksville, MO",1996,31,100,131,28779,4.55193022690156
28860,"Kirksville, MO",1997,27,6,33,28715,1.14922514365314
28860,"Kirksville, MO",1998,28,36,64,28708,2.22934373693744
28860,"Kirksville, MO",1999,38,26,64,28651,2.23377892569195
28860,"Kirksville, MO",2000,50,81,131,29134,4.49646461179378
28860,"Kirksville, MO",2001,44,14,58,29151,1.98964014956605
28860,"Kirksville, MO",2002,34,18,52,29317,1.77371490943821
28860,"Kirksville, MO",2003,36,23,59,29222,2.01902676065978
28860,"Kirksville, MO",2004,43,30,73,29301,2.49138254667076
28860,"Kirksville, MO",2005,55,22,77,29129,2.64341378008171
28860,"Kirksville, MO",2006,40,18,58,29274,1.98128031700485
28860,"Kirksville, MO",2007,43,25,68,29296,2.32113599126161
28860,"Kirksville, MO",2008,34,37,71,29782,2.38399032972937
28860,"Kirksville, MO",2009,20,14,34,29991,1.13367343536394
28860,"Kirksville, MO",2010,18,0,18,30064,0.598722724853646
28860,"Kirksville, MO",2011,16,18,34,30041,1.13178655837023
28860,"Kirksville, MO",2012,47,28,75,30058,2.49517599308005
28860,"Kirksville, MO",2013,35,31,66,30072,2.19473264166002
28860,"Kirksville, MO",2014,36,21,57,29909,1.90578086863486
28860,"Kirksville, MO",2015,23,12,35,29809,1.17414203763964
28860,"Kirksville, MO",2016,54,13,67,29656,2.25923927704343
28860,"Kirksville, MO",2017,87,4,91,29820,3.05164319248826
28860,"Kirksville, MO",2018,41,24,65,29938,2.17115371768321
28900,"Klamath Falls, OR",1990,102,21,123,57948,2.12259266928971
28900,"Klamath Falls, OR",1991,100,23,123,58284,2.11035618694667
28900,"Klamath Falls, OR",1992,94,29,123,58698,2.09547173668609
28900,"Klamath Falls, OR",1993,109,27,136,59600,2.28187919463087
28900,"Klamath Falls, OR",1994,171,42,213,60537,3.51850934139452
28900,"Klamath Falls, OR",1995,127,187,314,61130,5.13659414362833
28900,"Klamath Falls, OR",1996,152,29,181,62059,2.91657938413445
28900,"Klamath Falls, OR",1997,163,81,244,62763,3.88764080748212
28900,"Klamath Falls, OR",1998,145,30,175,63145,2.77139916066197
28900,"Klamath Falls, OR",1999,158,46,204,63398,3.21776712199123
28900,"Klamath Falls, OR",2000,148,2,150,63885,2.34796900680911
28900,"Klamath Falls, OR",2001,161,54,215,64139,3.35209466938992
28900,"Klamath Falls, OR",2002,212,15,227,64150,3.5385814497272
28900,"Klamath Falls, OR",2003,241,64,305,64582,4.72267814561333
28900,"Klamath Falls, OR",2004,319,47,366,64841,5.64457673385667
28900,"Klamath Falls, OR",2005,480,80,560,65553,8.54270590209449
28900,"Klamath Falls, OR",2006,443,6,449,66294,6.7728602890156004
28900,"Klamath Falls, OR",2007,311,0,311,66767,4.65798972546318
28900,"Klamath Falls, OR",2008,110,0,110,66732,1.64838458310855
28900,"Klamath Falls, OR",2009,59,36,95,66460,1.42943123683419
28900,"Klamath Falls, OR",2010,68,0,68,66318,1.02536264664194
28900,"Klamath Falls, OR",2011,57,0,57,66294,0.859806317313784
28900,"Klamath Falls, OR",2012,62,0,62,65900,0.94081942336874
28900,"Klamath Falls, OR",2013,63,0,63,65682,0.959166895039737
28900,"Klamath Falls, OR",2014,75,0,75,65277,1.14894985982812
28900,"Klamath Falls, OR",2015,90,0,90,65661,1.37067665737652
28900,"Klamath Falls, OR",2016,95,10,105,66168,1.58686978599927
28900,"Klamath Falls, OR",2017,98,35,133,66789,1.99134588030963
28900,"Klamath Falls, OR",2018,138,8,146,67653,2.15807133460453
28940,"Knoxville, TN",1990,2884,372,3256,636152,5.1182736201411
28940,"Knoxville, TN",1991,2838,252,3090,663928,4.65411912135051
28940,"Knoxville, TN",1992,3544,231,3775,675691,5.58687328971379
28940,"Knoxville, TN",1993,3716,527,4243,685715,6.18770188781053
28940,"Knoxville, TN",1994,3813,391,4204,697179,6.03001524716034
28940,"Knoxville, TN",1995,3487,765,4252,708911,5.99793203942385
28940,"Knoxville, TN",1996,3937,1197,5134,718190,7.14852615603113
28940,"Knoxville, TN",1997,3230,1113,4343,724506,5.99442930769379
28940,"Knoxville, TN",1998,3044,660,3704,728606,5.08368034301118
28940,"Knoxville, TN",1999,3166,628,3794,733632,5.17153014045189
28940,"Knoxville, TN",2000,3017,586,3603,749847,4.80498021596406
28940,"Knoxville, TN",2001,3174,626,3800,756459,5.02340510192886
28940,"Knoxville, TN",2002,3479,826,4305,763352,5.63960007964871
28940,"Knoxville, TN",2003,3844,166,4010,772111,5.1935537765943
28940,"Knoxville, TN",2004,5058,999,6057,780124,7.76415031456538
28940,"Knoxville, TN",2005,5331,534,5865,790669,7.4177690032112
28940,"Knoxville, TN",2006,5407,1224,6631,804860,8.23869989811893
28940,"Knoxville, TN",2007,4173,813,4986,816480,6.10670194003527
28940,"Knoxville, TN",2008,2306,815,3121,827099,3.77342978289177
28940,"Knoxville, TN",2009,1533,598,2131,833862,2.55557874084681
28940,"Knoxville, TN",2010,1606,821,2427,838702,2.89375725823952
28940,"Knoxville, TN",2011,1268,58,1326,843119,1.57273172588923
28940,"Knoxville, TN",2012,1577,473,2050,847334,2.41935293520619
28940,"Knoxville, TN",2013,2039,342,2381,851594,2.79593327336736
28940,"Knoxville, TN",2014,2095,1014,3109,855683,3.63335487557892
28940,"Knoxville, TN",2015,2592,468,3060,860324,3.55679953133936
28940,"Knoxville, TN",2016,2917,720,3637,867386,4.19305822321319
28940,"Knoxville, TN",2017,3372,1202,4574,875797,5.22267146382095
28940,"Knoxville, TN",2018,3690,723,4413,883309,4.99598668189727
29020,"Kokomo, IN",1990,160,40,200,80947,2.47075246766403
29020,"Kokomo, IN",1991,158,24,182,81777,2.22556464531592
29020,"Kokomo, IN",1992,208,47,255,82270,3.09955026133463
29020,"Kokomo, IN",1993,223,160,383,82882,4.62102748485799
29020,"Kokomo, IN",1994,326,162,488,83075,5.87421005115859
29020,"Kokomo, IN",1995,288,302,590,83276,7.08487439358279
29020,"Kokomo, IN",1996,335,324,659,83901,7.85449517884173
29020,"Kokomo, IN",1997,283,126,409,83796,4.88090123633586
29020,"Kokomo, IN",1998,251,140,391,83374,4.68971142082664
29020,"Kokomo, IN",1999,359,162,521,83662,6.22743898066028
29020,"Kokomo, IN",2000,374,34,408,84940,4.80339062867907
29020,"Kokomo, IN",2001,335,47,382,84909,4.49893415303442
29020,"Kokomo, IN",2002,380,68,448,84563,5.29782529002046
29020,"Kokomo, IN",2003,308,45,353,84538,4.17563699164873
29020,"Kokomo, IN",2004,247,21,268,84291,3.17946162698271
29020,"Kokomo, IN",2005,227,12,239,84382,2.83235761181295
29020,"Kokomo, IN",2006,112,2,114,83943,1.35806440084343
29020,"Kokomo, IN",2007,81,2,83,83743,0.991127616636614
29020,"Kokomo, IN",2008,46,0,46,83472,0.551082997891509
29020,"Kokomo, IN",2009,11,62,73,82701,0.882697911754392
29020,"Kokomo, IN",2010,13,0,13,82755,0.157090206029847
29020,"Kokomo, IN",2011,22,0,22,82791,0.265729366718605
29020,"Kokomo, IN",2012,32,130,162,82833,1.95574227662888
29020,"Kokomo, IN",2013,48,103,151,82735,1.82510424850426
29020,"Kokomo, IN",2014,98,42,140,82602,1.69487421612067
29020,"Kokomo, IN",2015,166,275,441,82340,5.3558416322565
29020,"Kokomo, IN",2016,116,202,318,82317,3.86311454499071
29020,"Kokomo, IN",2017,90,2,92,82311,1.11771209194397
29020,"Kokomo, IN",2018,277,72,349,82366,4.23718524633951
29060,"Laconia, NH",1990,197,30,227,49292,4.60520977034813
29060,"Laconia, NH",1991,177,2,179,48905,3.66015744811369
29060,"Laconia, NH",1992,237,29,266,49127,5.41453783052089
29060,"Laconia, NH",1993,191,52,243,49498,4.9092892642127
29060,"Laconia, NH",1994,233,6,239,49889,4.79063521016657
29060,"Laconia, NH",1995,183,11,194,50780,3.82040173296573
29060,"Laconia, NH",1996,219,8,227,51554,4.40315009504597
29060,"Laconia, NH",1997,234,4,238,51684,4.60490674096432
29060,"Laconia, NH",1998,283,2,285,52483,5.43032982108492
29060,"Laconia, NH",1999,338,6,344,53264,6.4583959146891
29060,"Laconia, NH",2000,436,22,458,56473,8.11007029908098
29060,"Laconia, NH",2001,409,6,415,57597,7.20523638383944
29060,"Laconia, NH",2002,610,20,630,58609,10.7492023409374
29060,"Laconia, NH",2003,598,74,672,59497,11.294687127082
29060,"Laconia, NH",2004,499,8,507,60170,8.4261259764002
29060,"Laconia, NH",2005,557,91,648,60287,10.7485859306318
29060,"Laconia, NH",2006,388,67,455,60105,7.57008568338741
29060,"Laconia, NH",2007,359,15,374,60109,6.22202997887172
29060,"Laconia, NH",2008,210,72,282,60239,4.68135261209515
29060,"Laconia, NH",2009,143,34,177,60171,2.94161639327915
29060,"Laconia, NH",2010,150,28,178,60098,2.96182901261273
29060,"Laconia, NH",2011,140,4,144,60327,2.3869908995972
29060,"Laconia, NH",2012,115,3,118,60434,1.95254327034451
29060,"Laconia, NH",2013,162,4,166,60236,2.7558270801514
29060,"Laconia, NH",2014,140,58,198,60285,3.28439910425479
29060,"Laconia, NH",2015,191,173,364,60347,6.03178285581719
29060,"Laconia, NH",2016,196,2,198,60700,3.26194398682043
29060,"Laconia, NH",2017,178,4,182,60845,2.99120716574903
29060,"Laconia, NH",2018,170,3,173,61022,2.83504309921012
29100,"La Crosse-Onalaska, WI-MN",1990,343,183,526,116662,4.50875177864257
29100,"La Crosse-Onalaska, WI-MN",1991,281,131,412,117164,3.51643849646649
29100,"La Crosse-Onalaska, WI-MN",1992,431,97,528,118231,4.4658338337661
29100,"La Crosse-Onalaska, WI-MN",1993,481,160,641,119175,5.37864485001049
29100,"La Crosse-Onalaska, WI-MN",1994,445,203,648,119980,5.400900150025
29100,"La Crosse-Onalaska, WI-MN",1995,476,271,747,120578,6.1951599794324
29100,"La Crosse-Onalaska, WI-MN",1996,519,306,825,121126,6.81108927893268
29100,"La Crosse-Onalaska, WI-MN",1997,490,303,793,121272,6.53901972425622
29100,"La Crosse-Onalaska, WI-MN",1998,499,280,779,121657,6.40324847727628
29100,"La Crosse-Onalaska, WI-MN",1999,553,280,833,121868,6.83526438441593
29100,"La Crosse-Onalaska, WI-MN",2000,472,172,644,127021,5.07002779068028
29100,"La Crosse-Onalaska, WI-MN",2001,501,145,646,127624,5.06174387262584
29100,"La Crosse-Onalaska, WI-MN",2002,494,130,624,128261,4.86507979822393
29100,"La Crosse-Onalaska, WI-MN",2003,528,152,680,128780,5.28032303152663
29100,"La Crosse-Onalaska, WI-MN",2004,590,258,848,128992,6.57405110394443
29100,"La Crosse-Onalaska, WI-MN",2005,529,81,610,129549,4.70864306169866
29100,"La Crosse-Onalaska, WI-MN",2006,450,166,616,130147,4.73310948389129
29100,"La Crosse-Onalaska, WI-MN",2007,439,188,627,131190,4.7793276926595
29100,"La Crosse-Onalaska, WI-MN",2008,301,81,382,131920,2.89569436021831
29100,"La Crosse-Onalaska, WI-MN",2009,258,91,349,133072,2.62264037513527
29100,"La Crosse-Onalaska, WI-MN",2010,249,78,327,133902,2.4420845095667
29100,"La Crosse-Onalaska, WI-MN",2011,252,48,300,134099,2.23715314804734
29100,"La Crosse-Onalaska, WI-MN",2012,281,57,338,135305,2.49805993865711
29100,"La Crosse-Onalaska, WI-MN",2013,294,190,484,135659,3.56776918597365
29100,"La Crosse-Onalaska, WI-MN",2014,243,55,298,136145,2.1888427779206
29100,"La Crosse-Onalaska, WI-MN",2015,233,264,497,136407,3.64350803111277
29100,"La Crosse-Onalaska, WI-MN",2016,259,22,281,136427,2.05970958827798
29100,"La Crosse-Onalaska, WI-MN",2017,278,154,432,136778,3.15840266709559
29100,"La Crosse-Onalaska, WI-MN",2018,191,403,594,136808,4.341851353722
29180,"Lafayette, LA",1990,606,32,638,383265,1.664644567075
29180,"Lafayette, LA",1991,857,53,910,387630,2.34759951500142
29180,"Lafayette, LA",1992,1168,24,1192,391310,3.04617822187013
29180,"Lafayette, LA",1993,1526,14,1540,396138,3.88753414214239
29180,"Lafayette, LA",1994,1659,128,1787,400030,4.4671649626278
29180,"Lafayette, LA",1995,1607,42,1649,403723,4.08448366825769
29180,"Lafayette, LA",1996,1870,148,2018,407698,4.94974221114649
29180,"Lafayette, LA",1997,1703,197,1900,412422,4.60693173497049
29180,"Lafayette, LA",1998,1700,234,1934,416331,4.64534228774701
29180,"Lafayette, LA",1999,1602,117,1719,418765,4.10492758468353
29180,"Lafayette, LA",2000,1483,44,1527,425158,3.59160594414312
29180,"Lafayette, LA",2001,1353,189,1542,426750,3.61335676625659
29180,"Lafayette, LA",2002,1728,385,2113,430358,4.90986573968649
29180,"Lafayette, LA",2003,2172,119,2291,432900,5.29221529221529
29180,"Lafayette, LA",2004,2917,48,2965,436018,6.80017797430381
29180,"Lafayette, LA",2005,2437,11,2448,439936,5.56444573756183
29180,"Lafayette, LA",2006,2880,716,3596,450740,7.97799174690509
29180,"Lafayette, LA",2007,1953,589,2542,454315,5.59523678505002
29180,"Lafayette, LA",2008,1367,286,1653,459111,3.60043649574939
29180,"Lafayette, LA",2009,1122,158,1280,463998,2.75863258031285
29180,"Lafayette, LA",2010,1101,101,1202,467620,2.57046319661263
29180,"Lafayette, LA",2011,1167,177,1344,470885,2.85420007008081
29180,"Lafayette, LA",2012,1596,152,1748,474186,3.68631718355245
29180,"Lafayette, LA",2013,1819,163,1982,479799,4.13089647956749
29180,"Lafayette, LA",2014,2224,138,2362,484902,4.87108735373333
29180,"Lafayette, LA",2015,1973,510,2483,489537,5.07213959312575
29180,"Lafayette, LA",2016,1518,180,1698,490941,3.45866407572397
29180,"Lafayette, LA",2017,1746,25,1771,490107,3.61349664461026
29180,"Lafayette, LA",2018,1657,30,1687,489364,3.44733163861665
29200,"Lafayette-West Lafayette, IN",1990,447,385,832,158875,5.23682140047207
29200,"Lafayette-West Lafayette, IN",1991,534,454,988,160604,6.1517770416677
29200,"Lafayette-West Lafayette, IN",1992,742,235,977,162090,6.02751557776544
29200,"Lafayette-West Lafayette, IN",1993,769,282,1051,164122,6.40377280315862
29200,"Lafayette-West Lafayette, IN",1994,805,318,1123,165184,6.79847927160016
29200,"Lafayette-West Lafayette, IN",1995,726,216,942,166688,5.65127663659052
29200,"Lafayette-West Lafayette, IN",1996,851,517,1368,167911,8.14717320485257
29200,"Lafayette-West Lafayette, IN",1997,777,747,1524,168177,9.06188123227314
29200,"Lafayette-West Lafayette, IN",1998,879,519,1398,168602,8.29171658699185
29200,"Lafayette-West Lafayette, IN",1999,921,699,1620,169207,9.57407199465743
29200,"Lafayette-West Lafayette, IN",2000,887,943,1830,178921,10.2279777108333
29200,"Lafayette-West Lafayette, IN",2001,949,651,1600,180706,8.854160902239
29200,"Lafayette-West Lafayette, IN",2002,997,435,1432,181781,7.87761097144366
29200,"Lafayette-West Lafayette, IN",2003,1026,493,1519,183621,8.27247428126413
29200,"Lafayette-West Lafayette, IN",2004,1334,177,1511,184996,8.16774416744146
29200,"Lafayette-West Lafayette, IN",2005,1048,31,1079,188023,5.73865963206629
29200,"Lafayette-West Lafayette, IN",2006,720,198,918,192060,4.77975632614808
29200,"Lafayette-West Lafayette, IN",2007,623,296,919,195149,4.70922218407473
29200,"Lafayette-West Lafayette, IN",2008,537,123,660,197954,3.33410792406317
29200,"Lafayette-West Lafayette, IN",2009,453,33,486,200775,2.42062009712365
29200,"Lafayette-West Lafayette, IN",2010,451,80,531,202159,2.62664536330314
29200,"Lafayette-West Lafayette, IN",2011,737,507,1244,204749,6.07573174960562
29200,"Lafayette-West Lafayette, IN",2012,509,34,543,208060,2.60982408920504
29200,"Lafayette-West Lafayette, IN",2013,471,614,1085,210833,5.14625319565723
29200,"Lafayette-West Lafayette, IN",2014,596,485,1081,213133,5.07195037840222
29200,"Lafayette-West Lafayette, IN",2015,475,52,527,215355,2.44712219358733
29200,"Lafayette-West Lafayette, IN",2016,495,132,627,219120,2.86144578313253
29200,"Lafayette-West Lafayette, IN",2017,567,409,976,220337,4.42957832774341
29200,"Lafayette-West Lafayette, IN",2018,499,1319,1818,221828,8.19553888598374
29260,"La Grande, OR",1990,23,2,25,23677,1.05587701144571
29260,"La Grande, OR",1991,18,2,20,23976,0.834167500834168
29260,"La Grande, OR",1992,28,2,30,24122,1.24367797031755
29260,"La Grande, OR",1993,36,9,45,24705,1.82149362477231
29260,"La Grande, OR",1994,66,27,93,24980,3.72297838270616
29260,"La Grande, OR",1995,36,0,36,24996,1.4402304368699
29260,"La Grande, OR",1996,49,3,52,25011,2.0790852025109
29260,"La Grande, OR",1997,48,8,56,25029,2.23740461065164
29260,"La Grande, OR",1998,32,2,34,24848,1.3683193818416
29260,"La Grande, OR",1999,34,13,47,24705,1.90244889698442
29260,"La Grande, OR",2000,46,0,46,24537,1.87471981089783
29260,"La Grande, OR",2001,30,0,30,24353,1.23188108241284
29260,"La Grande, OR",2002,35,0,35,24472,1.43020594965675
29260,"La Grande, OR",2003,31,0,31,24607,1.25980412077864
29260,"La Grande, OR",2004,32,0,32,24513,1.30542977195774
29260,"La Grande, OR",2005,54,2,56,24675,2.26950354609929
29260,"La Grande, OR",2006,64,11,75,24754,3.02981336349681
29260,"La Grande, OR",2007,54,10,64,25263,2.53334916676563
29260,"La Grande, OR",2008,28,3,31,25473,1.21697483610097
29260,"La Grande, OR",2009,51,0,51,25580,1.99374511336982
29260,"La Grande, OR",2010,30,2,32,25732,1.24358775066066
29260,"La Grande, OR",2011,33,2,35,25902,1.35124700795305
29260,"La Grande, OR",2012,20,18,38,25798,1.47298240173657
29260,"La Grande, OR",2013,21,8,29,25523,1.13623006699839
29260,"La Grande, OR",2014,32,54,86,25633,3.35505013069091
29260,"La Grande, OR",2015,19,0,19,25698,0.739357148416219
29260,"La Grande, OR",2016,41,8,49,26064,1.87998772252916
29260,"La Grande, OR",2017,34,2,36,26286,1.36955033097466
29260,"La Grande, OR",2018,43,9,52,26461,1.96515626771475
29300,"LaGrange, GA",1990,229,6,235,55593,4.2271509002932
29300,"LaGrange, GA",1991,238,0,238,56418,4.21851182246801
29300,"LaGrange, GA",1992,201,6,207,56548,3.66060691801655
29300,"LaGrange, GA",1993,227,0,227,56914,3.98847383772007
29300,"LaGrange, GA",1994,242,0,242,57452,4.21221193344009
29300,"LaGrange, GA",1995,251,2,253,57850,4.37337942955921
29300,"LaGrange, GA",1996,288,8,296,58318,5.07561987722487
29300,"LaGrange, GA",1997,311,0,311,58341,5.33072796146792
29300,"LaGrange, GA",1998,271,64,335,58542,5.72238734583718
29300,"LaGrange, GA",1999,269,292,561,58855,9.5319004332682
29300,"LaGrange, GA",2000,324,266,590,58923,10.0130679021774
29300,"LaGrange, GA",2001,309,66,375,59844,6.26629236013635
29300,"LaGrange, GA",2002,353,105,458,60224,7.60494155154091
29300,"LaGrange, GA",2003,432,27,459,60791,7.55045977200573
29300,"LaGrange, GA",2004,438,107,545,62001,8.79018080353543
29300,"LaGrange, GA",2005,442,2,444,63233,7.02165008777063
29300,"LaGrange, GA",2006,456,12,468,63897,7.32428752523593
29300,"LaGrange, GA",2007,444,132,576,64894,8.87601319074182
29300,"LaGrange, GA",2008,188,20,208,65860,3.15821439416945
29300,"LaGrange, GA",2009,113,288,401,66422,6.03715636385535
29300,"LaGrange, GA",2010,80,60,140,67052,2.08793175445923
29300,"LaGrange, GA",2011,95,0,95,67619,1.40493056685251
29300,"LaGrange, GA",2012,62,0,62,68278,0.908052374117578
29300,"LaGrange, GA",2013,118,0,118,68803,1.71504149528364
29300,"LaGrange, GA",2014,133,0,133,69282,1.91969054011143
29300,"LaGrange, GA",2015,106,0,106,69593,1.52314169528545
29300,"LaGrange, GA",2016,148,0,148,69924,2.11658371946685
29300,"LaGrange, GA",2017,152,0,152,70038,2.17025043547788
29300,"LaGrange, GA",2018,185,0,185,70034,2.6415740925836
29340,"Lake Charles, LA",1990,484,108,592,168212,3.51936841604642
29340,"Lake Charles, LA",1991,491,66,557,178946,3.11267086160071
29340,"Lake Charles, LA",1992,627,198,825,179843,4.58733450843236
29340,"Lake Charles, LA",1993,701,48,749,180800,4.14269911504425
29340,"Lake Charles, LA",1994,748,81,829,182480,4.54296361245068
29340,"Lake Charles, LA",1995,811,104,915,184489,4.95964529050512
29340,"Lake Charles, LA",1996,945,465,1410,186789,7.54862438366285
29340,"Lake Charles, LA",1997,722,318,1040,188090,5.52926790366314
29340,"Lake Charles, LA",1998,801,175,976,189048,5.16270999957683
29340,"Lake Charles, LA",1999,793,710,1503,189560,7.92888795104452
29340,"Lake Charles, LA",2000,935,66,1001,193491,5.17336723671902
29340,"Lake Charles, LA",2001,905,197,1102,193171,5.70479005647846
29340,"Lake Charles, LA",2002,914,72,986,193321,5.10032536558367
29340,"Lake Charles, LA",2003,1164,294,1458,194552,7.49414038406185
29340,"Lake Charles, LA",2004,1211,136,1347,195444,6.89199975440535
29340,"Lake Charles, LA",2005,732,186,918,196263,4.6773971660476
29340,"Lake Charles, LA",2006,560,70,630,193069,3.26308211054079
29340,"Lake Charles, LA",2007,716,493,1209,194598,6.21280794252767
29340,"Lake Charles, LA",2008,840,123,963,196362,4.90420753506279
29340,"Lake Charles, LA",2009,782,381,1163,198010,5.8734407353164
29340,"Lake Charles, LA",2010,865,110,975,199943,4.87638977108476
29340,"Lake Charles, LA",2011,649,546,1195,200509,5.95983222698233
29340,"Lake Charles, LA",2012,580,25,605,201089,3.00861807458389
29340,"Lake Charles, LA",2013,730,426,1156,202185,5.7175359200732
29340,"Lake Charles, LA",2014,619,683,1302,203287,6.40473812885231
29340,"Lake Charles, LA",2015,788,246,1034,205252,5.0377097421706
29340,"Lake Charles, LA",2016,926,637,1563,207375,7.5370705244123
29340,"Lake Charles, LA",2017,1052,846,1898,209256,9.07022976641052
29340,"Lake Charles, LA",2018,1063,328,1391,210080,6.62128712871287
29380,"Lake City, FL",1990,254,24,278,42822,6.49199009854748
29380,"Lake City, FL",1991,224,20,244,43518,5.60687531596121
29380,"Lake City, FL",1992,224,2,226,44293,5.10238638159529
29380,"Lake City, FL",1993,227,4,231,45773,5.04664321761737
29380,"Lake City, FL",1994,252,9,261,47859,5.45351971416035
29380,"Lake City, FL",1995,266,0,266,49438,5.380476556495
29380,"Lake City, FL",1996,315,18,333,50555,6.5868855701711
29380,"Lake City, FL",1997,279,10,289,51561,5.60501153972964
29380,"Lake City, FL",1998,245,6,251,52688,4.76389310658974
29380,"Lake City, FL",1999,279,0,279,53632,5.20211813842482
29380,"Lake City, FL",2000,289,0,289,56571,5.10862456028707
29380,"Lake City, FL",2001,266,0,266,57040,4.66339410939691
29380,"Lake City, FL",2002,247,0,247,57930,4.26376661488003
29380,"Lake City, FL",2003,299,0,299,59395,5.03409377893762
29380,"Lake City, FL",2004,380,0,380,60804,6.24958884283929
29380,"Lake City, FL",2005,512,68,580,63109,9.19044827203727
29380,"Lake City, FL",2006,467,6,473,65890,7.17863105175292
29380,"Lake City, FL",2007,326,0,326,66604,4.89460092486938
29380,"Lake City, FL",2008,227,0,227,67318,3.37205502243085
29380,"Lake City, FL",2009,96,3,99,67412,1.46858126149647
29380,"Lake City, FL",2010,84,0,84,67553,1.24346809172057
29380,"Lake City, FL",2011,52,0,52,67309,0.772556418903861
29380,"Lake City, FL",2012,47,0,47,67879,0.692408550508994
29380,"Lake City, FL",2013,65,0,65,67415,0.964177111918712
29380,"Lake City, FL",2014,80,0,80,67784,1.18021952083087
29380,"Lake City, FL",2015,80,0,80,68197,1.17307212927255
29380,"Lake City, FL",2016,104,0,104,69217,1.50252105696577
29380,"Lake City, FL",2017,146,0,146,69825,2.09094163981382
29380,"Lake City, FL",2018,147,0,147,70503,2.08501765882303
29420,"Lake Havasu City-Kingman, AZ",1990,2217,970,3187,95183,33.4828698402026
29420,"Lake Havasu City-Kingman, AZ",1991,1497,433,1930,100625,19.1801242236025
29420,"Lake Havasu City-Kingman, AZ",1992,1760,555,2315,105530,21.9368899838908
29420,"Lake Havasu City-Kingman, AZ",1993,1807,182,1989,110948,17.927317301799
29420,"Lake Havasu City-Kingman, AZ",1994,1900,290,2190,116340,18.824136152656
29420,"Lake Havasu City-Kingman, AZ",1995,1535,197,1732,121733,14.2278593314878
29420,"Lake Havasu City-Kingman, AZ",1996,1327,119,1446,125856,11.4893211289092
29420,"Lake Havasu City-Kingman, AZ",1997,1428,264,1692,128328,13.1849635309519
29420,"Lake Havasu City-Kingman, AZ",1998,1772,189,1961,130490,15.0279714920684
29420,"Lake Havasu City-Kingman, AZ",1999,1904,40,1944,133431,14.569327967264
29420,"Lake Havasu City-Kingman, AZ",2000,1887,51,1938,156215,12.4059789392824
29420,"Lake Havasu City-Kingman, AZ",2001,2141,90,2231,160312,13.9166126054194
29420,"Lake Havasu City-Kingman, AZ",2002,2554,241,2795,166155,16.8216424422979
29420,"Lake Havasu City-Kingman, AZ",2003,2995,392,3387,172633,19.6196555699084
29420,"Lake Havasu City-Kingman, AZ",2004,3838,283,4121,180521,22.8283689986207
29420,"Lake Havasu City-Kingman, AZ",2005,3879,132,4011,188773,21.2477419970017
29420,"Lake Havasu City-Kingman, AZ",2006,2265,427,2692,196168,13.7229313649525
29420,"Lake Havasu City-Kingman, AZ",2007,1127,96,1223,199760,6.12234681617942
29420,"Lake Havasu City-Kingman, AZ",2008,455,101,556,200078,2.77891622267316
29420,"Lake Havasu City-Kingman, AZ",2009,261,6,267,199696,1.3370322890794
29420,"Lake Havasu City-Kingman, AZ",2010,214,48,262,200315,1.30793999450865
29420,"Lake Havasu City-Kingman, AZ",2011,194,2,196,202801,0.966464662403045
29420,"Lake Havasu City-Kingman, AZ",2012,323,22,345,203356,1.69653218985425
29420,"Lake Havasu City-Kingman, AZ",2013,454,10,464,203158,2.28393664044734
29420,"Lake Havasu City-Kingman, AZ",2014,521,14,535,203474,2.62932856286307
29420,"Lake Havasu City-Kingman, AZ",2015,626,10,636,204661,3.1075778971079
29420,"Lake Havasu City-Kingman, AZ",2016,657,26,683,205521,3.32326136988434
29420,"Lake Havasu City-Kingman, AZ",2017,889,24,913,207114,4.40820031480248
29420,"Lake Havasu City-Kingman, AZ",2018,945,73,1018,209550,4.85802910999761
29460,"Lakeland-Winter Haven, FL",1990,1988,797,2785,407231,6.83887032175841
29460,"Lakeland-Winter Haven, FL",1991,1991,598,2589,412465,6.27689622149758
29460,"Lakeland-Winter Haven, FL",1992,2258,91,2349,418279,5.61586883396011
29460,"Lakeland-Winter Haven, FL",1993,2587,68,2655,422079,6.29029162787061
29460,"Lakeland-Winter Haven, FL",1994,2572,111,2683,428964,6.25460411596311
29460,"Lakeland-Winter Haven, FL",1995,2186,179,2365,435229,5.43392099331616
29460,"Lakeland-Winter Haven, FL",1996,2504,122,2626,440090,5.96696130336977
29460,"Lakeland-Winter Haven, FL",1997,2645,717,3362,446511,7.52948975501163
29460,"Lakeland-Winter Haven, FL",1998,2873,450,3323,451826,7.35460110750599
29460,"Lakeland-Winter Haven, FL",1999,2967,912,3879,455804,8.51023685619257
29460,"Lakeland-Winter Haven, FL",2000,3520,1226,4746,485515,9.77518717238396
29460,"Lakeland-Winter Haven, FL",2001,3839,682,4521,492917,9.17192955406285
29460,"Lakeland-Winter Haven, FL",2002,4422,550,4972,501469,9.91487011161208
29460,"Lakeland-Winter Haven, FL",2003,6261,562,6823,513058,13.2986913760238
29460,"Lakeland-Winter Haven, FL",2004,8715,1527,10242,527685,19.4093066886495
29460,"Lakeland-Winter Haven, FL",2005,11980,1199,13179,547373,24.0768178189279
29460,"Lakeland-Winter Haven, FL",2006,7609,1714,9323,568324,16.4043749692077
29460,"Lakeland-Winter Haven, FL",2007,3854,368,4222,585982,7.20499947097351
29460,"Lakeland-Winter Haven, FL",2008,2268,981,3249,594801,5.4623310989726
29460,"Lakeland-Winter Haven, FL",2009,1135,0,1135,598683,1.89582800914674
29460,"Lakeland-Winter Haven, FL",2010,1112,88,1200,603128,1.98962740910719
29460,"Lakeland-Winter Haven, FL",2011,1074,82,1156,609943,1.89525906519134
29460,"Lakeland-Winter Haven, FL",2012,1382,140,1522,615486,2.47284259918179
29460,"Lakeland-Winter Haven, FL",2013,1994,40,2034,622712,3.26635748146816
29460,"Lakeland-Winter Haven, FL",2014,2547,12,2559,634520,4.03296980394629
29460,"Lakeland-Winter Haven, FL",2015,3003,36,3039,648758,4.68433529914082
29460,"Lakeland-Winter Haven, FL",2016,3424,1143,4567,666236,6.85492828367125
29460,"Lakeland-Winter Haven, FL",2017,4542,62,4604,685830,6.71303384220579
29460,"Lakeland-Winter Haven, FL",2018,5331,0,5331,708009,7.52956530213599
29500,"Lamesa, TX",1990,5,0,5,14297,0.349723718262573
29500,"Lamesa, TX",1991,4,0,4,14151,0.282665536004523
29500,"Lamesa, TX",1992,2,0,2,14093,0.141914425601362
29500,"Lamesa, TX",1993,6,0,6,15097,0.397429952970789
29500,"Lamesa, TX",1994,6,24,30,15053,1.99295821430944
29500,"Lamesa, TX",1995,5,0,5,15350,0.325732899022801
29500,"Lamesa, TX",1996,4,0,4,15122,0.264515275757175
29500,"Lamesa, TX",1997,5,0,5,14709,0.339927935277721
29500,"Lamesa, TX",1998,5,0,5,14631,0.341740140796938
29500,"Lamesa, TX",1999,5,0,5,14438,0.346308352957473
29500,"Lamesa, TX",2000,4,0,4,14935,0.267827251422832
29500,"Lamesa, TX",2001,4,0,4,14863,0.269124672004306
29500,"Lamesa, TX",2002,0,0,0,14429,0
29500,"Lamesa, TX",2003,0,0,0,14354,0
29500,"Lamesa, TX",2004,1,0,1,14062,0.0711136395960745
29500,"Lamesa, TX",2005,1,0,1,14092,0.0709622480840193
29500,"Lamesa, TX",2006,0,0,0,13987,0
29500,"Lamesa, TX",2007,0,0,0,13865,0
29500,"Lamesa, TX",2008,3,0,3,13804,0.217328310634599
29500,"Lamesa, TX",2009,6,0,6,13741,0.43664944327196
29500,"Lamesa, TX",2010,1,0,1,13827,0.0723222680263253
29500,"Lamesa, TX",2011,1,0,1,13746,0.072748435908628
29500,"Lamesa, TX",2012,6,0,6,13613,0.440755160508338
29500,"Lamesa, TX",2013,5,0,5,13219,0.37824343747636
29500,"Lamesa, TX",2014,7,0,7,13448,0.520523497917906
29500,"Lamesa, TX",2015,0,0,0,12990,0
29500,"Lamesa, TX",2016,0,0,0,12998,0
29500,"Lamesa, TX",2017,0,0,0,12766,0
29500,"Lamesa, TX",2018,0,0,0,12619,0
29540,"Lancaster, PA",1990,1958,734,2692,424741,6.33798008668812
29540,"Lancaster, PA",1991,1925,672,2597,430181,6.03699373054598
29540,"Lancaster, PA",1992,2352,304,2656,433977,6.12014000741975
29540,"Lancaster, PA",1993,2258,552,2810,438273,6.41152888724608
29540,"Lancaster, PA",1994,2160,273,2433,442580,5.49731122057029
29540,"Lancaster, PA",1995,1656,267,1923,447231,4.29979138297658
29540,"Lancaster, PA",1996,1748,335,2083,450285,4.62595911478286
29540,"Lancaster, PA",1997,1679,348,2027,453663,4.46807431948385
29540,"Lancaster, PA",1998,1915,539,2454,456916,5.37079025466388
29540,"Lancaster, PA",1999,1986,287,2273,459585,4.94576628915217
29540,"Lancaster, PA",2000,1704,312,2016,471955,4.27159369007638
29540,"Lancaster, PA",2001,1871,396,2267,475483,4.76778349593992
29540,"Lancaster, PA",2002,2077,471,2548,480118,5.30702868878068
29540,"Lancaster, PA",2003,1955,735,2690,485119,5.54503121914417
29540,"Lancaster, PA",2004,2268,407,2675,489977,5.45943993289481
29540,"Lancaster, PA",2005,1812,228,2040,494722,4.12352796115798
29540,"Lancaster, PA",2006,1705,182,1887,500922,3.76705355324781
29540,"Lancaster, PA",2007,1386,345,1731,506639,3.41663393461617
29540,"Lancaster, PA",2008,1170,314,1484,511957,2.8986809439074
29540,"Lancaster, PA",2009,990,272,1262,516577,2.44300462467357
29540,"Lancaster, PA",2010,1149,232,1381,520322,2.65412571446143
29540,"Lancaster, PA",2011,731,473,1204,523906,2.29812218222353
29540,"Lancaster, PA",2012,781,379,1160,526869,2.20168580804716
29540,"Lancaster, PA",2013,980,278,1258,530027,2.37346399334373
29540,"Lancaster, PA",2014,970,139,1109,533320,2.07942698567464
29540,"Lancaster, PA",2015,968,186,1154,535737,2.15404200195245
29540,"Lancaster, PA",2016,1013,274,1287,538069,2.39188654243229
29540,"Lancaster, PA",2017,979,457,1436,541054,2.65407889046195
29540,"Lancaster, PA",2018,966,285,1251,543557,2.30150655772992
29620,"Lansing-East Lansing, MI",1990,1324,310,1634,433500,3.76931949250288
29620,"Lansing-East Lansing, MI",1991,1424,415,1839,437409,4.2043030664664
29620,"Lansing-East Lansing, MI",1992,1368,212,1580,439898,3.59174172194463
29620,"Lansing-East Lansing, MI",1993,1416,437,1853,442351,4.18898114845451
29620,"Lansing-East Lansing, MI",1994,1556,370,1926,444124,4.33662670785636
29620,"Lansing-East Lansing, MI",1995,1543,392,1935,445173,4.3466247953043
29620,"Lansing-East Lansing, MI",1996,1707,477,2184,449173,4.86226910344121
29620,"Lansing-East Lansing, MI",1997,1431,554,1985,450362,4.4075654695556
29620,"Lansing-East Lansing, MI",1998,1431,276,1707,450170,3.7919008374614
29620,"Lansing-East Lansing, MI",1999,1541,499,2040,450197,4.5313496091711
29620,"Lansing-East Lansing, MI",2000,1661,655,2316,448735,5.16117530390988
29620,"Lansing-East Lansing, MI",2001,1642,827,2469,452051,5.46177311851981
29620,"Lansing-East Lansing, MI",2002,1768,638,2406,455420,5.2830354398138
29620,"Lansing-East Lansing, MI",2003,1957,1199,3156,458376,6.88517723441018
29620,"Lansing-East Lansing, MI",2004,1817,389,2206,461724,4.77774601276953
29620,"Lansing-East Lansing, MI",2005,1596,525,2121,462743,4.58353773044649
29620,"Lansing-East Lansing, MI",2006,941,290,1231,463349,2.65674469999935
29620,"Lansing-East Lansing, MI",2007,568,200,768,463804,1.65587187691352
29620,"Lansing-East Lansing, MI",2008,264,119,383,463638,0.826075515811905
29620,"Lansing-East Lansing, MI",2009,249,2,251,463147,0.541944566196046
29620,"Lansing-East Lansing, MI",2010,451,226,677,464272,1.45819691904746
29620,"Lansing-East Lansing, MI",2011,374,42,416,466566,0.891620906795609
29620,"Lansing-East Lansing, MI",2012,412,187,599,467677,1.28079849981932
29620,"Lansing-East Lansing, MI",2013,508,475,983,469209,2.09501522775565
29620,"Lansing-East Lansing, MI",2014,455,300,755,471269,1.60205742367947
29620,"Lansing-East Lansing, MI",2015,496,560,1056,472839,2.23331831765146
29620,"Lansing-East Lansing, MI",2016,521,704,1225,476721,2.56963716723199
29620,"Lansing-East Lansing, MI",2017,533,374,907,480353,1.88819472346379
29620,"Lansing-East Lansing, MI",2018,453,372,825,481893,1.71199830667804
29660,"Laramie, WY",1990,12,12,24,30790,0.779473855147775
29660,"Laramie, WY",1991,31,16,47,30836,1.52419250227007
29660,"Laramie, WY",1992,56,16,72,30756,2.34100663285213
29660,"Laramie, WY",1993,69,4,73,31039,2.35187989303779
29660,"Laramie, WY",1994,106,108,214,30968,6.910359080341
29660,"Laramie, WY",1995,102,72,174,30816,5.64641744548287
29660,"Laramie, WY",1996,109,26,135,30589,4.41335120468142
29660,"Laramie, WY",1997,98,56,154,29673,5.18990327907525
29660,"Laramie, WY",1998,97,42,139,29256,4.75116215477167
29660,"Laramie, WY",1999,101,104,205,28933,7.08533508450558
29660,"Laramie, WY",2000,105,2,107,31966,3.34730651317024
29660,"Laramie, WY",2001,135,148,283,32419,8.7294487800364
29660,"Laramie, WY",2002,153,10,163,32675,4.9885233358837
29660,"Laramie, WY",2003,193,78,271,33098,8.18780590972264
29660,"Laramie, WY",2004,210,200,410,33580,12.2096486003574
29660,"Laramie, WY",2005,192,402,594,33631,17.6622758764235
29660,"Laramie, WY",2006,156,173,329,33950,9.69072164948454
29660,"Laramie, WY",2007,192,72,264,33858,7.79727095516569
29660,"Laramie, WY",2008,142,30,172,34643,4.96492797967843
29660,"Laramie, WY",2009,103,29,132,35743,3.6930308032342
29660,"Laramie, WY",2010,140,32,172,36465,4.7168517756753
29660,"Laramie, WY",2011,145,318,463,36843,12.5668376625139
29660,"Laramie, WY",2012,103,87,190,37360,5.08565310492505
29660,"Laramie, WY",2013,125,14,139,37559,3.70084400543145
29660,"Laramie, WY",2014,99,0,99,37622,2.63143905161873
29660,"Laramie, WY",2015,122,20,142,37956,3.74117399093687
29660,"Laramie, WY",2016,123,28,151,37903,3.98385352082949
29660,"Laramie, WY",2017,97,28,125,38430,3.25266718709342
29660,"Laramie, WY",2018,99,47,146,38601,3.78228543301987
29700,"Laredo, TX",1990,603,221,824,134518,6.12557427258806
29700,"Laredo, TX",1991,550,671,1221,140540,8.68791803045396
29700,"Laredo, TX",1992,818,492,1310,147890,8.85793495165326
29700,"Laredo, TX",1993,869,680,1549,155851,9.93898017978711
29700,"Laredo, TX",1994,951,869,1820,162904,11.1722241320041
29700,"Laredo, TX",1995,881,1019,1900,169778,11.191084828423
29700,"Laredo, TX",1996,1156,143,1299,174408,7.44805284161277
29700,"Laredo, TX",1997,1198,254,1452,180532,8.04289544235925
29700,"Laredo, TX",1998,1402,145,1547,186991,8.27312544454011
29700,"Laredo, TX",1999,1336,303,1639,193653,8.46359209513924
29700,"Laredo, TX",2000,1423,440,1863,194576,9.57466491242497
29700,"Laredo, TX",2001,1477,282,1759,200347,8.77976710407443
29700,"Laredo, TX",2002,1439,366,1805,206001,8.76209338789618
29700,"Laredo, TX",2003,1580,91,1671,211786,7.89003994598321
29700,"Laredo, TX",2004,1617,576,2193,217858,10.0661899035151
29700,"Laredo, TX",2005,1886,290,2176,223703,9.727182916635
29700,"Laredo, TX",2006,1941,454,2395,229307,10.4445132507948
29700,"Laredo, TX",2007,1257,324,1581,234594,6.73930279546791
29700,"Laredo, TX",2008,668,419,1087,240287,4.5237570072455
29700,"Laredo, TX",2009,668,118,786,245908,3.19631732192527
29700,"Laredo, TX",2010,636,27,663,251391,2.63732591858897
29700,"Laredo, TX",2011,640,316,956,255981,3.73465218121657
29700,"Laredo, TX",2012,750,756,1506,260722,5.77626744194966
29700,"Laredo, TX",2013,915,708,1623,264632,6.13304513437528
29700,"Laredo, TX",2014,954,765,1719,267732,6.42059970418179
29700,"Laredo, TX",2015,1032,816,1848,270120,6.84140382052421
29700,"Laredo, TX",2016,945,213,1158,272520,4.24922941435491
29700,"Laredo, TX",2017,1061,270,1331,273982,4.85798337117037
29700,"Laredo, TX",2018,1078,297,1375,275910,4.98350911529122
29780,"Las Vegas, NM",2013,1,2,3,28829,0.104061882132575
29780,"Las Vegas, NM",2014,0,0,0,28505,0
29780,"Las Vegas, NM",2015,0,0,0,28233,0
29780,"Las Vegas, NM",2016,1,0,1,28058,0.0356404590491126
29780,"Las Vegas, NM",2017,1,0,1,27782,0.0359945288316176
29780,"Las Vegas, NM",2018,1,0,1,27591,0.0362437026566634
29820,"Las Vegas-Henderson-Paradise, NV",1990,11201,9502,20703,754595,27.4359093288453
29820,"Las Vegas-Henderson-Paradise, NV",1991,12563,5301,17864,807613,22.1195052580877
29820,"Las Vegas-Henderson-Paradise, NV",1992,10064,3365,13429,841395,15.9603990991152
29820,"Las Vegas-Henderson-Paradise, NV",1993,15657,3379,19036,878181,21.6766247504785
29820,"Las Vegas-Henderson-Paradise, NV",1994,18347,7223,25570,938724,27.2391032934068
29820,"Las Vegas-Henderson-Paradise, NV",1995,18527,9286,27813,991444,28.0530216532653
29820,"Las Vegas-Henderson-Paradise, NV",1996,19186,11749,30935,1044006,29.6310557602159
29820,"Las Vegas-Henderson-Paradise, NV",1997,19127,10049,29176,1108153,26.3284943505094
29820,"Las Vegas-Henderson-Paradise, NV",1998,19856,10788,30644,1168081,26.2344820265033
29820,"Las Vegas-Henderson-Paradise, NV",1999,19919,6937,26856,1223210,21.9553469968362
29820,"Las Vegas-Henderson-Paradise, NV",2000,21282,4942,26224,1393909,18.8132797765134
29820,"Las Vegas-Henderson-Paradise, NV",2001,21871,7836,29707,1460500,20.3402944197193
29820,"Las Vegas-Henderson-Paradise, NV",2002,22148,7008,29156,1522962,19.1442728052309
29820,"Las Vegas-Henderson-Paradise, NV",2003,27354,9378,36732,1584166,23.1869639924099
29820,"Las Vegas-Henderson-Paradise, NV",2004,31741,4654,36395,1662773,21.8881350611298
29820,"Las Vegas-Henderson-Paradise, NV",2005,30479,8758,39237,1729522,22.6866151456877
29820,"Las Vegas-Henderson-Paradise, NV",2006,21590,12138,33728,1803774,18.6985731028388
29820,"Las Vegas-Henderson-Paradise, NV",2007,13310,10779,24089,1867817,12.8968737301352
29820,"Las Vegas-Henderson-Paradise, NV",2008,5840,6697,12537,1912349,6.55581172683438
29820,"Las Vegas-Henderson-Paradise, NV",2009,3777,1911,5688,1939407,2.93285524905293
29820,"Las Vegas-Henderson-Paradise, NV",2010,4623,851,5474,1952644,2.80337839360375
29820,"Las Vegas-Henderson-Paradise, NV",2011,3817,1330,5147,1962010,2.62333015631928
29820,"Las Vegas-Henderson-Paradise, NV",2012,6108,1267,7375,1989693,3.70660197326924
29820,"Las Vegas-Henderson-Paradise, NV",2013,7067,1506,8573,2018003,4.24825929396537
29820,"Las Vegas-Henderson-Paradise, NV",2014,6809,3227,10036,2054263,4.88545040240709
29820,"Las Vegas-Henderson-Paradise, NV",2015,7805,2800,10605,2098105,5.05456113969511
29820,"Las Vegas-Henderson-Paradise, NV",2016,8805,4772,13577,2140547,6.34277126360692
29820,"Las Vegas-Henderson-Paradise, NV",2017,9812,4261,14073,2183310,6.44571774049494
29820,"Las Vegas-Henderson-Paradise, NV",2018,9721,2323,12044,2231647,5.39691089137305
29860,"Laurel, MS",1990,15,0,15,79038,0.189782130114628
29860,"Laurel, MS",1991,11,0,11,79039,0.139171801262668
29860,"Laurel, MS",1992,7,0,7,79380,0.0881834215167549
29860,"Laurel, MS",1993,15,0,15,79782,0.188012333609085
29860,"Laurel, MS",1994,28,0,28,80189,0.34917507388794
29860,"Laurel, MS",1995,22,50,72,80274,0.896928021526272
29860,"Laurel, MS",1996,29,0,29,80615,0.359734540718229
29860,"Laurel, MS",1997,28,0,28,81017,0.345606477652838
29860,"Laurel, MS",1998,26,0,26,81385,0.319469189654113
29860,"Laurel, MS",1999,66,3,69,81417,0.847488853679207
29860,"Laurel, MS",2000,25,6,31,83103,0.373031057843881
29860,"Laurel, MS",2001,27,4,31,83085,0.37311187338268
29860,"Laurel, MS",2002,41,4,45,82984,0.542273209293358
29860,"Laurel, MS",2003,45,22,67,82768,0.809491590953025
29860,"Laurel, MS",2004,35,16,51,83047,0.614110082242586
29860,"Laurel, MS",2005,41,0,41,83367,0.491801312269843
29860,"Laurel, MS",2006,49,0,49,83874,0.584209647805041
29860,"Laurel, MS",2007,118,114,232,84252,2.75364383041352
29860,"Laurel, MS",2008,77,6,83,84868,0.977989348164208
29860,"Laurel, MS",2009,23,25,48,84787,0.566124523806716
29860,"Laurel, MS",2010,56,0,56,84814,0.660268351923032
29860,"Laurel, MS",2011,11,64,75,84777,0.88467390919707
29860,"Laurel, MS",2012,9,2,11,84981,0.129440698509078
29860,"Laurel, MS",2013,112,3,115,85452,1.34578476805692
29860,"Laurel, MS",2014,22,0,22,84936,0.259018555147405
29860,"Laurel, MS",2015,29,8,37,85178,0.434384465472305
29860,"Laurel, MS",2016,24,2,26,85043,0.305727690697647
29860,"Laurel, MS",2017,20,0,20,84868,0.23566008389499
29860,"Laurel, MS",2018,11,0,11,84889,0.129580982223845
29900,"Laurinburg, NC",1990,83,0,83,33866,2.45083564637099
29900,"Laurinburg, NC",1991,68,6,74,34037,2.17410465082117
29900,"Laurinburg, NC",1992,97,38,135,34232,3.94367842953961
29900,"Laurinburg, NC",1993,93,0,93,34647,2.68421508355702
29900,"Laurinburg, NC",1994,92,4,96,34759,2.76187462239995
29900,"Laurinburg, NC",1995,81,3,84,35051,2.39650794556503
29900,"Laurinburg, NC",1996,103,24,127,35470,3.58049055539893
29900,"Laurinburg, NC",1997,94,42,136,35544,3.82624352914697
29900,"Laurinburg, NC",1998,108,36,144,35725,4.03079076277117
29900,"Laurinburg, NC",1999,108,51,159,35983,4.41875330016952
29900,"Laurinburg, NC",2000,88,56,144,35944,4.00623191631427
29900,"Laurinburg, NC",2001,60,55,115,35851,3.20772084460685
29900,"Laurinburg, NC",2002,56,40,96,35450,2.70803949224259
29900,"Laurinburg, NC",2003,61,4,65,35442,1.83398228090966
29900,"Laurinburg, NC",2004,58,20,78,36446,2.14015255446414
29900,"Laurinburg, NC",2005,62,7,69,36405,1.89534404614751
29900,"Laurinburg, NC",2006,49,8,57,36348,1.56817431495543
29900,"Laurinburg, NC",2007,42,42,84,36399,2.30775570757438
29900,"Laurinburg, NC",2008,36,0,36,36463,0.987302196747388
29900,"Laurinburg, NC",2009,19,0,19,36313,0.523228595819679
29900,"Laurinburg, NC",2010,38,42,80,36063,2.21834012699997
29900,"Laurinburg, NC",2011,19,0,19,36272,0.523820026466696
29900,"Laurinburg, NC",2012,12,44,56,36090,1.55167636464395
29900,"Laurinburg, NC",2013,9,0,9,35915,0.250591674787693
29900,"Laurinburg, NC",2014,32,0,32,35665,0.897238188700407
29900,"Laurinburg, NC",2015,29,0,29,35330,0.82083215397679
29900,"Laurinburg, NC",2016,9,0,9,35331,0.254733803175681
29900,"Laurinburg, NC",2017,15,0,15,35172,0.42647560559536
29900,"Laurinburg, NC",2018,20,0,20,34810,0.57454754380925
29940,"Lawrence, KS",1990,436,274,710,82208,8.6366290385364
29940,"Lawrence, KS",1991,463,329,792,83576,9.47640470948598
29940,"Lawrence, KS",1992,624,260,884,85182,10.3777793430537
29940,"Lawrence, KS",1993,537,426,963,87634,10.98888559235
29940,"Lawrence, KS",1994,678,511,1189,89294,13.3155643156315
29940,"Lawrence, KS",1995,506,335,841,90920,9.24989001319842
29940,"Lawrence, KS",1996,536,1356,1892,92788,20.3905677458292
29940,"Lawrence, KS",1997,500,163,663,95004,6.97865353037767
29940,"Lawrence, KS",1998,514,449,963,96754,9.95307687537466
29940,"Lawrence, KS",1999,564,332,896,98564,9.09054015664949
29940,"Lawrence, KS",2000,478,325,803,100247,8.01021476951929
29940,"Lawrence, KS",2001,523,514,1037,101269,10.2400537183146
29940,"Lawrence, KS",2002,436,512,948,102552,9.24409080271472
29940,"Lawrence, KS",2003,550,510,1060,103570,10.2346239258473
29940,"Lawrence, KS",2004,553,326,879,104826,8.38532425161697
29940,"Lawrence, KS",2005,508,189,697,105681,6.59531987774529
29940,"Lawrence, KS",2006,438,107,545,107187,5.08457182307556
29940,"Lawrence, KS",2007,254,202,456,107892,4.22644867089312
29940,"Lawrence, KS",2008,182,562,744,109010,6.82506192092469
29940,"Lawrence, KS",2009,186,156,342,110039,3.10798898572324
29940,"Lawrence, KS",2010,190,98,288,111195,2.59004451639013
29940,"Lawrence, KS",2011,127,363,490,112462,4.35702726254201
29940,"Lawrence, KS",2012,165,306,471,113309,4.15677483695029
29940,"Lawrence, KS",2013,215,374,589,114711,5.13464271081239
29940,"Lawrence, KS",2014,178,169,347,116448,2.97987084363836
29940,"Lawrence, KS",2015,372,467,839,118222,7.09681785116137
29940,"Lawrence, KS",2016,261,1134,1395,119858,11.6387725475146
29940,"Lawrence, KS",2017,288,18,306,120629,2.53670344610334
29940,"Lawrence, KS",2018,419,404,823,121436,6.77723245166178
29980,"Lawrenceburg, TN",1990,25,2,27,35386,0.763013621206127
29980,"Lawrenceburg, TN",1991,24,6,30,35947,0.834561994046791
29980,"Lawrenceburg, TN",1992,21,26,47,36408,1.29092507141288
29980,"Lawrenceburg, TN",1993,20,13,33,37268,0.885478158205431
29980,"Lawrenceburg, TN",1994,24,30,54,37849,1.42672197416048
29980,"Lawrenceburg, TN",1995,23,13,36,38293,0.940119604105189
29980,"Lawrenceburg, TN",1996,14,17,31,38634,0.802402029300616
29980,"Lawrenceburg, TN",1997,12,2,14,39077,0.358267011285411
29980,"Lawrenceburg, TN",1998,14,4,18,39313,0.45786381095312
29980,"Lawrenceburg, TN",1999,21,25,46,39703,1.15860262448681
29980,"Lawrenceburg, TN",2000,4,11,15,39940,0.375563345017526
29980,"Lawrenceburg, TN",2001,5,0,5,39994,0.125018752812922
29980,"Lawrenceburg, TN",2002,10,26,36,40524,0.888362451880367
29980,"Lawrenceburg, TN",2003,4,7,11,40547,0.271290107776161
29980,"Lawrenceburg, TN",2004,14,2,16,40596,0.39412750024633
29980,"Lawrenceburg, TN",2005,9,2,11,40794,0.269647497180958
29980,"Lawrenceburg, TN",2006,11,0,11,40773,0.269786378240502
29980,"Lawrenceburg, TN",2007,9,0,9,41072,0.219127386053759
29980,"Lawrenceburg, TN",2008,4,51,55,41272,1.33262260127932
29980,"Lawrenceburg, TN",2009,5,2,7,41487,0.168727553209439
29980,"Lawrenceburg, TN",2010,2,2,4,41964,0.0953197979220284
29980,"Lawrenceburg, TN",2011,2,2,4,42067,0.0950864097748829
29980,"Lawrenceburg, TN",2012,5,2,7,42074,0.166373532347768
29980,"Lawrenceburg, TN",2013,6,4,10,41925,0.238521168753727
29980,"Lawrenceburg, TN",2014,6,4,10,42211,0.23690507213759401
29980,"Lawrenceburg, TN",2015,6,2,8,42450,0.188457008244994
29980,"Lawrenceburg, TN",2016,7,4,11,42963,0.256034262039429
29980,"Lawrenceburg, TN",2017,7,4,11,43327,0.253883259861057
29980,"Lawrenceburg, TN",2018,7,4,11,43734,0.251520556089084
30020,"Lawton, OK",1990,62,0,62,118050,0.525201185938162
30020,"Lawton, OK",1991,133,0,133,117582,1.13112551240836
30020,"Lawton, OK",1992,227,23,250,126796,1.97167103063188
30020,"Lawton, OK",1993,218,7,225,124611,1.80561908659749
30020,"Lawton, OK",1994,166,13,179,124186,1.44138630763532
30020,"Lawton, OK",1995,179,92,271,122037,2.22063800322853
30020,"Lawton, OK",1996,183,22,205,121725,1.68412405011296
30020,"Lawton, OK",1997,123,13,136,120619,1.12751722365465
30020,"Lawton, OK",1998,224,6,230,119950,1.91746561067111
30020,"Lawton, OK",1999,134,8,142,120153,1.18182650454004
30020,"Lawton, OK",2000,130,10,140,121695,1.15041702617199
30020,"Lawton, OK",2001,133,10,143,119955,1.19211370930766
30020,"Lawton, OK",2002,149,24,173,119889,1.44300144300144
30020,"Lawton, OK",2003,152,13,165,117484,1.40444656293623
30020,"Lawton, OK",2004,170,0,170,122341,1.38955869250701
30020,"Lawton, OK",2005,316,320,636,121475,5.23564519448446
30020,"Lawton, OK",2006,311,274,585,122980,4.7568710359408
30020,"Lawton, OK",2007,293,583,876,125814,6.96265916352711
30020,"Lawton, OK",2008,233,24,257,124166,2.06980977079072
30020,"Lawton, OK",2009,349,294,643,126131,5.09787443213802
30020,"Lawton, OK",2010,298,28,326,131570,2.4777684882572
30020,"Lawton, OK",2011,260,24,284,132263,2.14723694457256
30020,"Lawton, OK",2012,263,26,289,132738,2.17722129307357
30020,"Lawton, OK",2013,161,10,171,131154,1.30381078731872
30020,"Lawton, OK",2014,92,22,114,130940,0.870627768443562
30020,"Lawton, OK",2015,96,4,100,130038,0.769005982866547
30020,"Lawton, OK",2016,90,10,100,127687,0.783165083367923
30020,"Lawton, OK",2017,82,2,84,127589,0.658363965545619
30020,"Lawton, OK",2018,68,0,68,126198,0.538835797714702
30060,"Lebanon, MO",1990,26,4,30,27210,1.10253583241455
30060,"Lebanon, MO",1991,36,57,93,27369,3.39800504220103
30060,"Lebanon, MO",1992,39,0,39,27680,1.40895953757225
30060,"Lebanon, MO",1993,45,24,69,28225,2.44464127546501
30060,"Lebanon, MO",1994,75,32,107,28639,3.73616397220573
30060,"Lebanon, MO",1995,92,18,110,29123,3.777083404869
30060,"Lebanon, MO",1996,77,22,99,29824,3.31947424892704
30060,"Lebanon, MO",1997,93,32,125,30469,4.10253044077587
30060,"Lebanon, MO",1998,204,68,272,30980,8.7798579728857291
30060,"Lebanon, MO",1999,47,12,59,31365,1.88107763430575
30060,"Lebanon, MO",2000,76,30,106,32598,3.2517332351678
30060,"Lebanon, MO",2001,69,24,93,32889,2.82769314968531
30060,"Lebanon, MO",2002,64,38,102,32862,3.10388899032317
30060,"Lebanon, MO",2003,77,61,138,33155,4.16226813451968
30060,"Lebanon, MO",2004,79,62,141,33513,4.20732253155492
30060,"Lebanon, MO",2005,83,57,140,34236,4.08926276434163
30060,"Lebanon, MO",2006,71,59,130,34937,3.72098348455792
30060,"Lebanon, MO",2007,37,80,117,35333,3.31135199388673
30060,"Lebanon, MO",2008,25,47,72,35518,2.02714116785855
30060,"Lebanon, MO",2009,18,42,60,35355,1.69707254985151
30060,"Lebanon, MO",2010,18,37,55,35676,1.54165265164256
30060,"Lebanon, MO",2011,6,30,36,35638,1.01015769684045
30060,"Lebanon, MO",2012,9,36,45,35453,1.26928609708628
30060,"Lebanon, MO",2013,12,0,12,35626,0.33683265031157
30060,"Lebanon, MO",2014,15,2,17,35504,0.478819287967553
30060,"Lebanon, MO",2015,18,0,18,35442,0.507872016251904
30060,"Lebanon, MO",2016,13,2,15,35422,0.423465642820846
30060,"Lebanon, MO",2017,57,26,83,35455,2.34099562826118
30060,"Lebanon, MO",2018,14,6,20,35713,0.560020160725786
30140,"Lebanon, PA",1990,354,49,403,114050,3.53353792196405
30140,"Lebanon, PA",1991,471,90,561,114948,4.88046768973797
30140,"Lebanon, PA",1992,522,5,527,115522,4.56190162912692
30140,"Lebanon, PA",1993,523,4,527,115976,4.5440435952266
30140,"Lebanon, PA",1994,604,0,604,116381,5.18985057698422
30140,"Lebanon, PA",1995,465,0,465,116530,3.99038874109671
30140,"Lebanon, PA",1996,426,9,435,116864,3.72227546549836
30140,"Lebanon, PA",1997,465,2,467,116980,3.99213540776201
30140,"Lebanon, PA",1998,500,0,500,117563,4.2530387962199
30140,"Lebanon, PA",1999,583,8,591,117670,5.02252060848135
30140,"Lebanon, PA",2000,514,0,514,120309,4.27233207823189
30140,"Lebanon, PA",2001,598,11,609,120954,5.03497197281611
30140,"Lebanon, PA",2002,804,6,810,121698,6.65582014494897
30140,"Lebanon, PA",2003,740,4,744,123154,6.04121668804911
30140,"Lebanon, PA",2004,715,92,807,124644,6.47443920284972
30140,"Lebanon, PA",2005,706,139,845,126197,6.69588025071911
30140,"Lebanon, PA",2006,562,2,564,128302,4.39587847422488
30140,"Lebanon, PA",2007,497,0,497,130182,3.81773209813953
30140,"Lebanon, PA",2008,396,0,396,131574,3.00971316521501
30140,"Lebanon, PA",2009,353,0,353,132959,2.65495378274506
30140,"Lebanon, PA",2010,240,0,240,133643,1.79582918671386
30140,"Lebanon, PA",2011,159,16,175,134490,1.30121198602127
30140,"Lebanon, PA",2012,212,12,224,135516,1.65294135009888
30140,"Lebanon, PA",2013,359,89,448,135782,3.2994064014376
30140,"Lebanon, PA",2014,285,63,348,136524,2.54900237320911
30140,"Lebanon, PA",2015,347,37,384,137491,2.79291008138715
30140,"Lebanon, PA",2016,414,18,432,138475,3.11969669615454
30140,"Lebanon, PA",2017,283,83,366,139566,2.62241520141009
30140,"Lebanon, PA",2018,278,21,299,141314,2.11585547079553
30220,"Levelland, TX",1990,10,0,10,24182,0.413530725332892
30220,"Levelland, TX",1991,7,0,7,24450,0.286298568507157
30220,"Levelland, TX",1992,17,0,17,24608,0.690832249674902
30220,"Levelland, TX",1993,20,0,20,24553,0.814564411680854
30220,"Levelland, TX",1994,26,0,26,24394,1.06583586127736
30220,"Levelland, TX",1995,17,0,17,23952,0.709752839011356
30220,"Levelland, TX",1996,7,0,7,23913,0.292727804959645
30220,"Levelland, TX",1997,11,0,11,23835,0.461506188378435
30220,"Levelland, TX",1998,18,2,20,23759,0.841786270465929
30220,"Levelland, TX",1999,10,0,10,23455,0.426348326582818
30220,"Levelland, TX",2000,16,0,16,22670,0.70577856197618
30220,"Levelland, TX",2001,20,0,20,22662,0.8825346394846
30220,"Levelland, TX",2002,13,2,15,22745,0.65948560123104
30220,"Levelland, TX",2003,12,0,12,22955,0.522761925506426
30220,"Levelland, TX",2004,13,0,13,22919,0.567214974475326
30220,"Levelland, TX",2005,20,0,20,23094,0.866025807569066
30220,"Levelland, TX",2006,33,0,33,22912,1.44029329608939
30220,"Levelland, TX",2007,23,0,23,22844,1.00682892663281
30220,"Levelland, TX",2008,29,0,29,22958,1.26317623486366
30220,"Levelland, TX",2009,5,0,5,23086,0.216581477952006
30220,"Levelland, TX",2010,8,0,8,22852,0.350078767722738
30220,"Levelland, TX",2011,8,0,8,22929,0.348903135766933
30220,"Levelland, TX",2012,8,0,8,23075,0.346695557963164
30220,"Levelland, TX",2013,9,0,9,23414,0.384385410438199
30220,"Levelland, TX",2014,15,0,15,23469,0.639140994503387
30220,"Levelland, TX",2015,4,0,4,23317,0.171548655487413
30220,"Levelland, TX",2016,8,0,8,23048,0.347101700798334
30220,"Levelland, TX",2017,6,0,6,22995,0.260926288323549
30220,"Levelland, TX",2018,17,0,17,22980,0.739773716275022
30260,"Lewisburg, PA",1990,100,60,160,36230,4.41622964394149
30260,"Lewisburg, PA",1991,72,14,86,36377,2.36413118179069
30260,"Lewisburg, PA",1992,138,18,156,36478,4.27655024946543
30260,"Lewisburg, PA",1993,131,14,145,38037,3.81207771380498
30260,"Lewisburg, PA",1994,127,6,133,40539,3.28079133673746
30260,"Lewisburg, PA",1995,115,4,119,40633,2.92865404966407
30260,"Lewisburg, PA",1996,114,28,142,41041,3.45995467946687
30260,"Lewisburg, PA",1997,105,2,107,40831,2.62055790943156
30260,"Lewisburg, PA",1998,122,0,122,40272,3.02940007945967
30260,"Lewisburg, PA",1999,162,0,162,40660,3.98425971470733
30260,"Lewisburg, PA",2000,111,0,111,41622,2.66685887271155
30260,"Lewisburg, PA",2001,100,6,106,42098,2.51793434367428
30260,"Lewisburg, PA",2002,211,0,211,42372,4.97970357783442
30260,"Lewisburg, PA",2003,142,0,142,42622,3.33161278213129
30260,"Lewisburg, PA",2004,139,24,163,43287,3.76556471919976
30260,"Lewisburg, PA",2005,129,48,177,43690,4.0512703135729
30260,"Lewisburg, PA",2006,122,0,122,44666,2.73138405050822
30260,"Lewisburg, PA",2007,105,4,109,44846,2.43054007046336
30260,"Lewisburg, PA",2008,75,0,75,45057,1.66455822624675
30260,"Lewisburg, PA",2009,48,4,52,44795,1.16084384417904
30260,"Lewisburg, PA",2010,79,12,91,45000,2.02222222222222
30260,"Lewisburg, PA",2011,37,0,37,45100,0.82039911308204
30260,"Lewisburg, PA",2012,51,2,53,45159,1.17363094842667
30260,"Lewisburg, PA",2013,58,0,58,44729,1.29669789174808
30260,"Lewisburg, PA",2014,57,0,57,44965,1.26765261870344
30260,"Lewisburg, PA",2015,46,0,46,45551,1.0098570832693
30260,"Lewisburg, PA",2016,60,39,99,45514,2.17515489739421
30260,"Lewisburg, PA",2017,77,2,79,44756,1.76512646349093
30260,"Lewisburg, PA",2018,45,0,45,44785,1.00480071452495
30280,"Lewisburg, TN",1990,15,154,169,21741,7.77333149349156
30280,"Lewisburg, TN",1991,130,124,254,22470,11.3039608366711
30280,"Lewisburg, TN",1992,147,44,191,22979,8.31193698594369
30280,"Lewisburg, TN",1993,162,6,168,23576,7.12589073634204
30280,"Lewisburg, TN",1994,170,2,172,24077,7.14374714457781
30280,"Lewisburg, TN",1995,163,2,165,24733,6.67124893866494
30280,"Lewisburg, TN",1996,257,0,257,25137,10.2239726299877
30280,"Lewisburg, TN",1997,248,4,252,25661,9.82034994739098
30280,"Lewisburg, TN",1998,180,7,187,26256,7.12218159658745
30280,"Lewisburg, TN",1999,205,0,205,26458,7.748129110288
30280,"Lewisburg, TN",2000,146,6,152,26863,5.65834046830213
30280,"Lewisburg, TN",2001,177,152,329,27130,12.1267969037965
30280,"Lewisburg, TN",2002,172,0,172,27305,6.2992125984252
30280,"Lewisburg, TN",2003,194,3,197,27474,7.17041566572032
30280,"Lewisburg, TN",2004,226,6,232,27841,8.33303401458281
30280,"Lewisburg, TN",2005,264,0,264,28181,9.36801391008126
30280,"Lewisburg, TN",2006,260,0,260,28821,9.021199819576
30280,"Lewisburg, TN",2007,163,0,163,29494,5.52654777242829
30280,"Lewisburg, TN",2008,177,2,179,30108,5.94526371728444
30280,"Lewisburg, TN",2009,108,4,112,30403,3.683846988784
30280,"Lewisburg, TN",2010,66,0,66,30683,2.15102825668937
30280,"Lewisburg, TN",2011,48,0,48,30842,1.55631930484404
30280,"Lewisburg, TN",2012,57,0,57,30917,1.84364589061034
30280,"Lewisburg, TN",2013,99,0,99,31076,3.18573819024327
30280,"Lewisburg, TN",2014,102,0,102,31242,3.26483579796428
30280,"Lewisburg, TN",2015,107,0,107,31543,3.39219478172653
30280,"Lewisburg, TN",2016,155,0,155,31944,4.85224142248936
30280,"Lewisburg, TN",2017,143,0,143,32934,4.34201736806947
30280,"Lewisburg, TN",2018,162,0,162,33683,4.80954784312561
30300,"Lewiston, ID-WA",1990,104,7,111,51523,2.15437765658056
30300,"Lewiston, ID-WA",1991,138,7,145,52472,2.76337856380546
30300,"Lewiston, ID-WA",1992,218,20,238,53601,4.44021566761814
30300,"Lewiston, ID-WA",1993,220,18,238,54711,4.3501306866992
30300,"Lewiston, ID-WA",1994,243,46,289,55939,5.16634190814995
30300,"Lewiston, ID-WA",1995,188,218,406,56666,7.16479017400205
30300,"Lewiston, ID-WA",1996,187,126,313,57277,5.46467168322363
30300,"Lewiston, ID-WA",1997,133,38,171,57813,2.95781225675886
30300,"Lewiston, ID-WA",1998,138,46,184,58056,3.16935372743558
30300,"Lewiston, ID-WA",1999,129,32,161,57971,2.77725069431267
30300,"Lewiston, ID-WA",2000,140,39,179,57944,3.08918956233605
30300,"Lewiston, ID-WA",2001,101,31,132,57446,2.29781011732758
30300,"Lewiston, ID-WA",2002,121,22,143,57601,2.48259578826756
30300,"Lewiston, ID-WA",2003,135,20,155,58183,2.66400838732963
30300,"Lewiston, ID-WA",2004,200,26,226,58581,3.85790614704426
30300,"Lewiston, ID-WA",2005,253,24,277,58979,4.69658692076841
30300,"Lewiston, ID-WA",2006,156,54,210,59646,3.52077255809275
30300,"Lewiston, ID-WA",2007,150,22,172,59908,2.87106897242438
30300,"Lewiston, ID-WA",2008,110,19,129,60203,2.14275036127768
30300,"Lewiston, ID-WA",2009,71,10,81,60464,1.33964011643292
30300,"Lewiston, ID-WA",2010,71,4,75,61040,1.22870249017038
30300,"Lewiston, ID-WA",2011,61,4,65,61400,1.0586319218241
30300,"Lewiston, ID-WA",2012,29,4,33,61406,0.537406768068267
30300,"Lewiston, ID-WA",2013,60,15,75,61921,1.21122074901891
30300,"Lewiston, ID-WA",2014,59,31,90,62024,1.45105120598478
30300,"Lewiston, ID-WA",2015,63,76,139,62102,2.23825319635439
30300,"Lewiston, ID-WA",2016,93,15,108,62435,1.72979899095059
30300,"Lewiston, ID-WA",2017,97,28,125,62881,1.98788187210763
30300,"Lewiston, ID-WA",2018,108,12,120,63018,1.90421784252118
30340,"Lewiston-Auburn, ME",1990,228,22,250,105355,2.3729296189075
30340,"Lewiston-Auburn, ME",1991,181,6,187,104687,1.78627718818956
30340,"Lewiston-Auburn, ME",1992,240,26,266,103824,2.56202804746494
30340,"Lewiston-Auburn, ME",1993,253,2,255,103726,2.45840001542525
30340,"Lewiston-Auburn, ME",1994,277,6,283,103152,2.74352411974562
30340,"Lewiston-Auburn, ME",1995,236,60,296,102590,2.88527146895409
30340,"Lewiston-Auburn, ME",1996,260,2,262,101576,2.5793494526266
30340,"Lewiston-Auburn, ME",1997,256,4,260,100916,2.57640017440247
30340,"Lewiston-Auburn, ME",1998,338,2,340,101291,3.35666544905273
30340,"Lewiston-Auburn, ME",1999,321,8,329,101351,3.24614458663457
30340,"Lewiston-Auburn, ME",2000,310,11,321,103852,3.09093710280014
30340,"Lewiston-Auburn, ME",2001,294,8,302,104260,2.89660464224055
30340,"Lewiston-Auburn, ME",2002,363,15,378,105063,3.59784129522287
30340,"Lewiston-Auburn, ME",2003,490,18,508,106140,4.78613152440173
30340,"Lewiston-Auburn, ME",2004,525,20,545,106867,5.0997969438648
30340,"Lewiston-Auburn, ME",2005,486,35,521,107352,4.85319323347492
30340,"Lewiston-Auburn, ME",2006,304,16,320,107932,2.96482970759367
30340,"Lewiston-Auburn, ME",2007,246,6,252,107739,2.33898588254949
30340,"Lewiston-Auburn, ME",2008,186,33,219,108284,2.02245945846108
30340,"Lewiston-Auburn, ME",2009,153,14,167,107830,1.54873411851989
30340,"Lewiston-Auburn, ME",2010,162,44,206,107707,1.91259621008848
30340,"Lewiston-Auburn, ME",2011,146,2,148,107426,1.37769255115149
30340,"Lewiston-Auburn, ME",2012,125,4,129,107481,1.20021213051609
30340,"Lewiston-Auburn, ME",2013,121,2,123,107275,1.14658587741785
30340,"Lewiston-Auburn, ME",2014,91,0,91,107415,0.847181492342783
30340,"Lewiston-Auburn, ME",2015,74,0,74,107155,0.690588399981335
30340,"Lewiston-Auburn, ME",2016,143,42,185,107404,1.72246843692972
30340,"Lewiston-Auburn, ME",2017,169,83,252,107569,2.34268237131516
30340,"Lewiston-Auburn, ME",2018,177,123,300,107679,2.78605856295099
30380,"Lewistown, PA",1990,159,6,165,46244,3.56803044719315
30380,"Lewistown, PA",1991,129,6,135,46424,2.9079786317422
30380,"Lewistown, PA",1992,123,44,167,46599,3.58376789201485
30380,"Lewistown, PA",1993,121,55,176,46765,3.76349834277772
30380,"Lewistown, PA",1994,104,8,112,46878,2.38918042578608
30380,"Lewistown, PA",1995,131,11,142,46899,3.02778310838184
30380,"Lewistown, PA",1996,115,12,127,46902,2.70777365570765
30380,"Lewistown, PA",1997,130,0,130,46950,2.76890308839191
30380,"Lewistown, PA",1998,128,6,134,46985,2.85197403426626
30380,"Lewistown, PA",1999,119,0,119,46882,2.53828761571605
30380,"Lewistown, PA",2000,120,0,120,46479,2.58181114051507
30380,"Lewistown, PA",2001,116,4,120,46535,2.57870420113893
30380,"Lewistown, PA",2002,121,0,121,46558,2.59890888783882
30380,"Lewistown, PA",2003,154,0,154,46420,3.3175355450237
30380,"Lewistown, PA",2004,122,0,122,46313,2.63424956275776
30380,"Lewistown, PA",2005,77,0,77,46377,1.66030575500787
30380,"Lewistown, PA",2006,75,0,75,46435,1.61516097771078
30380,"Lewistown, PA",2007,79,8,87,46551,1.86891796094606
30380,"Lewistown, PA",2008,61,0,61,46600,1.30901287553648
30380,"Lewistown, PA",2009,43,0,43,46662,0.921520723500922
30380,"Lewistown, PA",2010,79,0,79,46639,1.69386136066382
30380,"Lewistown, PA",2011,24,31,55,46743,1.17664677063945
30380,"Lewistown, PA",2012,38,0,38,46752,0.812799452429843
30380,"Lewistown, PA",2013,51,0,51,46629,1.09373994724313
30380,"Lewistown, PA",2014,56,0,56,46490,1.20456012045601
30380,"Lewistown, PA",2015,66,0,66,46433,1.4214028815713
30380,"Lewistown, PA",2016,62,0,62,46331,1.33819688761305
30380,"Lewistown, PA",2017,64,0,64,46334,1.38127508956706
30380,"Lewistown, PA",2018,42,0,42,46222,0.908658214702955
30420,"Lexington, NE",1990,19,52,71,21943,3.23565601786447
30420,"Lexington, NE",1991,20,102,122,22768,5.3583977512298
30420,"Lexington, NE",1992,30,3,33,23942,1.37833096650238
30420,"Lexington, NE",1993,33,60,93,24848,3.74275595621378
30420,"Lexington, NE",1994,48,12,60,24933,2.40644928408134
30420,"Lexington, NE",1995,40,2,42,25166,1.66891838194389
30420,"Lexington, NE",1996,61,48,109,25356,4.29878529736551
30420,"Lexington, NE",1997,39,34,73,25407,2.87322391466919
30420,"Lexington, NE",1998,17,36,53,25504,2.07810539523212
30420,"Lexington, NE",1999,28,0,28,25575,1.09481915933529
30420,"Lexington, NE",2000,26,4,30,26556,1.12968820605513
30420,"Lexington, NE",2001,40,4,44,26455,1.66320166320166
30420,"Lexington, NE",2002,41,0,41,26249,1.56196426530534
30420,"Lexington, NE",2003,24,0,24,26311,0.912166014214587
30420,"Lexington, NE",2004,34,0,34,26224,1.29652226967663
30420,"Lexington, NE",2005,39,3,42,26195,1.60335941973659
30420,"Lexington, NE",2006,40,0,40,26366,1.51710536296746
30420,"Lexington, NE",2007,32,0,32,26279,1.21770234788234
30420,"Lexington, NE",2008,29,0,29,26209,1.10649013697585
30420,"Lexington, NE",2009,59,13,72,26232,2.74473924977127
30420,"Lexington, NE",2010,35,13,48,26354,1.82135539197086
30420,"Lexington, NE",2011,24,4,28,26212,1.06821303219899
30420,"Lexington, NE",2012,26,4,30,26067,1.150880423524
30420,"Lexington, NE",2013,33,0,33,26046,1.26698917300161
30420,"Lexington, NE",2014,24,26,50,26002,1.9229290054611199
30420,"Lexington, NE",2015,40,30,70,25928,2.69978401727862
30420,"Lexington, NE",2016,19,0,19,25790,0.736719658782474
30420,"Lexington, NE",2017,22,56,78,25670,3.03856641994546
30420,"Lexington, NE",2018,33,12,45,25705,1.75063217272904
30460,"Lexington-Fayette, KY",1990,1943,222,2165,349766,6.18985264433936
30460,"Lexington-Fayette, KY",1991,2075,142,2217,353851,6.26534897456839
30460,"Lexington-Fayette, KY",1992,2621,150,2771,359505,7.70782047537586
30460,"Lexington-Fayette, KY",1993,2745,270,3015,364422,8.2733753725077
30460,"Lexington-Fayette, KY",1994,2751,348,3099,368312,8.41406199092074
30460,"Lexington-Fayette, KY",1995,2743,994,3737,371193,10.0675389891512
30460,"Lexington-Fayette, KY",1996,2698,1052,3750,375403,9.98926487001969
30460,"Lexington-Fayette, KY",1997,2713,683,3396,378551,8.97105013591299
30460,"Lexington-Fayette, KY",1998,3141,1367,4508,383365,11.7590286019851
30460,"Lexington-Fayette, KY",1999,3329,513,3842,388058,9.90058187178205
30460,"Lexington-Fayette, KY",2000,3083,807,3890,409924,9.48956391916551
30460,"Lexington-Fayette, KY",2001,2846,272,3118,414520,7.52195310238348
30460,"Lexington-Fayette, KY",2002,3632,302,3934,418448,9.40140710434749
30460,"Lexington-Fayette, KY",2003,3792,183,3975,424953,9.35397561612696
30460,"Lexington-Fayette, KY",2004,4175,946,5121,430229,11.9029633055884
30460,"Lexington-Fayette, KY",2005,4315,692,5007,436898,11.4603408575915
30460,"Lexington-Fayette, KY",2006,3058,619,3677,445685,8.2502215690454
30460,"Lexington-Fayette, KY",2007,2342,227,2569,452138,5.68189358116327
30460,"Lexington-Fayette, KY",2008,1392,1427,2819,460112,6.12676913447161
30460,"Lexington-Fayette, KY",2009,1279,354,1633,467328,3.49433374417968
30460,"Lexington-Fayette, KY",2010,1155,206,1361,473415,2.87485609877169
30460,"Lexington-Fayette, KY",2011,1009,492,1501,478989,3.13368365453069
30460,"Lexington-Fayette, KY",2012,1218,1100,2318,485421,4.77523634123781
30460,"Lexington-Fayette, KY",2013,1335,319,1654,491110,3.36788092280752
30460,"Lexington-Fayette, KY",2014,1319,569,1888,495364,3.81133873272987
30460,"Lexington-Fayette, KY",2015,1381,825,2206,501668,4.39733050543387
30460,"Lexington-Fayette, KY",2016,1480,1252,2732,507460,5.38367556063532
30460,"Lexington-Fayette, KY",2017,1602,724,2326,512732,4.53648299696528
30460,"Lexington-Fayette, KY",2018,1404,1368,2772,516697,5.36484632192562
30580,"Liberal, KS",1990,5,0,5,18673,0.267766293578964
30580,"Liberal, KS",1991,7,0,7,18658,0.375174188015864
30580,"Liberal, KS",1992,6,0,6,18751,0.319982934243507
30580,"Liberal, KS",1993,16,44,60,19131,3.13627097381214
30580,"Liberal, KS",1994,15,10,25,19325,1.29366106080207
30580,"Liberal, KS",1995,13,0,13,19559,0.66465565724219
30580,"Liberal, KS",1996,25,32,57,19812,2.87704421562689
30580,"Liberal, KS",1997,8,16,24,20011,1.19934036280046
30580,"Liberal, KS",1998,22,156,178,20057,8.8747070848083
30580,"Liberal, KS",1999,20,0,20,20033,0.998352718015275
30580,"Liberal, KS",2000,15,0,15,22616,0.663247258577998
30580,"Liberal, KS",2001,7,0,7,22544,0.310503903477644
30580,"Liberal, KS",2002,7,0,7,22687,0.308546744831842
30580,"Liberal, KS",2003,17,0,17,22647,0.750651300392988
30580,"Liberal, KS",2004,26,0,26,22538,1.15360724110391
30580,"Liberal, KS",2005,33,0,33,22334,1.47756783379601
30580,"Liberal, KS",2006,46,2,48,22246,2.15769127034074
30580,"Liberal, KS",2007,29,34,63,22409,2.81137043152305
30580,"Liberal, KS",2008,23,4,27,22522,1.19882781280526
30580,"Liberal, KS",2009,17,32,49,22729,2.15583615645211
30580,"Liberal, KS",2010,17,41,58,22974,2.52459301819448
30580,"Liberal, KS",2011,1,40,41,23140,1.77182368193604
30580,"Liberal, KS",2012,11,0,11,23368,0.47072920232797
30580,"Liberal, KS",2013,14,0,14,23335,0.599957145918149
30580,"Liberal, KS",2014,14,48,62,23335,2.65695307478037
30580,"Liberal, KS",2015,8,2,10,23270,0.429737859905458
30580,"Liberal, KS",2016,15,10,25,22878,1.0927528630125
30580,"Liberal, KS",2017,14,14,28,22199,1.26131807739087
30580,"Liberal, KS",2018,17,16,33,21780,1.51515151515152
30620,"Lima, OH",1990,199,73,272,109799,2.47725389120119
30620,"Lima, OH",1991,185,24,209,109706,1.90509179078628
30620,"Lima, OH",1992,254,58,312,109863,2.83990060347888
30620,"Lima, OH",1993,213,39,252,109715,2.29686004648407
30620,"Lima, OH",1994,262,25,287,109426,2.62277703653611
30620,"Lima, OH",1995,247,70,317,108965,2.90919102464094
30620,"Lima, OH",1996,270,22,292,108535,2.69037637628415
30620,"Lima, OH",1997,197,308,505,107953,4.67796170555705
30620,"Lima, OH",1998,211,48,259,107248,2.41496344920185
30620,"Lima, OH",1999,214,22,236,106686,2.21209905704591
30620,"Lima, OH",2000,215,16,231,108589,2.12728729429316
30620,"Lima, OH",2001,192,28,220,108523,2.02722003630567
30620,"Lima, OH",2002,181,9,190,108518,1.75086160821246
30620,"Lima, OH",2003,260,24,284,107418,2.64387719004264
30620,"Lima, OH",2004,331,38,369,106826,3.45421526594649
30620,"Lima, OH",2005,267,53,320,106861,2.99454431457688
30620,"Lima, OH",2006,184,9,193,106716,1.8085385509202
30620,"Lima, OH",2007,169,9,178,106717,1.66796292999241
30620,"Lima, OH",2008,96,14,110,106773,1.03022299645041
30620,"Lima, OH",2009,57,7,64,106518,0.600837417150153
30620,"Lima, OH",2010,44,72,116,106359,1.09064583157044
30620,"Lima, OH",2011,35,16,51,105976,0.481241035706198
30620,"Lima, OH",2012,40,40,80,105239,0.760174460038579
30620,"Lima, OH",2013,59,4,63,105047,0.599731548735328
30620,"Lima, OH",2014,55,6,61,104846,0.581805695973142
30620,"Lima, OH",2015,64,13,77,104069,0.739893724355956
30620,"Lima, OH",2016,62,14,76,103561,0.733866996263072
30620,"Lima, OH",2017,66,158,224,103069,2.17330138062851
30620,"Lima, OH",2018,76,10,86,102663,0.837692255242882
30660,"Lincoln, IL",1990,40,4,44,30776,1.42968546919678
30660,"Lincoln, IL",1991,40,14,54,30783,1.75421498879252
30660,"Lincoln, IL",1992,39,15,54,30971,1.74356656226793
30660,"Lincoln, IL",1993,50,4,54,31019,1.74086849995164
30660,"Lincoln, IL",1994,73,4,77,31126,2.4738161022939
30660,"Lincoln, IL",1995,64,14,78,31393,2.48463033160259
30660,"Lincoln, IL",1996,51,18,69,31305,2.20412074748443
30660,"Lincoln, IL",1997,42,2,44,31382,1.40207762411574
30660,"Lincoln, IL",1998,38,0,38,31857,1.19283046112314
30660,"Lincoln, IL",1999,36,2,38,31701,1.19870035645563
30660,"Lincoln, IL",2000,25,2,27,31161,0.866467700009627
30660,"Lincoln, IL",2001,35,3,38,30934,1.22842180125428
30660,"Lincoln, IL",2002,38,2,40,30873,1.29563048618534
30660,"Lincoln, IL",2003,48,58,106,30958,3.42399379804897
30660,"Lincoln, IL",2004,46,0,46,30981,1.48478099480327
30660,"Lincoln, IL",2005,41,2,43,30795,1.39633057314499
30660,"Lincoln, IL",2006,39,2,41,30562,1.34153523984032
30660,"Lincoln, IL",2007,28,46,74,30498,2.42638861564693
30660,"Lincoln, IL",2008,18,0,18,30513,0.589912496313047
30660,"Lincoln, IL",2009,21,0,21,30342,0.692109946608661
30660,"Lincoln, IL",2010,17,0,17,30284,0.561352529388456
30660,"Lincoln, IL",2011,14,2,16,30269,0.528593610624732
30660,"Lincoln, IL",2012,12,0,12,30357,0.395295977863425
30660,"Lincoln, IL",2013,12,0,12,29821,0.402400992589115
30660,"Lincoln, IL",2014,13,0,13,29656,0.438359859724845
30660,"Lincoln, IL",2015,8,0,8,29270,0.273317389818927
30660,"Lincoln, IL",2016,7,0,7,29153,0.240112509861764
30660,"Lincoln, IL",2017,7,0,7,29015,0.241254523522316
30660,"Lincoln, IL",2018,13,0,13,28925,0.449438202247191
30700,"Lincoln, NE",1990,1010,1127,2137,229901,9.29530537057255
30700,"Lincoln, NE",1991,1086,518,1604,232186,6.90825458899331
30700,"Lincoln, NE",1992,1205,327,1532,235568,6.5034300074713
30700,"Lincoln, NE",1993,1117,631,1748,239455,7.29991021277484
30700,"Lincoln, NE",1994,1229,812,2041,241540,8.44994617868676
30700,"Lincoln, NE",1995,1054,977,2031,244985,8.29030348796865
30700,"Lincoln, NE",1996,1101,1276,2377,247265,9.61316805856065
30700,"Lincoln, NE",1997,1149,1147,2296,249612,9.19827572392353
30700,"Lincoln, NE",1998,1335,875,2210,252053,8.76799720693664
30700,"Lincoln, NE",1999,1281,477,1758,253737,6.9284337719765
30700,"Lincoln, NE",2000,1362,409,1771,268042,6.60717350266003
30700,"Lincoln, NE",2001,1461,333,1794,271237,6.61414187592401
30700,"Lincoln, NE",2002,1616,384,2000,274972,7.27346784399866
30700,"Lincoln, NE",2003,2097,401,2498,279194,8.94718367873235
30700,"Lincoln, NE",2004,2083,623,2706,281768,9.60364555236933
30700,"Lincoln, NE",2005,1545,235,1780,285469,6.23535305059394
30700,"Lincoln, NE",2006,1198,226,1424,288940,4.92835882882259
30700,"Lincoln, NE",2007,1065,284,1349,292502,4.61193427737246
30700,"Lincoln, NE",2008,676,147,823,296258,2.77798405443904
30700,"Lincoln, NE",2009,682,46,728,299633,2.42963892495152
30700,"Lincoln, NE",2010,648,384,1032,302958,3.40641277008694
30700,"Lincoln, NE",2011,680,379,1059,306587,3.45415819979321
30700,"Lincoln, NE",2012,859,390,1249,310324,4.02482566607803
30700,"Lincoln, NE",2013,1052,535,1587,314111,5.05235410412243
30700,"Lincoln, NE",2014,1052,942,1994,319652,6.23803386182473
30700,"Lincoln, NE",2015,1090,1458,2548,323131,7.88534680980779
30700,"Lincoln, NE",2016,1143,1241,2384,327550,7.27827812547703
30700,"Lincoln, NE",2017,1271,1237,2508,331179,7.57294393666265
30700,"Lincoln, NE",2018,1117,687,1804,334590,5.39167339131474
30780,"Little Rock-North Little Rock-Conway, AR",1990,1420,179,1599,535999,2.98321452092261
30780,"Little Rock-North Little Rock-Conway, AR",1991,1497,332,1829,540648,3.38297746408014
30780,"Little Rock-North Little Rock-Conway, AR",1992,1873,147,2020,548157,3.6850756261436
30780,"Little Rock-North Little Rock-Conway, AR",1993,2200,478,2678,555790,4.81836664927401
30780,"Little Rock-North Little Rock-Conway, AR",1994,2455,326,2781,560818,4.95882799767482
30780,"Little Rock-North Little Rock-Conway, AR",1995,2229,1088,3317,566243,5.85790906024445
30780,"Little Rock-North Little Rock-Conway, AR",1996,2062,743,2805,572668,4.89812596478239
30780,"Little Rock-North Little Rock-Conway, AR",1997,1936,1622,3558,577407,6.16203128815549
30780,"Little Rock-North Little Rock-Conway, AR",1998,2254,1472,3726,581399,6.40867975349115
30780,"Little Rock-North Little Rock-Conway, AR",1999,2549,1322,3871,586664,6.59832544693385
30780,"Little Rock-North Little Rock-Conway, AR",2000,2240,506,2746,612313,4.48463449248995
30780,"Little Rock-North Little Rock-Conway, AR",2001,2474,572,3046,618126,4.9277978923391
30780,"Little Rock-North Little Rock-Conway, AR",2002,2764,1772,4536,624166,7.26729748175966
30780,"Little Rock-North Little Rock-Conway, AR",2003,3515,583,4098,631032,6.49412391130719
30780,"Little Rock-North Little Rock-Conway, AR",2004,3590,1935,5525,639558,8.63877865650965
30780,"Little Rock-North Little Rock-Conway, AR",2005,4196,1552,5748,648784,8.8596512860983
30780,"Little Rock-North Little Rock-Conway, AR",2006,3767,408,4175,661719,6.30932465291158
30780,"Little Rock-North Little Rock-Conway, AR",2007,2877,600,3477,671441,5.17841478253488
30780,"Little Rock-North Little Rock-Conway, AR",2008,1842,993,2835,681888,4.15757426439533
30780,"Little Rock-North Little Rock-Conway, AR",2009,1781,1268,3049,691903,4.40668706451627
30780,"Little Rock-North Little Rock-Conway, AR",2010,1896,1663,3559,702307,5.06758440397148
30780,"Little Rock-North Little Rock-Conway, AR",2011,1514,1716,3230,710612,4.54537778703428
30780,"Little Rock-North Little Rock-Conway, AR",2012,1851,1462,3313,717646,4.61648222103934
30780,"Little Rock-North Little Rock-Conway, AR",2013,1681,814,2495,723154,3.45016414207762
30780,"Little Rock-North Little Rock-Conway, AR",2014,1514,568,2082,728182,2.85917531606109
30780,"Little Rock-North Little Rock-Conway, AR",2015,1487,1212,2699,730897,3.69272277762804
30780,"Little Rock-North Little Rock-Conway, AR",2016,1649,678,2327,734333,3.16886208300594
30780,"Little Rock-North Little Rock-Conway, AR",2017,2087,1128,3215,737991,4.35642169077943
30780,"Little Rock-North Little Rock-Conway, AR",2018,1819,355,2174,741104,2.93346143051448
30820,"Lock Haven, PA",1990,53,47,100,37247,2.68477998228045
30820,"Lock Haven, PA",1991,91,10,101,37120,2.72090517241379
30820,"Lock Haven, PA",1992,121,124,245,37370,6.55606101150656
30820,"Lock Haven, PA",1993,74,10,84,37278,2.25333977144697
30820,"Lock Haven, PA",1994,84,33,117,37376,3.13035102739726
30820,"Lock Haven, PA",1995,122,16,138,37209,3.70878013383859
30820,"Lock Haven, PA",1996,85,3,88,37108,2.37145628974884
30820,"Lock Haven, PA",1997,69,7,76,36991,2.05455381038631
30820,"Lock Haven, PA",1998,93,0,93,36973,2.51534903848755
30820,"Lock Haven, PA",1999,134,21,155,37124,4.17519663829329
30820,"Lock Haven, PA",2000,127,10,137,37926,3.61229763223119
30820,"Lock Haven, PA",2001,153,19,172,37945,4.53287653182237
30820,"Lock Haven, PA",2002,128,4,132,38007,3.47304443918226
30820,"Lock Haven, PA",2003,147,12,159,38143,4.16852371339433
30820,"Lock Haven, PA",2004,144,6,150,38227,3.92392811363696
30820,"Lock Haven, PA",2005,100,0,100,38418,2.60294653547816
30820,"Lock Haven, PA",2006,105,0,105,38730,2.71107668474051
30820,"Lock Haven, PA",2007,93,5,98,38859,2.52193828971409
30820,"Lock Haven, PA",2008,61,0,61,38955,1.56590938262097
30820,"Lock Haven, PA",2009,33,0,33,39074,0.844551364078415
30820,"Lock Haven, PA",2010,31,0,31,39250,0.789808917197452
30820,"Lock Haven, PA",2011,27,8,35,39493,0.886233003317043
30820,"Lock Haven, PA",2012,29,0,29,39715,0.730202694196147
30820,"Lock Haven, PA",2013,31,0,31,39817,0.778561920787603
30820,"Lock Haven, PA",2014,38,0,38,39471,0.962732132451673
30820,"Lock Haven, PA",2015,41,0,41,39381,1.0411111957543
30820,"Lock Haven, PA",2016,36,0,36,38996,0.923171607344343
30820,"Lock Haven, PA",2017,41,0,41,38837,1.05569431212504
30820,"Lock Haven, PA",2018,27,0,27,38684,0.697962982111467
30860,"Logan, UT-ID",1990,211,84,295,79658,3.70333174320219
30860,"Logan, UT-ID",1991,240,130,370,82046,4.50966530970431
30860,"Logan, UT-ID",1992,389,234,623,84707,7.3547640690852
30860,"Logan, UT-ID",1993,447,328,775,87294,8.87804431003276
30860,"Logan, UT-ID",1994,529,515,1044,90012,11.5984535395281
30860,"Logan, UT-ID",1995,563,386,949,92680,10.2395338800173
30860,"Logan, UT-ID",1996,673,320,993,94954,10.4576953050951
30860,"Logan, UT-ID",1997,693,78,771,96589,7.98227541438466
30860,"Logan, UT-ID",1998,657,255,912,98384,9.26979996747439
30860,"Logan, UT-ID",1999,742,40,782,98687,7.92404268039357
30860,"Logan, UT-ID",2000,562,163,725,103211,7.02444506883956
30860,"Logan, UT-ID",2001,558,320,878,104294,8.4185092143364
30860,"Logan, UT-ID",2002,652,79,731,107180,6.82030229520433
30860,"Logan, UT-ID",2003,792,196,988,108819,9.0792968139755
30860,"Logan, UT-ID",2004,949,455,1404,110813,12.6699935928095
30860,"Logan, UT-ID",2005,960,144,1104,112580,9.80635992183336
30860,"Logan, UT-ID",2006,815,181,996,113321,8.78919176498619
30860,"Logan, UT-ID",2007,912,93,1005,115901,8.6711935186064
30860,"Logan, UT-ID",2008,468,125,593,119394,4.96674874784328
30860,"Logan, UT-ID",2009,428,105,533,123048,4.33164293608998
30860,"Logan, UT-ID",2010,366,289,655,126167,5.19153185856841
30860,"Logan, UT-ID",2011,295,247,542,127583,4.24821488756339
30860,"Logan, UT-ID",2012,338,503,841,128695,6.53483041299196
30860,"Logan, UT-ID",2013,379,291,670,129833,5.16047537991112
30860,"Logan, UT-ID",2014,415,369,784,130816,5.99315068493151
30860,"Logan, UT-ID",2015,368,246,614,132728,4.62600204930384
30860,"Logan, UT-ID",2016,662,235,897,135685,6.61090024689538
30860,"Logan, UT-ID",2017,811,562,1373,138052,9.94552777214383
30860,"Logan, UT-ID",2018,712,499,1211,140794,8.60121880193758
30880,"Logan, WV",1990,3,10,13,42857,0.303334344447815
30880,"Logan, WV",1991,3,0,3,42971,0.0698145260757255
30880,"Logan, WV",1992,5,14,19,42757,0.444371681829876
30880,"Logan, WV",1993,11,8,19,43006,0.441798818769474
30880,"Logan, WV",1994,4,5,9,42756,0.210496772382823
30880,"Logan, WV",1995,4,7,11,42283,0.26015183407043
30880,"Logan, WV",1996,4,11,15,41791,0.35892895599531
30880,"Logan, WV",1997,5,6,11,41286,0.266434142324275
30880,"Logan, WV",1998,1,5,6,40997,0.146352172110154
30880,"Logan, WV",1999,1,22,23,40028,0.574597781552913
30880,"Logan, WV",2000,2,5,7,37577,0.186284163184927
30880,"Logan, WV",2001,3,7,10,37013,0.270175343798125
30880,"Logan, WV",2002,2,6,8,37093,0.215674116410104
30880,"Logan, WV",2003,4,5,9,36947,0.243592172571521
30880,"Logan, WV",2004,4,5,9,36582,0.246022634082336
30880,"Logan, WV",2005,1,0,1,36476,0.0274152867638996
30880,"Logan, WV",2006,0,0,0,36440,0
30880,"Logan, WV",2007,4,0,4,36443,0.109760447822627
30880,"Logan, WV",2008,2,0,2,36548,0.0547225566378461
30880,"Logan, WV",2009,3,5,8,36645,0.218310820030018
30880,"Logan, WV",2010,3,10,13,36722,0.354011219432493
30880,"Logan, WV",2011,13,0,13,36456,0.356594250603467
30880,"Logan, WV",2012,4,0,4,36313,0.110153388593617
30880,"Logan, WV",2013,1,0,1,35929,0.0278326699880319
30880,"Logan, WV",2014,1,0,1,35248,0.0283704039945529
30880,"Logan, WV",2015,1,0,1,34437,0.0290385341347969
30880,"Logan, WV",2016,0,0,0,33669,0
30880,"Logan, WV",2017,1,0,1,33043,0.0302635959204673
30880,"Logan, WV",2018,0,0,0,32607,0
30900,"Logansport, IN",1990,55,0,55,38410,1.43191877115335
30900,"Logansport, IN",1991,67,4,71,38397,1.84910279448915
30900,"Logansport, IN",1992,55,4,59,38531,1.53123459032986
30900,"Logansport, IN",1993,101,0,101,38593,2.61705490633016
30900,"Logansport, IN",1994,52,0,52,38443,1.35265197825352
30900,"Logansport, IN",1995,75,0,75,38427,1.95175267390116
30900,"Logansport, IN",1996,75,4,79,38716,2.04050005165823
30900,"Logansport, IN",1997,81,0,81,38738,2.09097010687181
30900,"Logansport, IN",1998,87,0,87,38819,2.24117056080785
30900,"Logansport, IN",1999,92,0,92,38908,2.36455227716665
30900,"Logansport, IN",2000,87,0,87,40939,2.12511297295977
30900,"Logansport, IN",2001,82,0,82,40859,2.00690178418464
30900,"Logansport, IN",2002,60,4,64,40389,1.58458986357672
30900,"Logansport, IN",2003,53,0,53,40218,1.31781789248595
30900,"Logansport, IN",2004,65,0,65,39921,1.62821572605897
30900,"Logansport, IN",2005,54,0,54,39637,1.36236344829326
30900,"Logansport, IN",2006,45,0,45,39255,1.1463507833397
30900,"Logansport, IN",2007,35,0,35,39033,0.896677170599236
30900,"Logansport, IN",2008,30,0,30,39070,0.767852572306117
30900,"Logansport, IN",2009,12,0,12,38968,0.307944980496818
30900,"Logansport, IN",2010,15,0,15,38980,0.384812724474089
30900,"Logansport, IN",2011,16,0,16,38909,0.411215914055874
30900,"Logansport, IN",2012,9,0,9,38769,0.232144238953803
30900,"Logansport, IN",2013,12,0,12,38590,0.310961388960871
30900,"Logansport, IN",2014,12,0,12,38495,0.311728795947526
30900,"Logansport, IN",2015,12,0,12,38114,0.314844938867608
30900,"Logansport, IN",2016,17,0,17,37953,0.44792243037441
30900,"Logansport, IN",2017,27,0,27,37905,0.712307083498219
30900,"Logansport, IN",2018,5,0,5,37955,0.131734949282045
30940,"London, KY",1990,57,76,133,106568,1.24802942722018
30940,"London, KY",1991,51,44,95,107875,0.880648899188876
30940,"London, KY",1992,53,44,97,109614,0.884923458682285
30940,"London, KY",1993,73,76,149,111567,1.33552035996307
30940,"London, KY",1994,62,22,84,113046,0.743060347115334
30940,"London, KY",1995,34,53,87,114411,0.760416393528594
30940,"London, KY",1996,34,37,71,115933,0.612422692417172
30940,"London, KY",1997,46,49,95,117169,0.810794664117642
30940,"London, KY",1998,41,74,115,118542,0.97012029491657
30940,"London, KY",1999,65,80,145,120045,1.20788037819151
30940,"London, KY",2000,19,25,44,120585,0.364887838454202
30940,"London, KY",2001,36,24,60,121126,0.49535194755874
30940,"London, KY",2002,45,10,55,121793,0.451585887530482
30940,"London, KY",2003,30,32,62,122846,0.504696937629227
30940,"London, KY",2004,37,13,50,123345,0.405367059872715
30940,"London, KY",2005,56,26,82,124288,0.65975798146241
30940,"London, KY",2006,55,8,63,124987,0.504052421451831
30940,"London, KY",2007,32,7,39,125744,0.310153963608602
30940,"London, KY",2008,24,19,43,126051,0.341131764127218
30940,"London, KY",2009,24,8,32,126427,0.253110490638867
30940,"London, KY",2010,15,2,17,126565,0.134318334452653
30940,"London, KY",2011,15,12,27,127095,0.212439513749557
30940,"London, KY",2012,8,12,20,126832,0.157688911315756
30940,"London, KY",2013,20,10,30,127250,0.235756385068762
30940,"London, KY",2014,13,2,15,127316,0.117817085048226
30940,"London, KY",2015,25,30,55,127537,0.431247402714506
30940,"London, KY",2016,8,8,16,127698,0.125295619351908
30940,"London, KY",2017,14,8,22,127912,0.171993245356182
30940,"London, KY",2018,13,2,15,128215,0.11699099169364
30980,"Longview, TX",1990,124,0,124,180244,0.687956325869377
30980,"Longview, TX",1991,130,24,154,182742,0.842718149084502
30980,"Longview, TX",1992,183,30,213,184106,1.15694219634341
30980,"Longview, TX",1993,234,12,246,185494,1.32618844814388
30980,"Longview, TX",1994,294,43,337,186920,1.80291033597261
30980,"Longview, TX",1995,231,170,401,189495,2.11615082192142
30980,"Longview, TX",1996,254,171,425,191587,2.21831335111464
30980,"Longview, TX",1997,240,220,460,193362,2.3789576028382
30980,"Longview, TX",1998,227,52,279,194515,1.43433668354626
30980,"Longview, TX",1999,226,144,370,195777,1.88990535149686
30980,"Longview, TX",2000,186,0,186,194113,0.958204757022971
30980,"Longview, TX",2001,270,20,290,195374,1.48433261334671
30980,"Longview, TX",2002,319,2,321,197750,1.62326169405815
30980,"Longview, TX",2003,330,2,332,199547,1.66376843550642
30980,"Longview, TX",2004,320,168,488,201231,2.4250736715516
30980,"Longview, TX",2005,386,10,396,203062,1.95014330598536
30980,"Longview, TX",2006,376,275,651,205537,3.16731294122226
30980,"Longview, TX",2007,360,21,381,207813,1.83337904750906
30980,"Longview, TX",2008,214,61,275,210058,1.30916223138371
30980,"Longview, TX",2009,171,28,199,213121,0.933741864949958
30980,"Longview, TX",2010,213,278,491,214727,2.286624411462
30980,"Longview, TX",2011,239,238,477,216084,2.20747487088355
30980,"Longview, TX",2012,245,450,695,216819,3.20543863775776
30980,"Longview, TX",2013,258,531,789,216369,3.64654825783731
30980,"Longview, TX",2014,213,77,290,216698,1.33826800431938
30980,"Longview, TX",2015,221,27,248,217260,1.14148945963362
30980,"Longview, TX",2016,164,0,164,217322,0.754640579416718
30980,"Longview, TX",2017,167,20,187,218594,0.855467213189749
30980,"Longview, TX",2018,183,76,259,219417,1.18040078936454
31020,"Longview, WA",1990,193,4,197,82455,2.38918197804863
31020,"Longview, WA",1991,247,143,390,84088,4.63799828750833
31020,"Longview, WA",1992,304,93,397,85097,4.66526434539408
31020,"Longview, WA",1993,332,69,401,86187,4.65267383712161
31020,"Longview, WA",1994,362,62,424,87369,4.8529798898923
31020,"Longview, WA",1995,468,73,541,88755,6.09543124331024
31020,"Longview, WA",1996,405,133,538,89689,5.99850594833257
31020,"Longview, WA",1997,300,68,368,90623,4.06077927237015
31020,"Longview, WA",1998,445,215,660,91448,7.21721634152743
31020,"Longview, WA",1999,431,158,589,91861,6.41186139928805
31020,"Longview, WA",2000,349,165,514,92984,5.52783274541857
31020,"Longview, WA",2001,288,123,411,93608,4.3906503717631
31020,"Longview, WA",2002,365,116,481,94325,5.09939040551285
31020,"Longview, WA",2003,354,82,436,94516,4.61297558085403
31020,"Longview, WA",2004,383,26,409,95541,4.28088464638218
31020,"Longview, WA",2005,469,46,515,96536,5.33479738128781
31020,"Longview, WA",2006,620,83,703,99162,7.0894092495109
31020,"Longview, WA",2007,485,93,578,100744,5.73731438100532
31020,"Longview, WA",2008,268,8,276,101688,2.71418456455039
31020,"Longview, WA",2009,147,0,147,102126,1.43939839022384
31020,"Longview, WA",2010,116,15,131,102357,1.27983430542122
31020,"Longview, WA",2011,113,0,113,102299,1.10460512810487
31020,"Longview, WA",2012,132,0,132,101657,1.29848411816205
31020,"Longview, WA",2013,155,40,195,101483,1.9215040942818
31020,"Longview, WA",2014,160,18,178,101799,1.74854369885755
31020,"Longview, WA",2015,168,10,178,103050,1.72731683648714
31020,"Longview, WA",2016,273,35,308,104826,2.93820235437773
31020,"Longview, WA",2017,464,20,484,106900,4.52759588400374
31020,"Longview, WA",2018,294,24,318,108987,2.9177791846734
31060,"Los Alamos, NM",1990,27,0,27,18140,1.48842337375965
31060,"Los Alamos, NM",1991,22,24,46,18060,2.54706533776301
31060,"Los Alamos, NM",1992,46,0,46,18100,2.5414364640884
31060,"Los Alamos, NM",1993,41,3,44,18377,2.39429721935027
31060,"Los Alamos, NM",1994,71,0,71,18541,3.82935116768243
31060,"Los Alamos, NM",1995,40,121,161,18658,8.62900632436488
31060,"Los Alamos, NM",1996,9,0,9,18262,0.492826634541671
31060,"Los Alamos, NM",1997,11,0,11,18279,0.601783467366924
31060,"Los Alamos, NM",1998,56,0,56,18340,3.05343511450382
31060,"Los Alamos, NM",1999,43,95,138,18350,7.52043596730245
31060,"Los Alamos, NM",2000,76,120,196,18263,10.7320812571867
31060,"Los Alamos, NM",2001,127,0,127,17610,7.21181147075525
31060,"Los Alamos, NM",2002,157,6,163,18060,9.02547065337763
31060,"Los Alamos, NM",2003,93,17,110,18408,5.97566275532377
31060,"Los Alamos, NM",2004,105,0,105,18416,5.7015638575152
31060,"Los Alamos, NM",2005,61,4,65,18407,3.53126527951323
31060,"Los Alamos, NM",2006,44,0,44,18477,2.3813389619527
31060,"Los Alamos, NM",2007,18,0,18,18281,0.984628849625294
31060,"Los Alamos, NM",2008,6,0,6,17924,0.334746708324035
31060,"Los Alamos, NM",2009,3,0,3,17742,0.169090294217112
31060,"Los Alamos, NM",2010,2,0,2,17994,0.111148160497944
31060,"Los Alamos, NM",2011,7,0,7,18229,0.384003510889242
31060,"Los Alamos, NM",2012,1,2,3,18238,0.164491720583397
31060,"Los Alamos, NM",2013,4,2,6,17950,0.334261838440111
31060,"Los Alamos, NM",2014,3,0,3,17807,0.168473072387263
31060,"Los Alamos, NM",2015,9,0,9,17830,0.504767246214246
31060,"Los Alamos, NM",2016,4,0,4,18239,0.219310269203355
31060,"Los Alamos, NM",2017,16,8,24,18804,1.27632418634333
31060,"Los Alamos, NM",2018,8,3,11,19101,0.575886079262866
31080,"Los Angeles-Long Beach-Anaheim, CA",1990,13389,23719,37108,11293182,3.2858763809881
31080,"Los Angeles-Long Beach-Anaheim, CA",1991,10986,11483,22469,11380626,1.97432021753461
31080,"Los Angeles-Long Beach-Anaheim, CA",1992,10501,7285,17786,11515482,1.544529356218
31080,"Los Angeles-Long Beach-Anaheim, CA",1993,8964,4812,13776,11579172,1.1897223739314
31080,"Los Angeles-Long Beach-Anaheim, CA",1994,12636,7758,20394,11592933,1.75917518025852
31080,"Los Angeles-Long Beach-Anaheim, CA",1995,10781,5175,15956,11605688,1.37484309417934
31080,"Los Angeles-Long Beach-Anaheim, CA",1996,11675,6229,17904,11666804,1.5346105068706
31080,"Los Angeles-Long Beach-Anaheim, CA",1997,14559,7531,22090,11793547,1.87305820717041
31080,"Los Angeles-Long Beach-Anaheim, CA",1998,13708,7222,20930,11945813,1.75207832233771
31080,"Los Angeles-Long Beach-Anaheim, CA",1999,15505,10794,26299,12093370,2.17466264573068
31080,"Los Angeles-Long Beach-Anaheim, CA",2000,15186,14302,29488,12392704,2.37946456237477
31080,"Los Angeles-Long Beach-Anaheim, CA",2001,14318,12587,26905,12511491,2.1504231589984
31080,"Los Angeles-Long Beach-Anaheim, CA",2002,15074,13176,28250,12614158,2.23954702327337
31080,"Los Angeles-Long Beach-Anaheim, CA",2003,16434,13717,30151,12696521,2.37474501873387
31080,"Los Angeles-Long Beach-Anaheim, CA",2004,17591,18194,35785,12734974,2.80997825358733
31080,"Los Angeles-Long Beach-Anaheim, CA",2005,16626,14015,30641,12726428,2.40766694315168
31080,"Los Angeles-Long Beach-Anaheim, CA",2006,13686,19819,33505,12670216,2.64439059286756
31080,"Los Angeles-Long Beach-Anaheim, CA",2007,9381,17235,26616,12631988,2.10703176728794
31080,"Los Angeles-Long Beach-Anaheim, CA",2008,4579,10466,15045,12692740,1.1853232635349
31080,"Los Angeles-Long Beach-Anaheim, CA",2009,3609,3672,7281,12774577,0.569960163847304
31080,"Los Angeles-Long Beach-Anaheim, CA",2010,4008,6386,10394,12838992,0.809565112276727
31080,"Los Angeles-Long Beach-Anaheim, CA",2011,4097,10150,14247,12927594,1.10206121881612
31080,"Los Angeles-Long Beach-Anaheim, CA",2012,4946,12501,17447,13018855,1.34013321448008
31080,"Los Angeles-Long Beach-Anaheim, CA",2013,7509,17689,25198,13106114,1.92261413261017
31080,"Los Angeles-Long Beach-Anaheim, CA",2014,8300,18650,26950,13178730,2.04496184381955
31080,"Los Angeles-Long Beach-Anaheim, CA",2015,8447,25587,34034,13250999,2.56841012515358
31080,"Los Angeles-Long Beach-Anaheim, CA",2016,9379,22735,32114,13291247,2.41617660103676
31080,"Los Angeles-Long Beach-Anaheim, CA",2017,10587,20497,31084,13298709,2.33736974017553
31080,"Los Angeles-Long Beach-Anaheim, CA",2018,10042,19482,29524,13291486,2.22127157189196
31140,"Louisville/Jefferson County, KY-IN",1990,3788,1150,4938,1018911,4.84635066261921
31140,"Louisville/Jefferson County, KY-IN",1991,4009,875,4884,1027207,4.75464049602466
31140,"Louisville/Jefferson County, KY-IN",1992,5100,921,6021,1035697,5.81347633526022
31140,"Louisville/Jefferson County, KY-IN",1993,5527,744,6271,1044621,6.00313415104617
31140,"Louisville/Jefferson County, KY-IN",1994,5444,1364,6808,1052373,6.46918915631625
31140,"Louisville/Jefferson County, KY-IN",1995,5025,1033,6058,1060448,5.71267992395667
31140,"Louisville/Jefferson County, KY-IN",1996,5600,1488,7088,1067002,6.64291163465486
31140,"Louisville/Jefferson County, KY-IN",1997,5518,1002,6520,1073968,6.07094438568002
31140,"Louisville/Jefferson County, KY-IN",1998,6634,1895,8529,1080688,7.89219460195727
31140,"Louisville/Jefferson County, KY-IN",1999,6654,2007,8661,1089594,7.94883231735858
31140,"Louisville/Jefferson County, KY-IN",2000,6158,1494,7652,1115859,6.8574972285925
31140,"Louisville/Jefferson County, KY-IN",2001,6404,1243,7647,1123755,6.80486404954817
31140,"Louisville/Jefferson County, KY-IN",2002,6175,1350,7525,1131709,6.64923580178297
31140,"Louisville/Jefferson County, KY-IN",2003,6819,1414,8233,1143073,7.20251462505019
31140,"Louisville/Jefferson County, KY-IN",2004,7155,1095,8250,1153078,7.1547631643306
31140,"Louisville/Jefferson County, KY-IN",2005,5988,628,6616,1163823,5.68471322529285
31140,"Louisville/Jefferson County, KY-IN",2006,4316,994,5310,1178334,4.50636237263798
31140,"Louisville/Jefferson County, KY-IN",2007,4159,1590,5749,1193817,4.815645949086
31140,"Louisville/Jefferson County, KY-IN",2008,2325,1056,3381,1207903,2.79906581902686
31140,"Louisville/Jefferson County, KY-IN",2009,1935,211,2146,1219110,1.76030054712044
31140,"Louisville/Jefferson County, KY-IN",2010,1764,443,2207,1228823,1.79602758086396
31140,"Louisville/Jefferson County, KY-IN",2011,1553,620,2173,1235828,1.75833530232362
31140,"Louisville/Jefferson County, KY-IN",2012,2206,1297,3503,1244214,2.81543207197476
31140,"Louisville/Jefferson County, KY-IN",2013,2355,1462,3817,1256253,3.03840070431673
31140,"Louisville/Jefferson County, KY-IN",2014,2390,1621,4011,1263345,3.17490471723876
31140,"Louisville/Jefferson County, KY-IN",2015,2734,1245,3979,1270227,3.13251096063932
31140,"Louisville/Jefferson County, KY-IN",2016,3127,2022,5149,1276565,4.03348047298806
31140,"Louisville/Jefferson County, KY-IN",2017,3446,2339,5785,1284244,4.50459569988258
31140,"Louisville/Jefferson County, KY-IN",2018,3104,2409,5513,1288786,4.27766906220272
31180,"Lubbock, TX",1990,397,59,456,236862,1.92517161891734
31180,"Lubbock, TX",1991,444,32,476,237916,2.00070613157585
31180,"Lubbock, TX",1992,631,4,635,238160,2.66627477326167
31180,"Lubbock, TX",1993,718,61,779,240685,3.23659555020047
31180,"Lubbock, TX",1994,732,102,834,243641,3.42306918786247
31180,"Lubbock, TX",1995,605,186,791,244878,3.23017992633066
31180,"Lubbock, TX",1996,840,309,1149,244820,4.69324401601176
31180,"Lubbock, TX",1997,669,619,1288,244058,5.27743405256128
31180,"Lubbock, TX",1998,742,150,892,242061,3.68502154415622
31180,"Lubbock, TX",1999,842,210,1052,241661,4.35320552343986
31180,"Lubbock, TX",2000,809,120,929,256651,3.61970146229705
31180,"Lubbock, TX",2001,983,747,1730,260015,6.65346230025191
31180,"Lubbock, TX",2002,1349,526,1875,262680,7.13796253997259
31180,"Lubbock, TX",2003,1366,1592,2958,266338,11.1061883771749
31180,"Lubbock, TX",2004,1397,2382,3779,268466,14.0762703657074
31180,"Lubbock, TX",2005,1294,490,1784,270478,6.59573052152116
31180,"Lubbock, TX",2006,1246,271,1517,274419,5.52804288332805
31180,"Lubbock, TX",2007,939,342,1281,277466,4.6167818759776
31180,"Lubbock, TX",2008,987,521,1508,280321,5.37954701931
31180,"Lubbock, TX",2009,790,245,1035,286236,3.61589737139982
31180,"Lubbock, TX",2010,897,555,1452,292244,4.96845102038023
31180,"Lubbock, TX",2011,695,815,1510,295323,5.1130457160465
31180,"Lubbock, TX",2012,756,715,1471,297802,4.93952357606732
31180,"Lubbock, TX",2013,1009,1039,2048,301196,6.79955909109019
31180,"Lubbock, TX",2014,975,1161,2136,306112,6.97783817687644
31180,"Lubbock, TX",2015,958,898,1856,310029,5.98653674333691
31180,"Lubbock, TX",2016,1279,1369,2648,313816,8.43806561806919
31180,"Lubbock, TX",2017,1613,775,2388,316588,7.5429264533084
31180,"Lubbock, TX",2018,1402,79,1481,319068,4.64164378753118
31220,"Ludington, MI",1990,106,24,130,25603,5.07752997695582
31220,"Ludington, MI",1991,117,42,159,25965,6.12362796071635
31220,"Ludington, MI",1992,136,42,178,26485,6.72078535019823
31220,"Ludington, MI",1993,121,86,207,26681,7.75832989768
31220,"Ludington, MI",1994,153,46,199,27101,7.3429024759234
31220,"Ludington, MI",1995,119,22,141,27373,5.15106126474994
31220,"Ludington, MI",1996,123,5,128,27640,4.63096960926194
31220,"Ludington, MI",1997,124,0,124,27769,4.46541106989809
31220,"Ludington, MI",1998,136,6,142,27907,5.08832909305909
31220,"Ludington, MI",1999,121,52,173,28018,6.17460204154472
31220,"Ludington, MI",2000,145,46,191,28350,6.73721340388007
31220,"Ludington, MI",2001,144,4,148,28475,5.19754170324846
31220,"Ludington, MI",2002,147,0,147,28624,5.13555058692007
31220,"Ludington, MI",2003,161,0,161,28735,5.60292326431181
31220,"Ludington, MI",2004,178,0,178,28842,6.17155537064004
31220,"Ludington, MI",2005,159,157,316,28748,10.9920690134966
31220,"Ludington, MI",2006,140,18,158,28846,5.47736254593358
31220,"Ludington, MI",2007,87,0,87,28685,3.03294404741154
31220,"Ludington, MI",2008,54,0,54,28668,1.88363331938049
31220,"Ludington, MI",2009,34,0,34,28656,1.18648799553322
31220,"Ludington, MI",2010,37,2,39,28720,1.35793871866295
31220,"Ludington, MI",2011,36,6,42,28641,1.46642924478894
31220,"Ludington, MI",2012,42,4,46,28659,1.60508042848669
31220,"Ludington, MI",2013,43,5,48,28667,1.67439913489378
31220,"Ludington, MI",2014,42,4,46,28732,1.60100236669915
31220,"Ludington, MI",2015,44,5,49,28741,1.70488152813055
31220,"Ludington, MI",2016,50,0,50,28822,1.73478592741656
31220,"Ludington, MI",2017,76,92,168,29023,5.78851255900493
31220,"Ludington, MI",2018,74,0,74,29100,2.54295532646048
31260,"Lufkin, TX",1990,64,0,64,69983,0.914507809039338
31260,"Lufkin, TX",1991,92,0,92,70648,1.30223077794134
31260,"Lufkin, TX",1992,120,103,223,71794,3.10610914561105
31260,"Lufkin, TX",1993,146,0,146,73030,1.99917841982747
31260,"Lufkin, TX",1994,121,0,121,74072,1.6335457392807
31260,"Lufkin, TX",1995,119,0,119,74665,1.59378557557088
31260,"Lufkin, TX",1996,136,8,144,75371,1.91054915020366
31260,"Lufkin, TX",1997,137,2,139,76311,1.82149362477231
31260,"Lufkin, TX",1998,152,20,172,77242,2.22676782061573
31260,"Lufkin, TX",1999,159,12,171,77357,2.21053039802474
31260,"Lufkin, TX",2000,132,9,141,80270,1.75657157094805
31260,"Lufkin, TX",2001,144,9,153,80273,1.90599578936878
31260,"Lufkin, TX",2002,156,12,168,80803,2.07913072534436
31260,"Lufkin, TX",2003,166,15,181,81510,2.22058643111275
31260,"Lufkin, TX",2004,107,0,107,82070,1.30376507859145
31260,"Lufkin, TX",2005,104,0,104,82553,1.25979673664191
31260,"Lufkin, TX",2006,128,57,185,83810,2.20737382173965
31260,"Lufkin, TX",2007,119,0,119,84518,1.40798409806195
31260,"Lufkin, TX",2008,71,0,71,84961,0.835677546168242
31260,"Lufkin, TX",2009,52,0,52,86029,0.604447337525718
31260,"Lufkin, TX",2010,43,80,123,86905,1.41533858811346
31260,"Lufkin, TX",2011,120,288,408,87295,4.67380720545277
31260,"Lufkin, TX",2012,55,2,57,87520,0.65127970749543
31260,"Lufkin, TX",2013,59,7,66,87333,0.755728075297997
31260,"Lufkin, TX",2014,66,10,76,87599,0.867589812669094
31260,"Lufkin, TX",2015,54,0,54,87874,0.614516239160616
31260,"Lufkin, TX",2016,60,4,64,87759,0.729269932428583
31260,"Lufkin, TX",2017,47,6,53,87711,0.604257162727594
31260,"Lufkin, TX",2018,93,0,93,87092,1.06783631102742
31300,"Lumberton, NC",1990,148,14,162,105404,1.536943569504
31300,"Lumberton, NC",1991,154,20,174,106204,1.63835637075816
31300,"Lumberton, NC",1992,192,7,199,107629,1.84894405782828
31300,"Lumberton, NC",1993,181,93,274,109157,2.51014593658675
31300,"Lumberton, NC",1994,214,16,230,110437,2.08263534866032
31300,"Lumberton, NC",1995,176,64,240,111791,2.14686334320294
31300,"Lumberton, NC",1996,187,101,288,113062,2.54727494648954
31300,"Lumberton, NC",1997,192,0,192,114399,1.67833634909396
31300,"Lumberton, NC",1998,194,74,268,115726,2.31581494219104
31300,"Lumberton, NC",1999,231,84,315,116679,2.69971460159926
31300,"Lumberton, NC",2000,401,12,413,123334,3.34863054794298
31300,"Lumberton, NC",2001,232,30,262,123913,2.11438670680235
31300,"Lumberton, NC",2002,262,57,319,124676,2.55863197407681
31300,"Lumberton, NC",2003,301,5,306,125665,2.43504555763339
31300,"Lumberton, NC",2004,328,0,328,126117,2.60075961210622
31300,"Lumberton, NC",2005,391,0,391,127885,3.05743441373109
31300,"Lumberton, NC",2006,311,0,311,128894,2.41283535308083
31300,"Lumberton, NC",2007,243,0,243,130453,1.86273983733605
31300,"Lumberton, NC",2008,157,0,157,131734,1.19179558807901
31300,"Lumberton, NC",2009,108,0,108,132984,0.812127774769897
31300,"Lumberton, NC",2010,158,48,206,134496,1.53164406376398
31300,"Lumberton, NC",2011,93,12,105,135176,0.776765106231876
31300,"Lumberton, NC",2012,113,7,120,135460,0.885870367636203
31300,"Lumberton, NC",2013,96,6,102,135140,0.754772828178186
31300,"Lumberton, NC",2014,124,16,140,134945,1.03745970580607
31300,"Lumberton, NC",2015,97,8,105,134461,0.780895575668781
31300,"Lumberton, NC",2016,85,0,85,133384,0.637257842020032
31300,"Lumberton, NC",2017,115,8,123,132590,0.92767177011841
31300,"Lumberton, NC",2018,102,4,106,131831,0.80405974315601
31340,"Lynchburg, VA",1990,806,63,869,200461,4.33500780700485
31340,"Lynchburg, VA",1991,815,48,863,202072,4.27075497842353
31340,"Lynchburg, VA",1992,1014,20,1034,205290,5.03677724195041
31340,"Lynchburg, VA",1993,1111,58,1169,206638,5.65723632632914
31340,"Lynchburg, VA",1994,1023,88,1111,208878,5.31889428278708
31340,"Lynchburg, VA",1995,1053,104,1157,210265,5.50258007752122
31340,"Lynchburg, VA",1996,1145,60,1205,211953,5.68522266728945
31340,"Lynchburg, VA",1997,1093,90,1183,213562,5.5393749824407
31340,"Lynchburg, VA",1998,1096,113,1209,214164,5.6452064772791
31340,"Lynchburg, VA",1999,1112,83,1195,215115,5.55516816586477
31340,"Lynchburg, VA",2000,965,225,1190,222430,5.34999775210178
31340,"Lynchburg, VA",2001,1039,186,1225,223099,5.49083590692921
31340,"Lynchburg, VA",2002,1190,245,1435,224036,6.40522058954811
31340,"Lynchburg, VA",2003,1382,20,1402,226397,6.19266156353662
31340,"Lynchburg, VA",2004,1410,40,1450,228376,6.34917854765825
31340,"Lynchburg, VA",2005,1769,67,1836,232329,7.90258641839805
31340,"Lynchburg, VA",2006,1808,12,1820,237066,7.67718694372031
31340,"Lynchburg, VA",2007,1426,280,1706,240658,7.0888979381529
31340,"Lynchburg, VA",2008,887,8,895,243149,3.68087057730034
31340,"Lynchburg, VA",2009,640,32,672,245267,2.73987124236037
31340,"Lynchburg, VA",2010,593,106,699,252981,2.76305335183275
31340,"Lynchburg, VA",2011,418,110,528,254176,2.0773007679718
31340,"Lynchburg, VA",2012,545,348,893,255731,3.49195052613879
31340,"Lynchburg, VA",2013,687,302,989,256846,3.85055636451414
31340,"Lynchburg, VA",2014,576,345,921,257974,3.57012722212316
31340,"Lynchburg, VA",2015,591,206,797,259475,3.07158685807881
31340,"Lynchburg, VA",2016,564,99,663,260583,2.54429490795639
31340,"Lynchburg, VA",2017,492,278,770,261954,2.93944738389183
31340,"Lynchburg, VA",2018,271,159,430,263353,1.63278944990184
31380,"Macomb, IL",1990,10,0,10,35234,0.283816767894647
31380,"Macomb, IL",1991,16,88,104,35255,2.94993617926535
31380,"Macomb, IL",1992,22,48,70,35049,1.99720391451967
31380,"Macomb, IL",1993,30,12,42,35163,1.1944373346984
31380,"Macomb, IL",1994,27,18,45,35348,1.27305646712685
31380,"Macomb, IL",1995,19,0,19,34055,0.557921010130671
31380,"Macomb, IL",1996,12,10,22,34093,0.64529375531634
31380,"Macomb, IL",1997,21,0,21,34060,0.616559013505578
31380,"Macomb, IL",1998,18,17,35,34114,1.0259717418068801
31380,"Macomb, IL",1999,19,20,39,34032,1.1459802538787
31380,"Macomb, IL",2000,19,133,152,32841,4.62836089035048
31380,"Macomb, IL",2001,12,92,104,32789,3.17179541919546
31380,"Macomb, IL",2002,8,74,82,32802,2.49984757027011
31380,"Macomb, IL",2003,8,230,238,32971,7.21846471141306
31380,"Macomb, IL",2004,7,57,64,32798,1.95133849624977
31380,"Macomb, IL",2005,12,31,43,32848,1.30905991232343
31380,"Macomb, IL",2006,12,202,214,32868,6.51089205306073
31380,"Macomb, IL",2007,14,86,100,32945,3.03536196691455
31380,"Macomb, IL",2008,59,17,76,32615,2.33021615820941
31380,"Macomb, IL",2009,5,10,15,32611,0.459967495630309
31380,"Macomb, IL",2010,4,5,9,32628,0.275836704670835
31380,"Macomb, IL",2011,2,17,19,32511,0.584417581741564
31380,"Macomb, IL",2012,4,41,45,32550,1.38248847926267
31380,"Macomb, IL",2013,9,0,9,32246,0.279104385040005
31380,"Macomb, IL",2014,2,6,8,31792,0.251635631605435
31380,"Macomb, IL",2015,4,0,4,31430,0.127266942411709
31380,"Macomb, IL",2016,1,0,1,30875,0.0323886639676113
31380,"Macomb, IL",2017,1,0,1,30323,0.0329782673218349
31380,"Macomb, IL",2018,1,0,1,29955,0.0333834084460023
31420,"Macon, GA",1990,695,252,947,207127,4.57207413808919
31420,"Macon, GA",1991,536,196,732,209035,3.50180591766929
31420,"Macon, GA",1992,830,156,986,210122,4.69251196923692
31420,"Macon, GA",1993,1015,96,1111,212608,5.22557947019868
31420,"Macon, GA",1994,952,221,1173,214216,5.47578145423311
31420,"Macon, GA",1995,1166,336,1502,215439,6.97181104628224
31420,"Macon, GA",1996,1203,390,1593,216814,7.34731152047377
31420,"Macon, GA",1997,939,177,1116,218610,5.10498147385755
31420,"Macon, GA",1998,875,98,973,219146,4.43996239949623
31420,"Macon, GA",1999,1224,41,1265,219109,5.7733821979015
31420,"Macon, GA",2000,995,303,1298,222407,5.83614724356697
31420,"Macon, GA",2001,916,170,1086,222869,4.87281766418838
31420,"Macon, GA",2002,950,90,1040,224661,4.62919687885303
31420,"Macon, GA",2003,1188,683,1871,225987,8.27923730126069
31420,"Macon, GA",2004,1318,237,1555,227394,6.83835105587658
31420,"Macon, GA",2005,1251,8,1259,228125,5.51890410958904
31420,"Macon, GA",2006,1571,6,1577,229655,6.86682197208857
31420,"Macon, GA",2007,1262,351,1613,230452,6.99928835505875
31420,"Macon, GA",2008,578,316,894,231314,3.86487631531165
31420,"Macon, GA",2009,302,2,304,232065,1.30997780794174
31420,"Macon, GA",2010,350,18,368,232227,1.58465639223691
31420,"Macon, GA",2011,174,222,396,232682,1.70189357148383
31420,"Macon, GA",2012,167,338,505,232771,2.16951424361282
31420,"Macon, GA",2013,173,275,448,231264,1.9371800193718
31420,"Macon, GA",2014,218,0,218,230482,0.945843927074565
31420,"Macon, GA",2015,245,72,317,229849,1.37916632223764
31420,"Macon, GA",2016,236,0,236,229231,1.02952916490353
31420,"Macon, GA",2017,320,0,320,229081,1.39688581768021
31420,"Macon, GA",2018,391,6,397,229737,1.72806295894871
31460,"Madera, CA",1990,1364,194,1558,89017,17.5022748463777
31460,"Madera, CA",1991,1084,46,1130,94400,11.9703389830508
31460,"Madera, CA",1992,837,206,1043,98457,10.5934570421605
31460,"Madera, CA",1993,692,107,799,102414,7.80166774073857
31460,"Madera, CA",1994,563,123,686,105209,6.52035472250473
31460,"Madera, CA",1995,602,258,860,106559,8.07064630861776
31460,"Madera, CA",1996,518,102,620,109774,5.64796764261118
31460,"Madera, CA",1997,457,45,502,112432,4.464921018927
31460,"Madera, CA",1998,474,160,634,114488,5.53769827405492
31460,"Madera, CA",1999,481,126,607,116559,5.20766307192066
31460,"Madera, CA",2000,549,99,648,123587,5.24326992321199
31460,"Madera, CA",2001,713,76,789,125581,6.28279755695527
31460,"Madera, CA",2002,909,72,981,128369,7.64203195475543
31460,"Madera, CA",2003,1139,88,1227,132738,9.24377344844732
31460,"Madera, CA",2004,1463,213,1676,137106,12.2241185651977
31460,"Madera, CA",2005,2135,133,2268,140313,16.1638622223172
31460,"Madera, CA",2006,1269,107,1376,143622,9.58070490593363
31460,"Madera, CA",2007,486,23,509,146067,3.48470222569095
31460,"Madera, CA",2008,233,7,240,148359,1.6176976118739
31460,"Madera, CA",2009,68,52,120,149234,0.804106302853237
31460,"Madera, CA",2010,112,80,192,151006,1.27147265671563
31460,"Madera, CA",2011,112,179,291,151702,1.91823443329686
31460,"Madera, CA",2012,115,42,157,151594,1.03566104199375
31460,"Madera, CA",2013,215,4,219,151470,1.44583085759556
31460,"Madera, CA",2014,210,4,214,153590,1.3933198775962
31460,"Madera, CA",2015,211,0,211,153739,1.37245591554518
31460,"Madera, CA",2016,300,0,300,154160,1.94603009859886
31460,"Madera, CA",2017,415,0,415,155904,2.66189449917898
31460,"Madera, CA",2018,503,0,503,157672,3.19016692881425
31500,"Madison, IN",1990,72,6,78,29833,2.6145543525626
31500,"Madison, IN",1991,71,4,75,29983,2.50141746989961
31500,"Madison, IN",1992,128,40,168,30297,5.54510347559164
31500,"Madison, IN",1993,123,0,123,30500,4.0327868852459
31500,"Madison, IN",1994,132,2,134,30694,4.36567407310875
31500,"Madison, IN",1995,172,22,194,30818,6.29502238951262
31500,"Madison, IN",1996,206,8,214,31032,6.89610724413509
31500,"Madison, IN",1997,182,32,214,31371,6.82158681584903
31500,"Madison, IN",1998,204,14,218,31440,6.93384223918575
31500,"Madison, IN",1999,180,52,232,31711,7.31607328687206
31500,"Madison, IN",2000,153,16,169,31706,5.330221409197
31500,"Madison, IN",2001,156,27,183,31887,5.73901589989651
31500,"Madison, IN",2002,60,35,95,31871,2.98076621379938
31500,"Madison, IN",2003,103,22,125,31779,3.93341514836842
31500,"Madison, IN",2004,142,0,142,31787,4.46723503318967
31500,"Madison, IN",2005,130,0,130,31998,4.06275392212013
31500,"Madison, IN",2006,101,2,103,32287,3.1901384458141
31500,"Madison, IN",2007,64,0,64,32140,1.99128811449907
31500,"Madison, IN",2008,45,0,45,32586,1.38096114895968
31500,"Madison, IN",2009,55,0,55,32558,1.68929295411266
31500,"Madison, IN",2010,37,0,37,32401,1.14194006357828
31500,"Madison, IN",2011,40,4,44,32275,1.36328427575523
31500,"Madison, IN",2012,46,0,46,32442,1.41791504839406
31500,"Madison, IN",2013,31,0,31,32396,0.956908260279047
31500,"Madison, IN",2014,27,2,29,32403,0.8949788599821
31500,"Madison, IN",2015,46,0,46,32298,1.42423679484798
31500,"Madison, IN",2016,33,0,33,32230,1.02389078498294
31500,"Madison, IN",2017,37,0,37,32047,1.15455424844759
31500,"Madison, IN",2018,45,2,47,32208,1.45926477893691
31540,"Madison, WI",1990,1898,1296,3194,464306,6.87908405232756
31540,"Madison, WI",1991,2062,1271,3333,474737,7.02072937226296
31540,"Madison, WI",1992,2672,1352,4024,484815,8.30007322380702
31540,"Madison, WI",1993,2772,1807,4579,496075,9.23045910396614
31540,"Madison, WI",1994,2510,2107,4617,504584,9.15011177524456
31540,"Madison, WI",1995,2066,2129,4195,512480,8.1856852950359
31540,"Madison, WI",1996,2346,1469,3815,519600,7.34218629715166
31540,"Madison, WI",1997,2097,1619,3716,527774,7.04089250323055
31540,"Madison, WI",1998,2343,1974,4317,531636,8.12021759248809
31540,"Madison, WI",1999,2488,1984,4472,536548,8.33476222071464
31540,"Madison, WI",2000,2609,2167,4776,537485,8.88582937198247
31540,"Madison, WI",2001,2967,2729,5696,544773,10.4557311026795
31540,"Madison, WI",2002,3138,2063,5201,552305,9.41689827178823
31540,"Madison, WI",2003,3498,2932,6430,559138,11.4998444033494
31540,"Madison, WI",2004,3446,2130,5576,566363,9.8452759096198
31540,"Madison, WI",2005,3083,2308,5391,573036,9.40778589826817
31540,"Madison, WI",2006,2070,1839,3909,580296,6.73621737871707
31540,"Madison, WI",2007,1598,1149,2747,587711,4.67406599502136
31540,"Madison, WI",2008,864,1104,1968,594452,3.31061212679914
31540,"Madison, WI",2009,822,652,1474,601715,2.44966470837523
31540,"Madison, WI",2010,844,408,1252,606603,2.06395286538313
31540,"Madison, WI",2011,735,725,1460,613078,2.38142618068174
31540,"Madison, WI",2012,895,1577,2472,619693,3.98907200823634
31540,"Madison, WI",2013,1251,1756,3007,626853,4.79697791986319
31540,"Madison, WI",2014,1243,2562,3805,633417,6.0071011671616
31540,"Madison, WI",2015,1406,2092,3498,640028,5.46538588936734
31540,"Madison, WI",2016,1613,3340,4953,647958,7.64401396386803
31540,"Madison, WI",2017,1656,2976,4632,654577,7.07632562708436
31540,"Madison, WI",2018,1623,2029,3652,660422,5.5297976142527
31580,"Madisonville, KY",1990,53,9,62,46095,1.34504826987743
31580,"Madisonville, KY",1991,48,2,50,46251,1.08105770686039
31580,"Madisonville, KY",1992,58,0,58,46331,1.25186160454124
31580,"Madisonville, KY",1993,76,0,76,46183,1.64562717883204
31580,"Madisonville, KY",1994,81,0,81,46132,1.7558310933842
31580,"Madisonville, KY",1995,63,0,63,46493,1.35504269459919
31580,"Madisonville, KY",1996,74,4,78,46466,1.67864675246417
31580,"Madisonville, KY",1997,64,36,100,46219,2.16361236720829
31580,"Madisonville, KY",1998,84,40,124,46393,2.67281701980902
31580,"Madisonville, KY",1999,51,0,51,46139,1.10535555603719
31580,"Madisonville, KY",2000,36,4,40,46463,0.860900071024256
31580,"Madisonville, KY",2001,36,20,56,46148,1.21348704169195
31580,"Madisonville, KY",2002,121,10,131,46374,2.82485875706215
31580,"Madisonville, KY",2003,139,10,149,46668,3.19276592097369
31580,"Madisonville, KY",2004,151,10,161,46759,3.44318740777177
31580,"Madisonville, KY",2005,159,10,169,46640,3.62349914236707
31580,"Madisonville, KY",2006,166,10,176,46727,3.76655894878764
31580,"Madisonville, KY",2007,93,20,113,46834,2.41277704231968
31580,"Madisonville, KY",2008,69,6,75,47051,1.59401500499458
31580,"Madisonville, KY",2009,50,8,58,46921,1.2361202872914001
31580,"Madisonville, KY",2010,80,2,82,46840,1.75064047822374
31580,"Madisonville, KY",2011,55,0,55,46846,1.17405968492507
31580,"Madisonville, KY",2012,58,2,60,46621,1.28697368138822
31580,"Madisonville, KY",2013,75,2,77,46442,1.65798199905258
31580,"Madisonville, KY",2014,65,6,71,46177,1.53756198973515
31580,"Madisonville, KY",2015,74,4,78,46077,1.69281854287389
31580,"Madisonville, KY",2016,51,6,57,45628,1.24923292715
31580,"Madisonville, KY",2017,62,4,66,45369,1.45473781657079
31580,"Madisonville, KY",2018,63,10,73,45068,1.61977456288276
31620,"Magnolia, AR",1990,23,0,23,25670,0.895987534086482
31620,"Magnolia, AR",1991,14,4,18,25771,0.698459508750146
31620,"Magnolia, AR",1992,12,0,12,25691,0.467089642287182
31620,"Magnolia, AR",1993,36,8,44,25567,1.72096843587437
31620,"Magnolia, AR",1994,21,2,23,25479,0.902704187762471
31620,"Magnolia, AR",1995,14,0,14,25526,0.548460393324454
31620,"Magnolia, AR",1996,24,0,24,25336,0.947268708556994
31620,"Magnolia, AR",1997,15,0,15,25311,0.592627711271779
31620,"Magnolia, AR",1998,14,0,14,25180,0.555996822875298
31620,"Magnolia, AR",1999,10,0,10,24843,0.402527875055348
31620,"Magnolia, AR",2000,12,0,12,25599,0.468768311262159
31620,"Magnolia, AR",2001,13,0,13,25424,0.511327879169289
31620,"Magnolia, AR",2002,3,0,3,25362,0.118287201324817
31620,"Magnolia, AR",2003,11,82,93,25106,3.70429379431212
31620,"Magnolia, AR",2004,9,0,9,25154,0.357795976783017
31620,"Magnolia, AR",2005,6,0,6,25025,0.23976023976024
31620,"Magnolia, AR",2006,9,0,9,25133,0.358094934946087
31620,"Magnolia, AR",2007,9,0,9,24847,0.362216766611663
31620,"Magnolia, AR",2008,8,0,8,24666,0.324333090083516
31620,"Magnolia, AR",2009,9,0,9,24622,0.365526764681992
31620,"Magnolia, AR",2010,8,0,8,24725,0.32355915065723
31620,"Magnolia, AR",2011,3,0,3,24703,0.121442739748209
31620,"Magnolia, AR",2012,8,2,10,24407,0.409718523374442
31620,"Magnolia, AR",2013,4,2,6,24282,0.247096614776378
31620,"Magnolia, AR",2014,9,40,49,24046,2.03776095816352
31620,"Magnolia, AR",2015,0,0,0,24126,0
31620,"Magnolia, AR",2016,0,0,0,24049,0
31620,"Magnolia, AR",2017,12,6,18,23700,0.759493670886076
31620,"Magnolia, AR",2018,14,5,19,23537,0.80723966520797
31660,"Malone, NY",1990,168,0,168,46642,3.60190386347069
31660,"Malone, NY",1991,138,59,197,47751,4.12556805093087
31660,"Malone, NY",1992,140,11,151,48454,3.1163577826392
31660,"Malone, NY",1993,115,12,127,48988,2.59247162570425
31660,"Malone, NY",1994,114,3,117,49236,2.37631001706069
31660,"Malone, NY",1995,94,2,96,49375,1.94430379746835
31660,"Malone, NY",1996,96,8,104,49475,2.10207175341081
31660,"Malone, NY",1997,122,0,122,49108,2.4843202736825
31660,"Malone, NY",1998,110,22,132,48705,2.71019402525408
31660,"Malone, NY",1999,92,14,106,50008,2.11966085426332
31660,"Malone, NY",2000,93,0,93,51044,1.82195752683959
31660,"Malone, NY",2001,121,0,121,50925,2.37604320078547
31660,"Malone, NY",2002,109,2,111,50924,2.17971879663813
31660,"Malone, NY",2003,124,0,124,51228,2.42055126102912
31660,"Malone, NY",2004,176,0,176,51197,3.43770142781804
31660,"Malone, NY",2005,165,0,165,51257,3.21907251692452
31660,"Malone, NY",2006,144,8,152,51511,2.95082603715711
31660,"Malone, NY",2007,119,2,121,51782,2.33671932331698
31660,"Malone, NY",2008,86,0,86,51907,1.65680929354422
31660,"Malone, NY",2009,71,0,71,51706,1.37314818396318
31660,"Malone, NY",2010,68,0,68,51652,1.31650274916751
31660,"Malone, NY",2011,57,0,57,51541,1.10591567878
31660,"Malone, NY",2012,62,0,62,51789,1.19716542122845
31660,"Malone, NY",2013,49,6,55,51213,1.07394606838108
31660,"Malone, NY",2014,55,2,57,51102,1.11541622637079
31660,"Malone, NY",2015,56,2,58,50542,1.1475604447786
31660,"Malone, NY",2016,72,0,72,51077,1.40963643127043
31660,"Malone, NY",2017,107,0,107,50444,2.1211640631195
31660,"Malone, NY",2018,94,23,117,50293,2.32636748652894
31680,"Malvern, AR",1990,7,0,7,26100,0.268199233716475
31680,"Malvern, AR",1991,5,2,7,26150,0.267686424474187
31680,"Malvern, AR",1992,10,2,12,26452,0.453651897777106
31680,"Malvern, AR",1993,15,4,19,27129,0.700357550960227
31680,"Malvern, AR",1994,9,6,15,27524,0.544978927481471
31680,"Malvern, AR",1995,8,5,13,27880,0.466284074605452
31680,"Malvern, AR",1996,9,5,14,28404,0.492888325587945
31680,"Malvern, AR",1997,9,5,14,28688,0.488008923591746
31680,"Malvern, AR",1998,9,5,14,28938,0.483792936623125
31680,"Malvern, AR",1999,10,6,16,29238,0.547233052876394
31680,"Malvern, AR",2000,5,2,7,30480,0.229658792650919
31680,"Malvern, AR",2001,9,8,17,30615,0.555283357831129
31680,"Malvern, AR",2002,3,28,31,30877,1.00398354762445
31680,"Malvern, AR",2003,7,0,7,30821,0.227117874176698
31680,"Malvern, AR",2004,1,0,1,31071,0.0321843519680731
31680,"Malvern, AR",2005,0,3,3,31565,0.095041976873119
31680,"Malvern, AR",2006,6,6,12,32248,0.37211610022327
31680,"Malvern, AR",2007,4,12,16,32631,0.490331280071098
31680,"Malvern, AR",2008,8,0,8,32737,0.244371811711519
31680,"Malvern, AR",2009,2,0,2,32797,0.0609811873037168
31680,"Malvern, AR",2010,2,0,2,33229,0.0601883896596347
31680,"Malvern, AR",2011,3,0,3,33136,0.0905359729599227
31680,"Malvern, AR",2012,1,0,1,33497,0.0298534197092277
31680,"Malvern, AR",2013,0,2,2,33516,0.0596729920038191
31680,"Malvern, AR",2014,0,0,0,33400,0
31680,"Malvern, AR",2015,0,0,0,33480,0
31680,"Malvern, AR",2016,0,0,0,33419,0
31680,"Malvern, AR",2017,9,0,9,33600,0.267857142857143
31680,"Malvern, AR",2018,10,0,10,33701,0.296727100086051
31700,"Manchester-Nashua, NH",1990,875,327,1202,336557,3.57146040640961
31700,"Manchester-Nashua, NH",1991,1075,12,1087,336010,3.23502276717955
31700,"Manchester-Nashua, NH",1992,1127,16,1143,339154,3.37015043313657
31700,"Manchester-Nashua, NH",1993,1180,28,1208,342140,3.5307184193605
31700,"Manchester-Nashua, NH",1994,1311,116,1427,345486,4.13041338867566
31700,"Manchester-Nashua, NH",1995,1178,152,1330,349027,3.81059344979042
31700,"Manchester-Nashua, NH",1996,1269,439,1708,353052,4.8378142596558
31700,"Manchester-Nashua, NH",1997,1336,416,1752,357712,4.89779487408865
31700,"Manchester-Nashua, NH",1998,1547,127,1674,363032,4.61116375415941
31700,"Manchester-Nashua, NH",1999,1532,266,1798,367813,4.88835359272239
31700,"Manchester-Nashua, NH",2000,1565,278,1843,382162,4.82256215950304
31700,"Manchester-Nashua, NH",2001,1475,403,1878,387414,4.8475274512537
31700,"Manchester-Nashua, NH",2002,1605,821,2426,389665,6.22586067519536
31700,"Manchester-Nashua, NH",2003,1521,530,2051,391461,5.23934695921177
31700,"Manchester-Nashua, NH",2004,1570,590,2160,394428,5.47628464510633
31700,"Manchester-Nashua, NH",2005,1518,344,1862,396381,4.69750063701338
31700,"Manchester-Nashua, NH",2006,1085,261,1346,398169,3.38047412028561
31700,"Manchester-Nashua, NH",2007,697,274,971,398843,2.43454191248185
31700,"Manchester-Nashua, NH",2008,409,281,690,399556,1.72691687773429
31700,"Manchester-Nashua, NH",2009,321,192,513,400148,1.28202565050931
31700,"Manchester-Nashua, NH",2010,367,315,682,401049,1.70054033297677
31700,"Manchester-Nashua, NH",2011,334,368,702,402492,1.74413404490027
31700,"Manchester-Nashua, NH",2012,365,255,620,404106,1.53425091436405
31700,"Manchester-Nashua, NH",2013,468,99,567,405065,1.39977534469776
31700,"Manchester-Nashua, NH",2014,464,504,968,407071,2.37796354935625
31700,"Manchester-Nashua, NH",2015,557,364,921,408811,2.25287480033561
31700,"Manchester-Nashua, NH",2016,701,396,1097,411150,2.66812598808221
31700,"Manchester-Nashua, NH",2017,717,316,1033,413157,2.50026019164628
31700,"Manchester-Nashua, NH",2018,709,697,1406,415247,3.38593656305765
31740,"Manhattan, KS",1990,170,183,353,83387,4.23327377169103
31740,"Manhattan, KS",1991,183,45,228,81531,2.79648231960849
31740,"Manhattan, KS",1992,240,66,306,85185,3.59218172213418
31740,"Manhattan, KS",1993,254,328,582,84886,6.85625427043329
31740,"Manhattan, KS",1994,261,58,319,86272,3.69760756676558
31740,"Manhattan, KS",1995,216,80,296,86729,3.41292993116489
31740,"Manhattan, KS",1996,213,357,570,84014,6.78458352179399
31740,"Manhattan, KS",1997,152,112,264,82977,3.18160454101739
31740,"Manhattan, KS",1998,205,64,269,82607,3.2563826310119
31740,"Manhattan, KS",1999,223,47,270,82677,3.26572081715592
31740,"Manhattan, KS",2000,189,75,264,81539,3.23771446792332
31740,"Manhattan, KS",2001,245,64,309,81374,3.79728168702534
31740,"Manhattan, KS",2002,255,111,366,81205,4.5071116310572
31740,"Manhattan, KS",2003,325,387,712,81847,8.6991581853947
31740,"Manhattan, KS",2004,357,224,581,83411,6.96550814640755
31740,"Manhattan, KS",2005,524,149,673,84195,7.99334877368015
31740,"Manhattan, KS",2006,699,423,1122,86648,12.9489428492291
31740,"Manhattan, KS",2007,378,142,520,87724,5.92768227622999
31740,"Manhattan, KS",2008,383,229,612,90328,6.77530776724825
31740,"Manhattan, KS",2009,325,258,583,91201,6.3924737667350104
31740,"Manhattan, KS",2010,335,266,601,93281,6.44289833942604
31740,"Manhattan, KS",2011,292,288,580,95443,6.07692549479794
31740,"Manhattan, KS",2012,327,223,550,99827,5.5095314894768
31740,"Manhattan, KS",2013,355,71,426,99509,4.28101980725362
31740,"Manhattan, KS",2014,407,107,514,99223,5.18025054674823
31740,"Manhattan, KS",2015,340,156,496,100275,4.94639740713039
31740,"Manhattan, KS",2016,297,665,962,98775,9.73930650468236
31740,"Manhattan, KS",2017,304,77,381,97954,3.88958082365192
31740,"Manhattan, KS",2018,233,8,241,97980,2.45968565013268
31820,"Manitowoc, WI",1990,186,61,247,80476,3.06923803369949
31820,"Manitowoc, WI",1991,176,220,396,80836,4.89880746202187
31820,"Manitowoc, WI",1992,259,138,397,81389,4.87780904053373
31820,"Manitowoc, WI",1993,246,52,298,81616,3.65124485395021
31820,"Manitowoc, WI",1994,248,170,418,81837,5.10771411464252
31820,"Manitowoc, WI",1995,225,148,373,82192,4.53815456492116
31820,"Manitowoc, WI",1996,232,240,472,82211,5.74132415370206
31820,"Manitowoc, WI",1997,296,151,447,82036,5.44882734409284
31820,"Manitowoc, WI",1998,340,68,408,82291,4.95801484974055
31820,"Manitowoc, WI",1999,358,44,402,82410,4.8780487804878
31820,"Manitowoc, WI",2000,369,99,468,82936,5.64290537281759
31820,"Manitowoc, WI",2001,344,280,624,82788,7.53732424989129
31820,"Manitowoc, WI",2002,170,84,254,82338,3.08484539337851
31820,"Manitowoc, WI",2003,249,50,299,82010,3.64589684184855
31820,"Manitowoc, WI",2004,242,42,284,81846,3.4699313344574
31820,"Manitowoc, WI",2005,259,22,281,81827,3.4340743275447
31820,"Manitowoc, WI",2006,190,12,202,81869,2.46735638642221
31820,"Manitowoc, WI",2007,139,26,165,81872,2.01534102012898
31820,"Manitowoc, WI",2008,117,32,149,81698,1.82379005606012
31820,"Manitowoc, WI",2009,83,22,105,81600,1.28676470588235
31820,"Manitowoc, WI",2010,78,10,88,81329,1.08202486198035
31820,"Manitowoc, WI",2011,58,36,94,81029,1.16007849041701
31820,"Manitowoc, WI",2012,50,74,124,80723,1.53611733954387
31820,"Manitowoc, WI",2013,63,6,69,80492,0.857228047507827
31820,"Manitowoc, WI",2014,64,56,120,79959,1.5007691441864
31820,"Manitowoc, WI",2015,65,52,117,79495,1.47179067865904
31820,"Manitowoc, WI",2016,90,64,154,79365,1.94040194040194
31820,"Manitowoc, WI",2017,82,68,150,79140,1.89537528430629
31820,"Manitowoc, WI",2018,95,54,149,79074,1.8843108986519
31860,"Mankato-North Mankato, MN",1990,188,218,406,82237,4.936950521055
31860,"Mankato-North Mankato, MN",1991,187,112,299,82525,3.62314450166616
31860,"Mankato-North Mankato, MN",1992,281,66,347,82535,4.20427697340522
31860,"Mankato-North Mankato, MN",1993,240,161,401,82684,4.8497895602535
31860,"Mankato-North Mankato, MN",1994,241,6,247,82928,2.97848736253135
31860,"Mankato-North Mankato, MN",1995,260,62,322,83563,3.85338008448715
31860,"Mankato-North Mankato, MN",1996,328,38,366,83741,4.37061893218376
31860,"Mankato-North Mankato, MN",1997,237,46,283,83546,3.38735546884351
31860,"Mankato-North Mankato, MN",1998,251,90,341,83232,4.09698193002691
31860,"Mankato-North Mankato, MN",1999,305,288,593,83371,7.11278502117043
31860,"Mankato-North Mankato, MN",2000,304,166,470,85892,5.47198807805151
31860,"Mankato-North Mankato, MN",2001,452,156,608,87105,6.98008151082027
31860,"Mankato-North Mankato, MN",2002,486,517,1003,88107,11.3838855028545
31860,"Mankato-North Mankato, MN",2003,833,346,1179,89336,13.1973672427689
31860,"Mankato-North Mankato, MN",2004,621,95,716,90152,7.94214215990771
31860,"Mankato-North Mankato, MN",2005,611,97,708,91111,7.77074118383071
31860,"Mankato-North Mankato, MN",2006,454,152,606,92879,6.52461805144328
31860,"Mankato-North Mankato, MN",2007,370,19,389,93963,4.13992741823909
31860,"Mankato-North Mankato, MN",2008,229,16,245,95121,2.57566678230885
31860,"Mankato-North Mankato, MN",2009,247,16,263,96111,2.73641934846167
31860,"Mankato-North Mankato, MN",2010,196,135,331,96845,3.41783261913367
31860,"Mankato-North Mankato, MN",2011,185,96,281,97311,2.88764887833852
31860,"Mankato-North Mankato, MN",2012,208,321,529,97986,5.39873043087788
31860,"Mankato-North Mankato, MN",2013,291,215,506,97715,5.17832471984854
31860,"Mankato-North Mankato, MN",2014,232,198,430,98668,4.35804921555114
31860,"Mankato-North Mankato, MN",2015,245,563,808,99190,8.14598245790906
31860,"Mankato-North Mankato, MN",2016,245,159,404,100075,4.0369722707969
31860,"Mankato-North Mankato, MN",2017,342,174,516,100945,5.11169448709693
31860,"Mankato-North Mankato, MN",2018,273,214,487,101647,4.79109073558492
31900,"Mansfield, OH",1990,229,70,299,126187,2.36949923526195
31900,"Mansfield, OH",1991,199,66,265,127177,2.08371010481455
31900,"Mansfield, OH",1992,257,29,286,127721,2.23925587804668
31900,"Mansfield, OH",1993,255,57,312,128149,2.43466589672959
31900,"Mansfield, OH",1994,327,48,375,128751,2.91259873709719
31900,"Mansfield, OH",1995,307,82,389,128799,3.02020978423745
31900,"Mansfield, OH",1996,315,60,375,129592,2.89369714179888
31900,"Mansfield, OH",1997,335,246,581,129681,4.48022455101364
31900,"Mansfield, OH",1998,356,246,602,129466,4.64986946379744
31900,"Mansfield, OH",1999,323,181,504,130281,3.86856103345845
31900,"Mansfield, OH",2000,310,228,538,128853,4.17530053627001
31900,"Mansfield, OH",2001,366,124,490,128187,3.82254050722772
31900,"Mansfield, OH",2002,368,78,446,128363,3.4745214742566
31900,"Mansfield, OH",2003,355,135,490,128312,3.81881663445352
31900,"Mansfield, OH",2004,334,112,446,128094,3.48181803987697
31900,"Mansfield, OH",2005,265,165,430,127724,3.36663430522063
31900,"Mansfield, OH",2006,202,29,231,127292,1.81472519875562
31900,"Mansfield, OH",2007,128,74,202,126995,1.59061380369306
31900,"Mansfield, OH",2008,84,26,110,126128,0.872129899784346
31900,"Mansfield, OH",2009,47,26,73,125308,0.582564560921888
31900,"Mansfield, OH",2010,45,0,45,124159,0.362438486134714
31900,"Mansfield, OH",2011,42,0,42,123128,0.341108439997401
31900,"Mansfield, OH",2012,51,2,53,122622,0.432222602795583
31900,"Mansfield, OH",2013,70,0,70,122310,0.572316245605429
31900,"Mansfield, OH",2014,61,0,61,121994,0.500024591373346
31900,"Mansfield, OH",2015,62,0,62,121702,0.509441093819329
31900,"Mansfield, OH",2016,54,15,69,121280,0.568931398416887
31900,"Mansfield, OH",2017,70,7,77,120543,0.638776204342019
31900,"Mansfield, OH",2018,61,19,80,121099,0.660616520367633
31930,"Marietta, OH",1990,19,2,21,62243,0.337387336728628
31930,"Marietta, OH",1991,26,2,28,62183,0.450283839634627
31930,"Marietta, OH",1992,30,43,73,62701,1.16425575349675
31930,"Marietta, OH",1993,43,4,47,63194,0.74374149444567506
31930,"Marietta, OH",1994,31,14,45,63554,0.708059288164396
31930,"Marietta, OH",1995,21,9,30,63667,0.471201721456956
31930,"Marietta, OH",1996,28,15,43,63743,0.674583875876567
31930,"Marietta, OH",1997,24,16,40,63585,0.629079185342455
31930,"Marietta, OH",1998,34,36,70,63257,1.10659689836698
31930,"Marietta, OH",1999,32,24,56,62822,0.891407468721149
31930,"Marietta, OH",2000,19,0,19,63180,0.300728078505856
31930,"Marietta, OH",2001,23,0,23,62847,0.365968144859739
31930,"Marietta, OH",2002,32,0,32,62638,0.510871994635844
31930,"Marietta, OH",2003,28,26,54,62759,0.86043436001211
31930,"Marietta, OH",2004,24,12,36,62924,0.572118746424258
31930,"Marietta, OH",2005,39,0,39,62547,0.623531104609334
31930,"Marietta, OH",2006,34,0,34,62387,0.544985333482937
31930,"Marietta, OH",2007,24,0,24,62253,0.385523589224616
31930,"Marietta, OH",2008,10,4,14,62040,0.225660863958736
31930,"Marietta, OH",2009,8,0,8,61968,0.129098889749548
31930,"Marietta, OH",2010,11,2,13,61710,0.210662777507697
31930,"Marietta, OH",2011,6,8,14,61593,0.227298556654165
31930,"Marietta, OH",2012,6,0,6,61433,0.097667377468136
31930,"Marietta, OH",2013,4,4,8,61355,0.130388721375601
31930,"Marietta, OH",2014,23,17,40,61152,0.65410779696494
31930,"Marietta, OH",2015,12,9,21,61007,0.344222794105594
31930,"Marietta, OH",2016,11,4,15,60577,0.247618733182561
31930,"Marietta, OH",2017,12,3,15,60462,0.248089709238861
31930,"Marietta, OH",2018,7,6,13,60155,0.216108386667775
31940,"Marinette, WI-MI",1990,225,0,225,65537,3.43317515296703
31940,"Marinette, WI-MI",1991,240,32,272,65688,4.1407867494824
31940,"Marinette, WI-MI",1992,241,2,243,65834,3.69110186225962
31940,"Marinette, WI-MI",1993,259,24,283,66122,4.27996733311152
31940,"Marinette, WI-MI",1994,302,27,329,66557,4.94313145123729
31940,"Marinette, WI-MI",1995,262,42,304,67057,4.53345661153944
31940,"Marinette, WI-MI",1996,299,41,340,67188,5.06042745728404
31940,"Marinette, WI-MI",1997,304,90,394,67359,5.84925548182129
31940,"Marinette, WI-MI",1998,337,60,397,67441,5.88662682937679
31940,"Marinette, WI-MI",1999,410,36,446,67563,6.60124624424611
31940,"Marinette, WI-MI",2000,368,41,409,68699,5.9535073290732
31940,"Marinette, WI-MI",2001,397,0,397,68327,5.81029461267142
31940,"Marinette, WI-MI",2002,372,46,418,68145,6.13397901533495
31940,"Marinette, WI-MI",2003,379,8,387,67943,5.69595101776489
31940,"Marinette, WI-MI",2004,407,6,413,67667,6.10341820976251
31940,"Marinette, WI-MI",2005,392,0,392,67569,5.80147700868742
31940,"Marinette, WI-MI",2006,326,6,332,66861,4.96552549318736
31940,"Marinette, WI-MI",2007,330,0,330,66512,4.96151070483522
31940,"Marinette, WI-MI",2008,153,86,239,66336,3.60287023637241
31940,"Marinette, WI-MI",2009,122,18,140,65910,2.12410863298437
31940,"Marinette, WI-MI",2010,126,12,138,65630,2.1026969373762
31940,"Marinette, WI-MI",2011,101,0,101,65272,1.5473710013482
31940,"Marinette, WI-MI",2012,124,49,173,65074,2.65851184804991
31940,"Marinette, WI-MI",2013,112,0,112,65008,1.72286487816884
31940,"Marinette, WI-MI",2014,109,14,123,64563,1.90511593327448
31940,"Marinette, WI-MI",2015,130,0,130,64119,2.02748015408849
31940,"Marinette, WI-MI",2016,133,2,135,63455,2.12749192341029
31940,"Marinette, WI-MI",2017,146,5,151,63297,2.38557909537577
31940,"Marinette, WI-MI",2018,155,0,155,63417,2.44413958402321
31980,"Marion, IN",1990,129,2,131,74176,1.76606988783434
31980,"Marion, IN",1991,110,104,214,74207,2.88382497608042
31980,"Marion, IN",1992,141,0,141,74134,1.90196131329754
31980,"Marion, IN",1993,161,6,167,73805,2.26271932795881
31980,"Marion, IN",1994,208,23,231,73705,3.13411573163286
31980,"Marion, IN",1995,169,35,204,73674,2.76895512663898
31980,"Marion, IN",1996,176,19,195,73349,2.65852295191482
31980,"Marion, IN",1997,181,84,265,72859,3.63716218998339
31980,"Marion, IN",1998,261,54,315,72648,4.33597621407334
31980,"Marion, IN",1999,206,171,377,72341,5.21142920335633
31980,"Marion, IN",2000,215,22,237,73325,3.23218547562223
31980,"Marion, IN",2001,214,20,234,72905,3.2096564021672
31980,"Marion, IN",2002,131,80,211,72425,2.91335864687608
31980,"Marion, IN",2003,144,42,186,72113,2.57928528836687
31980,"Marion, IN",2004,122,0,122,71479,1.70679500272807
31980,"Marion, IN",2005,94,2,96,70803,1.35587475106987
31980,"Marion, IN",2006,84,2,86,70448,1.22075857369975
31980,"Marion, IN",2007,68,0,68,70012,0.971262069359538
31980,"Marion, IN",2008,46,0,46,70250,0.654804270462633
31980,"Marion, IN",2009,43,4,47,70195,0.669563359213619
31980,"Marion, IN",2010,34,12,46,69906,0.658026492718794
31980,"Marion, IN",2011,31,2,33,69614,0.474042577642428
31980,"Marion, IN",2012,34,2,36,69083,0.521112285222124
31980,"Marion, IN",2013,48,0,48,68850,0.697167755991285
31980,"Marion, IN",2014,47,21,68,68336,0.995083118707563
31980,"Marion, IN",2015,43,37,80,67486,1.18543105236642
31980,"Marion, IN",2016,46,0,46,66680,0.689862027594481
31980,"Marion, IN",2017,54,0,54,66282,0.814700823753055
31980,"Marion, IN",2018,74,0,74,65936,1.12230041252123
32000,"Marion, NC",1990,100,24,124,35738,3.46969612177514
32000,"Marion, NC",1991,95,20,115,36028,3.19196180748307
32000,"Marion, NC",1992,113,18,131,36183,3.62048475803554
32000,"Marion, NC",1993,114,22,136,36558,3.72011598008644
32000,"Marion, NC",1994,96,4,100,37057,2.69854548398413
32000,"Marion, NC",1995,95,12,107,37467,2.85584647823418
32000,"Marion, NC",1996,139,41,180,38521,4.67277588847642
32000,"Marion, NC",1997,131,53,184,39454,4.6636589445937
32000,"Marion, NC",1998,126,47,173,40043,4.32035561771096
32000,"Marion, NC",1999,133,10,143,40527,3.52851185629334
32000,"Marion, NC",2000,122,10,132,42265,3.12315154383059
32000,"Marion, NC",2001,123,11,134,42796,3.13113375081783
32000,"Marion, NC",2002,169,6,175,42911,4.07820838479644
32000,"Marion, NC",2003,160,37,197,43211,4.55902432251047
32000,"Marion, NC",2004,231,40,271,43390,6.24567872781747
32000,"Marion, NC",2005,211,35,246,43655,5.63509334555034
32000,"Marion, NC",2006,216,34,250,43969,5.68582410334554
32000,"Marion, NC",2007,256,39,295,44345,6.65238471079039
32000,"Marion, NC",2008,156,29,185,44768,4.13241601143674
32000,"Marion, NC",2009,107,0,107,44865,2.38493257550429
32000,"Marion, NC",2010,115,0,115,45098,2.55000221739323
32000,"Marion, NC",2011,111,0,111,45051,2.46387427582074
32000,"Marion, NC",2012,98,0,98,45003,2.17763260227096
32000,"Marion, NC",2013,110,0,110,45031,2.44276165308343
32000,"Marion, NC",2014,106,0,106,45018,2.35461371007153
32000,"Marion, NC",2015,82,60,142,44976,3.15723941657773
32000,"Marion, NC",2016,81,0,81,44882,1.80473240942917
32000,"Marion, NC",2017,112,0,112,45164,2.47985120892746
32000,"Marion, NC",2018,120,2,122,45507,2.68090623420573
32020,"Marion, OH",1990,57,0,57,64284,0.886690311741646
32020,"Marion, OH",1991,65,2,67,64205,1.0435324351686
32020,"Marion, OH",1992,87,168,255,64426,3.95802936702573
32020,"Marion, OH",1993,84,15,99,64962,1.52396785813245
32020,"Marion, OH",1994,94,40,134,67410,1.98783563269545
32020,"Marion, OH",1995,100,5,105,67666,1.5517394260042
32020,"Marion, OH",1996,119,38,157,67485,2.32644291323998
32020,"Marion, OH",1997,158,20,178,67348,2.64298865593633
32020,"Marion, OH",1998,150,47,197,67034,2.93880717247964
32020,"Marion, OH",1999,156,54,210,66336,3.1657018813314
32020,"Marion, OH",2000,129,5,134,66135,2.02615861495426
32020,"Marion, OH",2001,147,0,147,66156,2.22202067839652
32020,"Marion, OH",2002,148,4,152,66188,2.29648878950867
32020,"Marion, OH",2003,131,27,158,66372,2.38052190682818
32020,"Marion, OH",2004,198,217,415,66361,6.2536730911228
32020,"Marion, OH",2005,182,60,242,66468,3.64084973220196
32020,"Marion, OH",2006,136,252,388,66345,5.84821765016203
32020,"Marion, OH",2007,95,210,305,66487,4.58736294313174
32020,"Marion, OH",2008,52,9,61,66840,0.912627169359665
32020,"Marion, OH",2009,33,2,35,66497,0.526339534114321
32020,"Marion, OH",2010,78,4,82,66455,1.2339176886615
32020,"Marion, OH",2011,41,20,61,66587,0.916094733206181
32020,"Marion, OH",2012,26,20,46,66269,0.694140548371033
32020,"Marion, OH",2013,28,22,50,65959,0.758046665352719
32020,"Marion, OH",2014,31,63,94,65789,1.42881028743407
32020,"Marion, OH",2015,31,0,31,65382,0.474136612523324
32020,"Marion, OH",2016,39,0,39,65353,0.596759138830658
32020,"Marion, OH",2017,47,2,49,64941,0.754531035863322
32020,"Marion, OH",2018,33,2,35,65256,0.536349147971068
32100,"Marquette, MI",1990,220,24,244,70956,3.43875077512825
32100,"Marquette, MI",1991,236,34,270,71283,3.7877193720803
32100,"Marquette, MI",1992,305,27,332,71782,4.62511493131983
32100,"Marquette, MI",1993,219,4,223,71654,3.11217796633824
32100,"Marquette, MI",1994,223,21,244,70045,3.48347490898708
32100,"Marquette, MI",1995,218,22,240,64617,3.71419285946423
32100,"Marquette, MI",1996,175,2,177,61943,2.857465734627
32100,"Marquette, MI",1997,200,2,202,61573,3.28065873028763
32100,"Marquette, MI",1998,224,197,421,61915,6.79964467415004
32100,"Marquette, MI",1999,242,8,250,62046,4.02926860716243
32100,"Marquette, MI",2000,239,28,267,64606,4.13274308887719
32100,"Marquette, MI",2001,187,2,189,64738,2.91945997713862
32100,"Marquette, MI",2002,190,28,218,65012,3.35322709653602
32100,"Marquette, MI",2003,257,142,399,65043,6.13440339467737
32100,"Marquette, MI",2004,272,65,337,65620,5.13562938128619
32100,"Marquette, MI",2005,237,96,333,65785,5.06194421220643
32100,"Marquette, MI",2006,204,82,286,66002,4.33320202418109
32100,"Marquette, MI",2007,122,8,130,66131,1.9657951641439
32100,"Marquette, MI",2008,123,26,149,66539,2.2392882369738
32100,"Marquette, MI",2009,95,15,110,66765,1.64756983449412
32100,"Marquette, MI",2010,84,42,126,67078,1.87841020901041
32100,"Marquette, MI",2011,91,5,96,67448,1.42331870477998
32100,"Marquette, MI",2012,107,73,180,67827,2.65381042947499
32100,"Marquette, MI",2013,95,8,103,67773,1.51977926312838
32100,"Marquette, MI",2014,92,50,142,67773,2.09522966373039
32100,"Marquette, MI",2015,82,15,97,67319,1.44090078581084
32100,"Marquette, MI",2016,93,2,95,66520,1.42814191220686
32100,"Marquette, MI",2017,72,47,119,66565,1.78772628258094
32100,"Marquette, MI",2018,75,0,75,66516,1.12754825906549
32140,"Marshall, MN",1990,45,7,52,24738,2.10202926671518
32140,"Marshall, MN",1991,38,14,52,24666,2.10816508554285
32140,"Marshall, MN",1992,68,126,194,24645,7.87177926557111
32140,"Marshall, MN",1993,67,57,124,24765,5.00706642438926
32140,"Marshall, MN",1994,59,26,85,24960,3.40544871794872
32140,"Marshall, MN",1995,60,36,96,24928,3.85109114249037
32140,"Marshall, MN",1996,53,59,112,24606,4.55173534910185
32140,"Marshall, MN",1997,39,89,128,24440,5.23731587561375
32140,"Marshall, MN",1998,58,26,84,24395,3.44332855093257
32140,"Marshall, MN",1999,46,33,79,24380,3.24036095159967
32140,"Marshall, MN",2000,67,30,97,25465,3.80914981346947
32140,"Marshall, MN",2001,91,32,123,25474,4.82845253984455
32140,"Marshall, MN",2002,106,49,155,25191,6.15299114763209
32140,"Marshall, MN",2003,119,5,124,25091,4.94201107967
32140,"Marshall, MN",2004,100,4,104,24981,4.16316400464353
32140,"Marshall, MN",2005,97,56,153,25178,6.07673365636667
32140,"Marshall, MN",2006,59,6,65,25347,2.56440604410778
32140,"Marshall, MN",2007,55,29,84,25403,3.30669605952053
32140,"Marshall, MN",2008,35,4,39,25646,1.52070498323325
32140,"Marshall, MN",2009,20,12,32,25768,1.24185035703198
32140,"Marshall, MN",2010,18,2,20,25848,0.773754255648406
32140,"Marshall, MN",2011,33,26,59,25825,2.28460793804453
32140,"Marshall, MN",2012,22,42,64,25630,2.49707374170894
32140,"Marshall, MN",2013,26,12,38,25720,1.47744945567652
32140,"Marshall, MN",2014,25,11,36,25776,1.39664804469274
32140,"Marshall, MN",2015,16,10,26,25837,1.00630878197933
32140,"Marshall, MN",2016,30,8,38,26000,1.46153846153846
32140,"Marshall, MN",2017,26,18,44,25953,1.69537240396101
32140,"Marshall, MN",2018,28,49,77,25629,3.00440906785282
32180,"Marshall, MO",1990,22,0,22,23473,0.9372470498019
32180,"Marshall, MO",1991,8,0,8,23165,0.345348586229225
32180,"Marshall, MO",1992,4,0,4,22873,0.174878677917195
32180,"Marshall, MO",1993,10,0,10,22774,0.43909721612365
32180,"Marshall, MO",1994,17,10,27,22804,1.18400280652517
32180,"Marshall, MO",1995,7,8,15,22969,0.65305411641778
32180,"Marshall, MO",1996,26,2,28,22992,1.2178148921364
32180,"Marshall, MO",1997,14,21,35,22827,1.53327200245324
32180,"Marshall, MO",1998,13,26,39,22664,1.72079068125662
32180,"Marshall, MO",1999,22,0,22,22805,0.964700723525543
32180,"Marshall, MO",2000,15,8,23,23747,0.968543394955152
32180,"Marshall, MO",2001,17,76,93,23399,3.97452882601821
32180,"Marshall, MO",2002,14,26,40,22960,1.74216027874564
32180,"Marshall, MO",2003,14,38,52,22896,2.27113906359189
32180,"Marshall, MO",2004,8,8,16,23058,0.693902333246596
32180,"Marshall, MO",2005,9,18,27,23053,1.17121415867783
32180,"Marshall, MO",2006,23,4,27,23008,1.17350486787204
32180,"Marshall, MO",2007,13,6,19,23029,0.8250466802727
32180,"Marshall, MO",2008,4,4,8,22967,0.348325858840946
32180,"Marshall, MO",2009,8,6,14,23221,0.60290254511003
32180,"Marshall, MO",2010,3,20,23,23420,0.982066609735269
32180,"Marshall, MO",2011,5,5,10,23402,0.427313904794462
32180,"Marshall, MO",2012,3,12,15,23542,0.637159119870869
32180,"Marshall, MO",2013,8,0,8,23356,0.342524404863846
32180,"Marshall, MO",2014,7,34,41,23398,1.7522865202154
32180,"Marshall, MO",2015,5,36,41,23212,1.76632776150267
32180,"Marshall, MO",2016,6,10,16,23080,0.693240901213172
32180,"Marshall, MO",2017,9,4,13,22924,0.567091258070145
32180,"Marshall, MO",2018,3,0,3,22895,0.131032976632453
32220,"Marshall, TX",1990,18,0,18,57431,0.31341958175898
32220,"Marshall, TX",1991,20,8,28,57094,0.490419308508775
32220,"Marshall, TX",1992,24,4,28,57196,0.489544723407231
32220,"Marshall, TX",1993,43,2,45,57861,0.777725929382486
32220,"Marshall, TX",1994,45,0,45,58085,0.774726693638633
32220,"Marshall, TX",1995,61,0,61,58599,1.04097339545043
32220,"Marshall, TX",1996,42,0,42,59116,0.710467555314974
32220,"Marshall, TX",1997,35,0,35,59384,0.589384345951771
32220,"Marshall, TX",1998,44,50,94,59767,1.57277427342848
32220,"Marshall, TX",1999,22,42,64,59797,1.07028780708062
32220,"Marshall, TX",2000,28,0,28,62040,0.451321727917473
32220,"Marshall, TX",2001,38,0,38,62256,0.610382934978155
32220,"Marshall, TX",2002,46,0,46,62062,0.741194289581386
32220,"Marshall, TX",2003,37,0,37,62018,0.596600986810281
32220,"Marshall, TX",2004,44,0,44,62583,0.703066327916527
32220,"Marshall, TX",2005,40,0,40,62811,0.636831128305552
32220,"Marshall, TX",2006,38,0,38,63699,0.59655567591328
32220,"Marshall, TX",2007,40,0,40,63661,0.628328175806224
32220,"Marshall, TX",2008,79,0,79,64107,1.23231472382111
32220,"Marshall, TX",2009,41,38,79,65185,1.21193526117972
32220,"Marshall, TX",2010,36,51,87,65769,1.32281165898828
32220,"Marshall, TX",2011,47,80,127,66345,1.91423618961489
32220,"Marshall, TX",2012,36,6,42,66271,0.633761373753225
32220,"Marshall, TX",2013,43,0,43,66288,0.64868452811972
32220,"Marshall, TX",2014,53,26,79,66610,1.18600810689086
32220,"Marshall, TX",2015,34,20,54,66710,0.809473842002698
32220,"Marshall, TX",2016,40,28,68,66640,1.02040816326531
32220,"Marshall, TX",2017,44,16,60,66540,0.901713255184851
32220,"Marshall, TX",2018,28,2,30,66726,0.449599856128046
32260,"Marshalltown, IA",1990,37,0,37,38285,0.966435940969048
32260,"Marshalltown, IA",1991,40,2,42,38129,1.1015237745548
32260,"Marshalltown, IA",1992,44,26,70,37764,1.85361720156763
32260,"Marshalltown, IA",1993,69,72,141,37887,3.72159315860321
32260,"Marshalltown, IA",1994,51,40,91,38253,2.37889838705461
32260,"Marshalltown, IA",1995,41,28,69,38710,1.78248514595712
32260,"Marshalltown, IA",1996,37,5,42,38697,1.08535545391116
32260,"Marshalltown, IA",1997,55,52,107,38771,2.7597946919089
32260,"Marshalltown, IA",1998,55,36,91,38703,2.35123892204739
32260,"Marshalltown, IA",1999,54,24,78,38714,2.01477501678979
32260,"Marshalltown, IA",2000,45,16,61,39356,1.54995426364468
32260,"Marshalltown, IA",2001,59,35,94,39414,2.38493936164815
32260,"Marshalltown, IA",2002,54,88,142,39297,3.61350739242181
32260,"Marshalltown, IA",2003,111,26,137,39397,3.47742213874153
32260,"Marshalltown, IA",2004,78,56,134,39711,3.37437989473949
32260,"Marshalltown, IA",2005,83,11,94,39646,2.37098320133179
32260,"Marshalltown, IA",2006,67,10,77,39601,1.9443953435519301
32260,"Marshalltown, IA",2007,64,14,78,39875,1.95611285266458
32260,"Marshalltown, IA",2008,28,56,84,40151,2.09210231376554
32260,"Marshalltown, IA",2009,18,2,20,40280,0.496524329692155
32260,"Marshalltown, IA",2010,12,2,14,40722,0.343794509110554
32260,"Marshalltown, IA",2011,16,2,18,41013,0.43888523151196
32260,"Marshalltown, IA",2012,10,2,12,41037,0.292419036479275
32260,"Marshalltown, IA",2013,11,6,17,41007,0.414563367229985
32260,"Marshalltown, IA",2014,6,4,10,40735,0.245489137105683
32260,"Marshalltown, IA",2015,23,4,27,40364,0.668912892676643
32260,"Marshalltown, IA",2016,40,26,66,40129,1.64469585586484
32260,"Marshalltown, IA",2017,33,26,59,40148,1.46956261831224
32260,"Marshalltown, IA",2018,71,40,111,39981,2.77631875140692
32280,"Martin, TN",1990,43,11,54,32027,1.68607737221719
32280,"Martin, TN",1991,35,9,44,31869,1.3806520443063801
32280,"Martin, TN",1992,42,47,89,31874,2.79224446257137
32280,"Martin, TN",1993,147,42,189,31971,5.91160739420099
32280,"Martin, TN",1994,122,80,202,32171,6.2789468776227
32280,"Martin, TN",1995,116,89,205,32239,6.35875802599336
32280,"Martin, TN",1996,93,77,170,32528,5.22626660108214
32280,"Martin, TN",1997,118,72,190,32803,5.79215315672347
32280,"Martin, TN",1998,97,95,192,32898,5.83622104687215
32280,"Martin, TN",1999,125,97,222,32968,6.7338024751274
32280,"Martin, TN",2000,65,71,136,34927,3.89383571449022
32280,"Martin, TN",2001,79,62,141,34491,4.08802296251196
32280,"Martin, TN",2002,104,4,108,34443,3.13561536451529
32280,"Martin, TN",2003,59,12,71,34300,2.06997084548105
32280,"Martin, TN",2004,92,10,102,34307,2.97315416678812
32280,"Martin, TN",2005,105,6,111,34407,3.22608771470922
32280,"Martin, TN",2006,84,8,92,34289,2.683076205197
32280,"Martin, TN",2007,71,10,81,34256,2.36454927603923
32280,"Martin, TN",2008,60,5,65,34484,1.88493214244287
32280,"Martin, TN",2009,48,4,52,34732,1.49717839456409
32280,"Martin, TN",2010,53,5,58,35042,1.65515666913989
32280,"Martin, TN",2011,35,0,35,34854,1.00418890227807
32280,"Martin, TN",2012,36,0,36,34547,1.04205864474484
32280,"Martin, TN",2013,53,0,53,34145,1.55220383657929
32280,"Martin, TN",2014,33,0,33,33990,0.970873786407767
32280,"Martin, TN",2015,23,0,23,33847,0.679528466333796
32280,"Martin, TN",2016,37,0,37,33580,1.10184633710542
32280,"Martin, TN",2017,41,0,41,33296,1.231379144642
32280,"Martin, TN",2018,55,0,55,33415,1.6459673799192
32300,"Martinsville, VA",1990,202,31,233,73058,3.18924689972351
32300,"Martinsville, VA",1991,238,47,285,72794,3.91515784267934
32300,"Martinsville, VA",1992,241,6,247,72512,3.40633274492498
32300,"Martinsville, VA",1993,249,38,287,72672,3.94925143108763
32300,"Martinsville, VA",1994,226,8,234,72514,3.22696306920043
32300,"Martinsville, VA",1995,236,26,262,72383,3.6196344445519
32300,"Martinsville, VA",1996,219,0,219,71877,3.04687173922117
32300,"Martinsville, VA",1997,159,24,183,71673,2.5532627349211
32300,"Martinsville, VA",1998,118,20,138,71094,1.94109207528061
32300,"Martinsville, VA",1999,133,8,141,70663,1.99538655307587
32300,"Martinsville, VA",2000,100,68,168,73234,2.29401644045116
32300,"Martinsville, VA",2001,103,11,114,72566,1.57098365625775
32300,"Martinsville, VA",2002,98,0,98,71853,1.36389573156305
32300,"Martinsville, VA",2003,88,6,94,71302,1.31833609155423
32300,"Martinsville, VA",2004,120,0,120,70631,1.6989707069134
32300,"Martinsville, VA",2005,93,0,93,70056,1.3275094210346
32300,"Martinsville, VA",2006,108,46,154,69745,2.20804358735393
32300,"Martinsville, VA",2007,89,0,89,69326,1.28378963159565
32300,"Martinsville, VA",2008,70,0,70,69113,1.01283405437472
32300,"Martinsville, VA",2009,54,12,66,68414,0.964714824451136
32300,"Martinsville, VA",2010,43,0,43,67892,0.633358864078242
32300,"Martinsville, VA",2011,58,0,58,67135,0.863930885529158
32300,"Martinsville, VA",2012,47,0,47,66594,0.70576928852449194
32300,"Martinsville, VA",2013,22,0,22,66159,0.332532232953944
32300,"Martinsville, VA",2014,29,0,29,65547,0.442430622301555
32300,"Martinsville, VA",2015,28,0,28,65189,0.429520317845035
32300,"Martinsville, VA",2016,35,0,35,64631,0.541535795516084
32300,"Martinsville, VA",2017,30,12,42,64219,0.654012052507825
32300,"Martinsville, VA",2018,21,0,21,63855,0.328870096311957
32340,"Maryville, MO",1990,28,0,28,21709,1.28978764567691
32340,"Maryville, MO",1991,21,48,69,21399,3.22444974064209
32340,"Maryville, MO",1992,23,22,45,21367,2.10605138765386
32340,"Maryville, MO",1993,15,28,43,21194,2.02887609700859
32340,"Maryville, MO",1994,17,30,47,21041,2.23373413811131
32340,"Maryville, MO",1995,17,28,45,21033,2.13949507916132
32340,"Maryville, MO",1996,18,35,53,20998,2.52404990951519
32340,"Maryville, MO",1997,24,56,80,20937,3.82098676983331
32340,"Maryville, MO",1998,56,48,104,20696,5.0251256281407
32340,"Maryville, MO",1999,22,19,41,20523,1.99775861228865
32340,"Maryville, MO",2000,23,36,59,21897,2.69443302735535
32340,"Maryville, MO",2001,20,51,71,22070,3.21703670140462
32340,"Maryville, MO",2002,24,24,48,22239,2.1583704303251
32340,"Maryville, MO",2003,32,8,40,22319,1.7921949908150001
32340,"Maryville, MO",2004,48,19,67,22517,2.97552959985789
32340,"Maryville, MO",2005,33,6,39,22588,1.72658048521339
32340,"Maryville, MO",2006,92,4,96,22698,4.2294475284166
32340,"Maryville, MO",2007,35,4,39,22804,1.71022627609191
32340,"Maryville, MO",2008,20,24,44,23026,1.91088334925736
32340,"Maryville, MO",2009,19,8,27,23242,1.16169004388607
32340,"Maryville, MO",2010,17,10,27,23398,1.15394478160527
32340,"Maryville, MO",2011,17,14,31,23426,1.32331597370443
32340,"Maryville, MO",2012,17,52,69,23320,2.95883361921098
32340,"Maryville, MO",2013,45,14,59,23148,2.5488163124244
32340,"Maryville, MO",2014,16,20,36,22977,1.56678417547983
32340,"Maryville, MO",2015,17,26,43,22609,1.90189747445707
32340,"Maryville, MO",2016,21,6,27,22436,1.20342307006597
32340,"Maryville, MO",2017,22,21,43,22408,1.91895751517315
32340,"Maryville, MO",2018,22,18,40,22304,1.79340028694405
32380,"Mason City, IA",1990,88,6,94,54720,1.71783625730994
32380,"Mason City, IA",1991,72,0,72,54951,1.31025823005951
32380,"Mason City, IA",1992,83,35,118,54696,2.15737896738336
32380,"Mason City, IA",1993,66,26,92,54512,1.68770179043146
32380,"Mason City, IA",1994,90,60,150,54318,2.76151551971722
32380,"Mason City, IA",1995,90,6,96,54465,1.76259983475627
32380,"Mason City, IA",1996,80,91,171,54270,3.15091210613599
32380,"Mason City, IA",1997,99,15,114,54083,2.10787123495368
32380,"Mason City, IA",1998,103,75,178,53815,3.30762798476261
32380,"Mason City, IA",1999,76,10,86,53347,1.61208690273118
32380,"Mason City, IA",2000,73,14,87,54283,1.6027117145331
32380,"Mason City, IA",2001,68,19,87,53641,1.62189370071401
32380,"Mason City, IA",2002,97,11,108,53225,2.02912165335838
32380,"Mason City, IA",2003,96,46,142,53146,2.67188499604862
32380,"Mason City, IA",2004,128,42,170,52724,3.22433806236249
32380,"Mason City, IA",2005,126,47,173,52483,3.29630547034278
32380,"Mason City, IA",2006,112,34,146,52180,2.79800689919509
32380,"Mason City, IA",2007,66,7,73,52116,1.40072146749559
32380,"Mason City, IA",2008,47,2,49,51917,0.943814164917079
32380,"Mason City, IA",2009,40,59,99,51849,1.90939073077591
32380,"Mason City, IA",2010,45,10,55,51679,1.0642620793746
32380,"Mason City, IA",2011,33,6,39,51526,0.756899429414276
32380,"Mason City, IA",2012,52,48,100,51193,1.95339206532143
32380,"Mason City, IA",2013,52,40,92,51016,1.80335580994198
32380,"Mason City, IA",2014,42,48,90,50763,1.77294486141481
32380,"Mason City, IA",2015,54,0,54,50485,1.06962464098247
32380,"Mason City, IA",2016,41,2,43,50558,0.8505083270699
32380,"Mason City, IA",2017,46,0,46,50458,0.911649292480875
32380,"Mason City, IA",2018,41,10,51,50100,1.01796407185629
32460,"Mayfield, KY",1990,16,5,21,33661,0.623867383619025
32460,"Mayfield, KY",1991,22,2,24,33757,0.710963651983292
32460,"Mayfield, KY",1992,19,4,23,34027,0.675933817262762
32460,"Mayfield, KY",1993,28,2,30,34350,0.873362445414847
32460,"Mayfield, KY",1994,42,0,42,34785,1.20741699008193
32460,"Mayfield, KY",1995,19,11,30,35036,0.85626213038018
32460,"Mayfield, KY",1996,25,0,25,35536,0.703511931562359
32460,"Mayfield, KY",1997,20,52,72,35649,2.01969199697046
32460,"Mayfield, KY",1998,12,0,12,35954,0.333759804194248
32460,"Mayfield, KY",1999,6,24,30,36212,0.828454655915166
32460,"Mayfield, KY",2000,11,4,15,37049,0.404869227239602
32460,"Mayfield, KY",2001,9,0,9,36869,0.244107515799181
32460,"Mayfield, KY",2002,5,0,5,36770,0.13598041881969
32460,"Mayfield, KY",2003,5,12,17,36898,0.460729578838961
32460,"Mayfield, KY",2004,12,0,12,36789,0.326184457310609
32460,"Mayfield, KY",2005,19,0,19,36926,0.514542598710935
32460,"Mayfield, KY",2006,6,2,8,36859,0.217043327274207
32460,"Mayfield, KY",2007,8,0,8,36932,0.216614318206433
32460,"Mayfield, KY",2008,1,0,1,36862,0.0271282079105854
32460,"Mayfield, KY",2009,9,0,9,36932,0.243691107982238
32460,"Mayfield, KY",2010,2,0,2,37240,0.0537056928034372
32460,"Mayfield, KY",2011,7,0,7,37598,0.186180115963615
32460,"Mayfield, KY",2012,2,0,2,37561,0.0532467186709619
32460,"Mayfield, KY",2013,1,0,1,37400,0.0267379679144385
32460,"Mayfield, KY",2014,0,0,0,37575,0
32460,"Mayfield, KY",2015,1,0,1,37230,0.02686005909213
32460,"Mayfield, KY",2016,0,0,0,37175,0
32460,"Mayfield, KY",2017,3,0,3,37173,0.0807037365830038
32460,"Mayfield, KY",2018,2,0,2,37317,0.0535948763298229
32500,"Maysville, KY",1990,7,36,43,16669,2.57963885056092
32500,"Maysville, KY",1991,17,65,82,16792,4.88327775131015
32500,"Maysville, KY",1992,29,30,59,17172,3.43582576286979
32500,"Maysville, KY",1993,33,36,69,17216,4.00789962825279
32500,"Maysville, KY",1994,35,51,86,17136,5.0186741363212
32500,"Maysville, KY",1995,33,55,88,17068,5.15584719943754
32500,"Maysville, KY",1996,53,0,53,16926,3.13127732482571
32500,"Maysville, KY",1997,33,8,41,16958,2.41773794079491
32500,"Maysville, KY",1998,34,4,38,16932,2.24427120245689
32500,"Maysville, KY",1999,25,12,37,16857,2.19493385537166
32500,"Maysville, KY",2000,17,0,17,16790,1.01250744490768
32500,"Maysville, KY",2001,18,4,22,16808,1.30890052356021
32500,"Maysville, KY",2002,26,0,26,16825,1.54531946508172
32500,"Maysville, KY",2003,35,0,35,16729,2.09217526451073
32500,"Maysville, KY",2004,45,0,45,16802,2.6782525889775
32500,"Maysville, KY",2005,0,0,0,16923,0
32500,"Maysville, KY",2006,51,12,63,17138,3.67604154510445
32500,"Maysville, KY",2007,64,0,64,17259,3.70821020916623
32500,"Maysville, KY",2008,10,4,14,17454,0.802108399220809
32500,"Maysville, KY",2009,22,5,27,17464,1.54603756298672
32500,"Maysville, KY",2010,23,4,27,17505,1.54241645244216
32500,"Maysville, KY",2011,12,0,12,17548,0.683838614087075
32500,"Maysville, KY",2012,14,31,45,17467,2.57628671208565
32500,"Maysville, KY",2013,15,6,21,17331,1.21170157521205
32500,"Maysville, KY",2014,19,0,19,17143,1.10832409729919
32500,"Maysville, KY",2015,20,0,20,17066,1.1719207781554
32500,"Maysville, KY",2016,26,0,26,17182,1.5132115004074
32500,"Maysville, KY",2017,19,2,21,17225,1.21915820029028
32500,"Maysville, KY",2018,18,0,18,17150,1.04956268221574
32540,"McAlester, OK",1990,31,0,31,40965,0.756743561576956
32540,"McAlester, OK",1991,30,0,30,41517,0.722595563263241
32540,"McAlester, OK",1992,27,0,27,42246,0.63911376224968
32540,"McAlester, OK",1993,34,0,34,42743,0.795451886858667
32540,"McAlester, OK",1994,66,0,66,42986,1.53538361326944
32540,"McAlester, OK",1995,50,0,50,43212,1.15708599463112
32540,"McAlester, OK",1996,59,12,71,43127,1.64630046142788
32540,"McAlester, OK",1997,93,2,95,42971,2.21079332573131
32540,"McAlester, OK",1998,52,6,58,42979,1.34949626561809
32540,"McAlester, OK",1999,70,0,70,43329,1.61554617000162
32540,"McAlester, OK",2000,37,6,43,43982,0.977672684279933
32540,"McAlester, OK",2001,45,12,57,43447,1.31194328722351
32540,"McAlester, OK",2002,58,34,92,43933,2.09409783078779
32540,"McAlester, OK",2003,57,2,59,43983,1.34142736966555
32540,"McAlester, OK",2004,54,0,54,44029,1.22646437575235
32540,"McAlester, OK",2005,57,60,117,44412,2.63442312888409
32540,"McAlester, OK",2006,59,9,68,44831,1.51680756619304
32540,"McAlester, OK",2007,52,8,60,45062,1.33149882384271
32540,"McAlester, OK",2008,65,34,99,45450,2.17821782178218
32540,"McAlester, OK",2009,44,0,44,45887,0.95887724192037
32540,"McAlester, OK",2010,54,124,178,45783,3.88790599130682
32540,"McAlester, OK",2011,24,0,24,45696,0.525210084033613
32540,"McAlester, OK",2012,70,15,85,45521,1.86727005118517
32540,"McAlester, OK",2013,32,0,32,45254,0.70711981261325
32540,"McAlester, OK",2014,38,35,73,44835,1.62819226051076
32540,"McAlester, OK",2015,21,52,73,44711,1.63270783476102
32540,"McAlester, OK",2016,18,10,28,44341,0.631469745833427
32540,"McAlester, OK",2017,17,2,19,44145,0.430399818779024
32540,"McAlester, OK",2018,13,0,13,43877,0.296282790528067
32580,"McAllen-Edinburg-Mission, TX",1990,1217,185,1402,386786,3.62474339815815
32580,"McAllen-Edinburg-Mission, TX",1991,3401,177,3578,401415,8.91346860481048
32580,"McAllen-Edinburg-Mission, TX",1992,3230,358,3588,420236,8.5380595665292809
32580,"McAllen-Edinburg-Mission, TX",1993,5565,622,6187,441316,14.0194327873904
32580,"McAllen-Edinburg-Mission, TX",1994,3995,645,4640,460445,10.0772079184267
32580,"McAllen-Edinburg-Mission, TX",1995,3761,749,4510,476752,9.45984495083398
32580,"McAllen-Edinburg-Mission, TX",1996,4287,1052,5339,490120,10.8932506324982
32580,"McAllen-Edinburg-Mission, TX",1997,4155,1121,5276,504025,10.4677347353802
32580,"McAllen-Edinburg-Mission, TX",1998,5219,997,6216,519287,11.9702592208162
32580,"McAllen-Edinburg-Mission, TX",1999,5069,631,5700,534333,10.6675050951373
32580,"McAllen-Edinburg-Mission, TX",2000,5038,621,5659,573216,9.87236922905153
32580,"McAllen-Edinburg-Mission, TX",2001,5626,1279,6905,590067,11.7020609524003
32580,"McAllen-Edinburg-Mission, TX",2002,6418,1059,7477,610520,12.2469370372797
32580,"McAllen-Edinburg-Mission, TX",2003,6461,1599,8060,632475,12.7435867030317
32580,"McAllen-Edinburg-Mission, TX",2004,6744,2570,9314,653779,14.2464043660014
32580,"McAllen-Edinburg-Mission, TX",2005,6741,2148,8889,674982,13.1692400686241
32580,"McAllen-Edinburg-Mission, TX",2006,6870,1176,8046,695352,11.57111793739
32580,"McAllen-Edinburg-Mission, TX",2007,5079,1379,6458,715264,9.02883410880458
32580,"McAllen-Edinburg-Mission, TX",2008,3137,557,3694,736694,5.01429358729676
32580,"McAllen-Edinburg-Mission, TX",2009,2784,372,3156,757468,4.16651264475859
32580,"McAllen-Edinburg-Mission, TX",2010,3096,456,3552,779213,4.55844550848099
32580,"McAllen-Edinburg-Mission, TX",2011,2922,183,3105,795741,3.9020233970601
32580,"McAllen-Edinburg-Mission, TX",2012,2833,659,3492,808835,4.31732059072617
32580,"McAllen-Edinburg-Mission, TX",2013,2545,749,3294,819374,4.02014220612321
32580,"McAllen-Edinburg-Mission, TX",2014,2840,633,3473,830824,4.18018738023938
32580,"McAllen-Edinburg-Mission, TX",2015,2929,1377,4306,841061,5.11972377746679
32580,"McAllen-Edinburg-Mission, TX",2016,2921,1647,4568,850798,5.3690770312107
32580,"McAllen-Edinburg-Mission, TX",2017,2698,1599,4297,858323,5.00627386193776
32580,"McAllen-Edinburg-Mission, TX",2018,2959,1683,4642,865939,5.36065473434041
32620,"McComb, MS",1990,14,4,18,50078,0.359439274731419
32620,"McComb, MS",1991,14,51,65,50089,1.29769011160135
32620,"McComb, MS",1992,24,0,24,50357,0.476597096729352
32620,"McComb, MS",1993,20,2,22,50866,0.432508945071364
32620,"McComb, MS",1994,15,0,15,50901,0.294689691754582
32620,"McComb, MS",1995,21,0,21,51511,0.407679913028285
32620,"McComb, MS",1996,20,0,20,51416,0.388983973860277
32620,"McComb, MS",1997,15,2,17,51609,0.329399910868259
32620,"McComb, MS",1998,19,0,19,51784,0.366908697667233
32620,"McComb, MS",1999,17,0,17,51989,0.32699224836023
32620,"McComb, MS",2000,16,0,16,52541,0.304524085951923
32620,"McComb, MS",2001,12,0,12,52210,0.229841026623252
32620,"McComb, MS",2002,15,0,15,52135,0.287714587129567
32620,"McComb, MS",2003,17,24,41,52064,0.787492317148125
32620,"McComb, MS",2004,19,5,24,52037,0.461210292676365
32620,"McComb, MS",2005,66,72,138,52301,2.63857287623564
32620,"McComb, MS",2006,68,76,144,53827,2.67523733442324
32620,"McComb, MS",2007,14,112,126,53541,2.3533366952429
32620,"McComb, MS",2008,7,86,93,53614,1.7346215540717
32620,"McComb, MS",2009,4,41,45,53503,0.841074332280433
32620,"McComb, MS",2010,1,61,62,53578,1.1571913845235
32620,"McComb, MS",2011,3,0,3,53571,0.056000448003584
32620,"McComb, MS",2012,1,0,1,53026,0.0188586731037604
32620,"McComb, MS",2013,1,0,1,52799,0.0189397526468304
32620,"McComb, MS",2014,2,0,2,52555,0.0380553705641709
32620,"McComb, MS",2015,1,192,193,52473,3.67808206125055
32620,"McComb, MS",2016,3,188,191,52064,3.66856177012907
32620,"McComb, MS",2017,2,214,216,52046,4.15017484532913
32620,"McComb, MS",2018,1,187,188,51889,3.62311858004587
32660,"McMinnville, TN",1990,26,26,52,33062,1.57280261327203
32660,"McMinnville, TN",1991,26,22,48,33428,1.43592198157233
32660,"McMinnville, TN",1992,38,10,48,33456,1.43472022955524
32660,"McMinnville, TN",1993,36,26,62,33998,1.82363668451085
32660,"McMinnville, TN",1994,23,18,41,34654,1.18312460322041
32660,"McMinnville, TN",1995,21,42,63,35131,1.79328797927756
32660,"McMinnville, TN",1996,28,54,82,35302,2.32281457141238
32660,"McMinnville, TN",1997,31,80,111,35762,3.10385325205525
32660,"McMinnville, TN",1998,29,48,77,36094,2.1333185571009
32660,"McMinnville, TN",1999,141,12,153,36378,4.20583869371598
32660,"McMinnville, TN",2000,59,0,59,38371,1.53761955643585
32660,"McMinnville, TN",2001,31,0,31,38566,0.803816833480268
32660,"McMinnville, TN",2002,20,0,20,38500,0.519480519480519
32660,"McMinnville, TN",2003,29,2,31,38828,0.798392912331307
32660,"McMinnville, TN",2004,22,56,78,38864,2.00699876492384
32660,"McMinnville, TN",2005,29,0,29,38987,0.743837689486239
32660,"McMinnville, TN",2006,29,0,29,39190,0.739984689971932
32660,"McMinnville, TN",2007,20,17,37,39365,0.939921249841229
32660,"McMinnville, TN",2008,32,92,124,39534,3.13654069914504
32660,"McMinnville, TN",2009,11,2,13,39709,0.327381701881186
32660,"McMinnville, TN",2010,9,0,9,39860,0.225790265930758
32660,"McMinnville, TN",2011,40,2,42,39903,1.05255243966619
32660,"McMinnville, TN",2012,40,0,40,39745,1.00641590137124
32660,"McMinnville, TN",2013,53,2,55,39898,1.37851521379518
32660,"McMinnville, TN",2014,50,2,52,39991,1.30029256582731
32660,"McMinnville, TN",2015,52,0,52,40269,1.29131590056868
32660,"McMinnville, TN",2016,70,0,70,40443,1.73083104616374
32660,"McMinnville, TN",2017,77,0,77,40690,1.89235684443352
32660,"McMinnville, TN",2018,88,0,88,40878,2.15274719898234
32700,"McPherson, KS",1990,69,14,83,27325,3.03751143641354
32700,"McPherson, KS",1991,54,33,87,27248,3.19289489136817
32700,"McPherson, KS",1992,72,14,86,27691,3.10570221371565
32700,"McPherson, KS",1993,63,45,108,27824,3.88154111558367
32700,"McPherson, KS",1994,100,17,117,28220,4.14599574769667
32700,"McPherson, KS",1995,113,33,146,28441,5.13343412678879
32700,"McPherson, KS",1996,119,12,131,28492,4.59778183349712
32700,"McPherson, KS",1997,79,10,89,28528,3.11974200785194
32700,"McPherson, KS",1998,85,6,91,28583,3.18371059720813
32700,"McPherson, KS",1999,92,4,96,28875,3.32467532467532
32700,"McPherson, KS",2000,103,4,107,29572,3.61828756932233
32700,"McPherson, KS",2001,96,98,194,29489,6.5787242700668
32700,"McPherson, KS",2002,91,5,96,29237,3.28351062010466
32700,"McPherson, KS",2003,98,9,107,29239,3.65949587879202
32700,"McPherson, KS",2004,126,2,128,29276,4.37218199207542
32700,"McPherson, KS",2005,116,15,131,29375,4.45957446808511
32700,"McPherson, KS",2006,98,0,98,29174,3.35915541235347
32700,"McPherson, KS",2007,79,10,89,29250,3.04273504273504
32700,"McPherson, KS",2008,38,6,44,29095,1.51228733459357
32700,"McPherson, KS",2009,43,9,52,29222,1.77948121278489
32700,"McPherson, KS",2010,52,4,56,29126,1.92268076632562
32700,"McPherson, KS",2011,41,8,49,29149,1.68101821674843
32700,"McPherson, KS",2012,70,10,80,29217,2.73813190950474
32700,"McPherson, KS",2013,60,12,72,29412,2.44798041615667
32700,"McPherson, KS",2014,46,78,124,28893,4.29169695081854
32700,"McPherson, KS",2015,54,135,189,28634,6.60054480687295
32700,"McPherson, KS",2016,62,127,189,28411,6.65235296188096
32700,"McPherson, KS",2017,61,2,63,28673,2.19718899312943
32700,"McPherson, KS",2018,56,0,56,28537,1.96236464940253
32740,"Meadville, PA",1990,160,52,212,86180,2.45996750986308
32740,"Meadville, PA",1991,193,48,241,86534,2.78503247278526
32740,"Meadville, PA",1992,191,54,245,86612,2.82870733847504
32740,"Meadville, PA",1993,200,0,200,87428,2.2875966509585
32740,"Meadville, PA",1994,228,3,231,88092,2.62225854788176
32740,"Meadville, PA",1995,214,14,228,88785,2.56800135157966
32740,"Meadville, PA",1996,426,28,454,88964,5.10318780630367
32740,"Meadville, PA",1997,207,36,243,89104,2.72715029628299
32740,"Meadville, PA",1998,275,10,285,89064,3.19994610617084
32740,"Meadville, PA",1999,212,0,212,89183,2.37713465570793
32740,"Meadville, PA",2000,227,13,240,90306,2.65763072221115
32740,"Meadville, PA",2001,219,5,224,90105,2.48598856889185
32740,"Meadville, PA",2002,285,34,319,90031,3.54322400062201
32740,"Meadville, PA",2003,252,2,254,89846,2.82705963537609
32740,"Meadville, PA",2004,280,20,300,89682,3.34515287348632
32740,"Meadville, PA",2005,146,16,162,89452,1.81102714304879
32740,"Meadville, PA",2006,147,45,192,89496,2.14534727809064
32740,"Meadville, PA",2007,154,24,178,89544,1.98784954882516
32740,"Meadville, PA",2008,91,15,106,89023,1.19070352605506
32740,"Meadville, PA",2009,62,0,62,89044,0.696284982705179
32740,"Meadville, PA",2010,96,12,108,88613,1.21878279710652
32740,"Meadville, PA",2011,60,0,60,88155,0.680619363620895
32740,"Meadville, PA",2012,54,0,54,87719,0.615602093047116
32740,"Meadville, PA",2013,39,0,39,87503,0.445699004605556
32740,"Meadville, PA",2014,63,10,73,87151,0.837626648001744
32740,"Meadville, PA",2015,57,0,57,86510,0.658883366084846
32740,"Meadville, PA",2016,69,0,69,86306,0.799480916738118
32740,"Meadville, PA",2017,80,0,80,85788,0.932531356366858
32740,"Meadville, PA",2018,52,0,52,85063,0.611311616096305
32780,"Medford, OR",1990,933,578,1511,147305,10.2576287295068
32780,"Medford, OR",1991,882,279,1161,150508,7.71387567438276
32780,"Medford, OR",1992,902,97,999,154147,6.48082674330347
32780,"Medford, OR",1993,1134,277,1411,157829,8.94005537638837
32780,"Medford, OR",1994,1250,628,1878,161884,11.6008994094537
32780,"Medford, OR",1995,1044,257,1301,165305,7.87030035389129
32780,"Medford, OR",1996,1000,276,1276,168202,7.58611669302386
32780,"Medford, OR",1997,983,188,1171,170567,6.86533737475596
32780,"Medford, OR",1998,1166,187,1353,173229,7.81047053322481
32780,"Medford, OR",1999,1316,441,1757,175386,10.0179033674296
32780,"Medford, OR",2000,1140,211,1351,181775,7.43226516297621
32780,"Medford, OR",2001,1289,313,1602,183835,8.71433622541953
32780,"Medford, OR",2002,1439,109,1548,186704,8.29119890307653
32780,"Medford, OR",2003,1754,384,2138,189838,11.2622341154037
32780,"Medford, OR",2004,1791,308,2099,192185,10.9217680880402
32780,"Medford, OR",2005,1707,329,2036,194701,10.4570597993847
32780,"Medford, OR",2006,1067,266,1333,196858,6.7713783539404
32780,"Medford, OR",2007,1020,118,1138,199152,5.71422832811119
32780,"Medford, OR",2008,370,79,449,201162,2.23203189469184
32780,"Medford, OR",2009,317,4,321,202301,1.586744504476
32780,"Medford, OR",2010,293,80,373,203343,1.83433902322676
32780,"Medford, OR",2011,254,108,362,204738,1.7681133937031701
32780,"Medford, OR",2012,368,181,549,205860,2.66686097347712
32780,"Medford, OR",2013,555,89,644,207173,3.10851317497937
32780,"Medford, OR",2014,590,157,747,209226,3.57030197011844
32780,"Medford, OR",2015,604,113,717,211432,3.39116122441258
32780,"Medford, OR",2016,727,185,912,214353,4.25466403549285
32780,"Medford, OR",2017,724,81,805,216761,3.71376769806377
32780,"Medford, OR",2018,681,252,933,219564,4.24933049133738
32820,"Memphis, TN-MS-AR",1990,5057,1250,6307,1078009,5.85060050519059
32820,"Memphis, TN-MS-AR",1991,5371,506,5877,1088748,5.39794332572827
32820,"Memphis, TN-MS-AR",1992,6914,327,7241,1098967,6.58891486277568
32820,"Memphis, TN-MS-AR",1993,7571,389,7960,1109342,7.17542471122521
32820,"Memphis, TN-MS-AR",1994,7041,627,7668,1122407,6.83174641640688
32820,"Memphis, TN-MS-AR",1995,7343,2122,9465,1135035,8.33894990022334
32820,"Memphis, TN-MS-AR",1996,6451,3699,10150,1145859,8.85798339935367
32820,"Memphis, TN-MS-AR",1997,6662,1602,8264,1154179,7.1600678924153
32820,"Memphis, TN-MS-AR",1998,7915,963,8878,1166055,7.61370604302541
32820,"Memphis, TN-MS-AR",1999,8230,2822,11052,1179139,9.37294076440521
32820,"Memphis, TN-MS-AR",2000,6313,4426,10739,1216257,8.8295483602561
32820,"Memphis, TN-MS-AR",2001,6448,1612,8060,1224627,6.5815958655166
32820,"Memphis, TN-MS-AR",2002,7463,1622,9085,1235125,7.35553081671896
32820,"Memphis, TN-MS-AR",2003,8548,1058,9606,1247414,7.70073127285729
32820,"Memphis, TN-MS-AR",2004,8891,1240,10131,1258948,8.04719495960119
32820,"Memphis, TN-MS-AR",2005,9712,1082,10794,1271965,8.48608255730307
32820,"Memphis, TN-MS-AR",2006,8615,1636,10251,1291868,7.93502122507872
32820,"Memphis, TN-MS-AR",2007,5676,2402,8078,1302273,6.20300044614301
32820,"Memphis, TN-MS-AR",2008,2335,771,3106,1310829,2.36949289342851
32820,"Memphis, TN-MS-AR",2009,1570,464,2034,1317719,1.5435764377686
32820,"Memphis, TN-MS-AR",2010,1653,776,2429,1326188,1.83156535875758
32820,"Memphis, TN-MS-AR",2011,1645,565,2210,1332647,1.65835363753492
32820,"Memphis, TN-MS-AR",2012,2220,1287,3507,1340380,2.6164222086274
32820,"Memphis, TN-MS-AR",2013,2470,1182,3652,1341457,2.72241301808407
32820,"Memphis, TN-MS-AR",2014,2539,615,3154,1342777,2.34886358643319
32820,"Memphis, TN-MS-AR",2015,2573,1378,3951,1343842,2.94007777700057
32820,"Memphis, TN-MS-AR",2016,3002,1352,4354,1345143,3.2368305823247
32820,"Memphis, TN-MS-AR",2017,3193,667,3860,1347576,2.86440245299709
32820,"Memphis, TN-MS-AR",2018,3185,1307,4492,1350620,3.32587996623773
32860,"Menomonie, WI",1990,62,32,94,35988,2.61198177170168
32860,"Menomonie, WI",1991,84,6,90,36223,2.48460922618226
32860,"Menomonie, WI",1992,102,54,156,36480,4.27631578947368
32860,"Menomonie, WI",1993,129,54,183,37219,4.91684354765039
32860,"Menomonie, WI",1994,108,148,256,37534,6.82048276229552
32860,"Menomonie, WI",1995,94,38,132,37970,3.47642875954701
32860,"Menomonie, WI",1996,138,112,250,38429,6.50550365609305
32860,"Menomonie, WI",1997,94,54,148,38692,3.82508011992143
32860,"Menomonie, WI",1998,157,78,235,39047,6.01838809639665
32860,"Menomonie, WI",1999,138,58,196,39117,5.01060919804689
32860,"Menomonie, WI",2000,219,86,305,39952,7.63416099319183
32860,"Menomonie, WI",2001,207,105,312,40599,7.68491834774256
32860,"Menomonie, WI",2002,207,162,369,40947,9.01164920506997
32860,"Menomonie, WI",2003,224,92,316,41222,7.66580951918878
32860,"Menomonie, WI",2004,271,152,423,41690,10.1463180618853
32860,"Menomonie, WI",2005,271,81,352,41988,8.38334762313042
32860,"Menomonie, WI",2006,179,60,239,42828,5.58046138040534
32860,"Menomonie, WI",2007,149,20,169,43148,3.91675164549921
32860,"Menomonie, WI",2008,88,14,102,43382,2.35120556913005
32860,"Menomonie, WI",2009,56,20,76,43570,1.74431948588478
32860,"Menomonie, WI",2010,66,8,74,43887,1.68614851778431
32860,"Menomonie, WI",2011,64,12,76,43796,1.73531829390812
32860,"Menomonie, WI",2012,48,18,66,43804,1.50671171582504
32860,"Menomonie, WI",2013,71,34,105,44048,2.38376316745369
32860,"Menomonie, WI",2014,66,2,68,44076,1.54278972683547
32860,"Menomonie, WI",2015,80,107,187,44249,4.22608420529277
32860,"Menomonie, WI",2016,74,48,122,44337,2.75165211899768
32860,"Menomonie, WI",2017,98,2,100,44699,2.23718651423969
32860,"Menomonie, WI",2018,100,4,104,45131,2.30440273869402
32900,"Merced, CA",1990,1061,117,1178,179814,6.5512140322778
32900,"Merced, CA",1991,795,194,989,185373,5.33518905126421
32900,"Merced, CA",1992,1378,77,1455,188173,7.73224639028979
32900,"Merced, CA",1993,1096,22,1118,191204,5.84715800924667
32900,"Merced, CA",1994,1054,12,1066,195216,5.46061798213261
32900,"Merced, CA",1995,780,2,782,192149,4.06975836460247
32900,"Merced, CA",1996,843,32,875,191095,4.57887438185196
32900,"Merced, CA",1997,897,184,1081,193925,5.5743199690602
32900,"Merced, CA",1998,979,15,994,197185,5.04095139082587
32900,"Merced, CA",1999,1001,0,1001,200927,4.98190885246881
32900,"Merced, CA",2000,1344,36,1380,212258,6.50152173298533
32900,"Merced, CA",2001,1090,2,1092,218816,4.99049429657795
32900,"Merced, CA",2002,1674,79,1753,225351,7.77897590869355
32900,"Merced, CA",2003,2465,277,2742,231735,11.8324810667357
32900,"Merced, CA",2004,2544,54,2598,237180,10.953706046041
32900,"Merced, CA",2005,3479,186,3665,242554,15.1100373525071
32900,"Merced, CA",2006,2136,80,2216,245338,9.03243688299407
32900,"Merced, CA",2007,780,14,794,248540,3.19465679568681
32900,"Merced, CA",2008,244,105,349,250538,1.39300225913833
32900,"Merced, CA",2009,94,5,99,252302,0.3923869014118
32900,"Merced, CA",2010,104,2,106,256732,0.412881915772089
32900,"Merced, CA",2011,87,70,157,259333,0.605399235731665
32900,"Merced, CA",2012,71,66,137,260971,0.524962543730913
32900,"Merced, CA",2013,99,55,154,262198,0.587342390102137
32900,"Merced, CA",2014,163,6,169,264649,0.638581668549664
32900,"Merced, CA",2015,228,4,232,266651,0.870051115503036
32900,"Merced, CA",2016,611,109,720,267971,2.68685790626598
32900,"Merced, CA",2017,546,4,550,271340,2.02697722414683
32900,"Merced, CA",2018,630,0,630,274765,2.29286845122195
32940,"Meridian, MS",1990,45,24,69,103151,0.668922259600004
32940,"Meridian, MS",1991,40,22,62,103321,0.600071621451593
32940,"Meridian, MS",1992,47,113,160,103807,1.54132187617405
32940,"Meridian, MS",1993,55,16,71,104107,0.681990644241021
32940,"Meridian, MS",1994,45,70,115,104238,1.10324449816765
32940,"Meridian, MS",1995,28,27,55,105091,0.523355948654024
32940,"Meridian, MS",1996,37,11,48,105083,0.456781782019927
32940,"Meridian, MS",1997,47,140,187,105067,1.77981668839883
32940,"Meridian, MS",1998,33,32,65,104724,0.620679118444674
32940,"Meridian, MS",1999,69,4,73,105054,0.694880728006549
32940,"Meridian, MS",2000,65,40,105,106387,0.986962692810212
32940,"Meridian, MS",2001,43,0,43,106048,0.405476765238383
32940,"Meridian, MS",2002,73,0,73,106016,0.688575309387262
32940,"Meridian, MS",2003,50,7,57,105940,0.538040400226543
32940,"Meridian, MS",2004,189,57,246,95188,2.58435937303021
32940,"Meridian, MS",2005,232,152,384,94987,4.04265846905366
32940,"Meridian, MS",2006,420,73,493,95039,5.1873441429308
32940,"Meridian, MS",2007,264,12,276,95651,2.88548995828585
32940,"Meridian, MS",2008,199,3,202,96437,2.09463172848595
32940,"Meridian, MS",2009,102,0,102,96946,1.05213211478555
32940,"Meridian, MS",2010,112,0,112,97119,1.15322439481461
32940,"Meridian, MS",2011,143,0,143,97324,1.4693189757922
32940,"Meridian, MS",2012,114,0,114,96775,1.17799018341514
32940,"Meridian, MS",2013,118,0,118,96644,1.22097595298208
32940,"Meridian, MS",2014,118,0,118,95545,1.23502014757444
32940,"Meridian, MS",2015,115,0,115,94365,1.21867217718434
32940,"Meridian, MS",2016,67,2,69,93270,0.739787713091026
32940,"Meridian, MS",2017,42,2,44,92153,0.477466821481666
32940,"Meridian, MS",2018,75,2,77,90921,0.846889057533463
32980,"Merrill, WI",1990,125,95,220,27083,8.12317690063878
32980,"Merrill, WI",1991,105,2,107,27530,3.88666908826734
32980,"Merrill, WI",1992,169,4,173,27954,6.1887386420548
32980,"Merrill, WI",1993,174,25,199,28343,7.02113396605864
32980,"Merrill, WI",1994,189,10,199,28771,6.91668694171214
32980,"Merrill, WI",1995,201,38,239,29024,8.2345644983462
32980,"Merrill, WI",1996,180,36,216,29315,7.36824151458298
32980,"Merrill, WI",1997,182,54,236,29533,7.99106084718789
32980,"Merrill, WI",1998,236,0,236,29673,7.95335827182961
32980,"Merrill, WI",1999,208,10,218,29914,7.28755766530721
32980,"Merrill, WI",2000,211,8,219,29670,7.38119312436805
32980,"Merrill, WI",2001,203,10,213,29548,7.20860971977799
32980,"Merrill, WI",2002,211,6,217,29641,7.32094058904895
32980,"Merrill, WI",2003,217,10,227,29621,7.66348198912933
32980,"Merrill, WI",2004,223,4,227,29666,7.65185734510888
32980,"Merrill, WI",2005,214,4,218,29602,7.36436727248159
32980,"Merrill, WI",2006,178,4,182,29457,6.17849747088977
32980,"Merrill, WI",2007,131,4,135,29272,4.61191582399563
32980,"Merrill, WI",2008,91,0,91,29094,3.1277926720286
32980,"Merrill, WI",2009,67,4,71,28833,2.46245621336663
32980,"Merrill, WI",2010,70,2,72,28777,2.50199812350141
32980,"Merrill, WI",2011,57,0,57,28500,2
32980,"Merrill, WI",2012,68,0,68,28499,2.38604863328538
32980,"Merrill, WI",2013,77,0,77,28301,2.7207519168934
32980,"Merrill, WI",2014,77,0,77,28104,2.73982351266724
32980,"Merrill, WI",2015,85,12,97,27858,3.48194414530835
32980,"Merrill, WI",2016,90,12,102,27821,3.6662952445994
32980,"Merrill, WI",2017,90,0,90,27766,3.24137434272131
32980,"Merrill, WI",2018,96,36,132,27689,4.76723608653256
33020,"Mexico, MO",1990,20,4,24,23583,1.01768222872408
33020,"Mexico, MO",1991,34,6,40,23607,1.6944126742068
33020,"Mexico, MO",1992,29,10,39,23507,1.65908027396095
33020,"Mexico, MO",1993,21,4,25,23539,1.0620672076129
33020,"Mexico, MO",1994,37,17,54,23512,2.29669955767268
33020,"Mexico, MO",1995,24,90,114,23385,4.87491982039769
33020,"Mexico, MO",1996,49,20,69,23471,2.93979804865579
33020,"Mexico, MO",1997,26,16,42,23460,1.79028132992327
33020,"Mexico, MO",1998,34,0,34,23610,1.44006776789496
33020,"Mexico, MO",1999,28,0,28,23520,1.19047619047619
33020,"Mexico, MO",2000,17,3,20,25862,0.773335395561055
33020,"Mexico, MO",2001,20,0,20,25784,0.775674837108284
33020,"Mexico, MO",2002,19,0,19,25800,0.736434108527132
33020,"Mexico, MO",2003,35,10,45,25728,1.7490671641791
33020,"Mexico, MO",2004,30,2,32,25555,1.25220113480728
33020,"Mexico, MO",2005,15,2,17,25725,0.660835762876579
33020,"Mexico, MO",2006,30,2,32,25869,1.23700181684642
33020,"Mexico, MO",2007,22,3,25,25658,0.974354977005222
33020,"Mexico, MO",2008,14,8,22,25774,0.853573368510902
33020,"Mexico, MO",2009,1,0,1,25628,0.0390198220696114
33020,"Mexico, MO",2010,6,2,8,25451,0.314329495894071
33020,"Mexico, MO",2011,12,2,14,25529,0.54839594187003
33020,"Mexico, MO",2012,6,8,14,25530,0.54837446141794
33020,"Mexico, MO",2013,5,10,15,25544,0.587222048230504
33020,"Mexico, MO",2014,3,0,3,25815,0.116211504938989
33020,"Mexico, MO",2015,26,2,28,25937,1.07953888267726
33020,"Mexico, MO",2016,9,26,35,25848,1.35406994738471
33020,"Mexico, MO",2017,14,42,56,25600,2.1875
33020,"Mexico, MO",2018,14,2,16,25473,0.62811604443921
33060,"Miami, OK",1990,22,7,29,30563,0.948859732356117
33060,"Miami, OK",1991,17,5,22,30440,0.722733245729304
33060,"Miami, OK",1992,32,0,32,30305,1.05593136446131
33060,"Miami, OK",1993,17,5,22,30295,0.726192440996864
33060,"Miami, OK",1994,18,13,31,30537,1.01516193470216
33060,"Miami, OK",1995,9,0,9,30706,0.293102325278447
33060,"Miami, OK",1996,11,0,11,30521,0.360407588217948
33060,"Miami, OK",1997,16,0,16,30690,0.521342456826328
33060,"Miami, OK",1998,16,0,16,30915,0.517548115801391
33060,"Miami, OK",1999,18,0,18,30854,0.58339275296558
33060,"Miami, OK",2000,7,8,15,33214,0.451616788101403
33060,"Miami, OK",2001,16,9,25,33047,0.756498320573728
33060,"Miami, OK",2002,18,28,46,32660,1.40845070422535
33060,"Miami, OK",2003,19,18,37,32495,1.13863671334051
33060,"Miami, OK",2004,22,2,24,32530,0.737780510298186
33060,"Miami, OK",2005,27,12,39,32655,1.19430408819476
33060,"Miami, OK",2006,18,2,20,32971,0.606593673227988
33060,"Miami, OK",2007,14,6,20,32441,0.616503806911008
33060,"Miami, OK",2008,12,2,14,31838,0.439726113449337
33060,"Miami, OK",2009,7,0,7,31883,0.219552739704545
33060,"Miami, OK",2010,31,0,31,31856,0.973129080863887
33060,"Miami, OK",2011,8,0,8,31856,0.251130085384229
33060,"Miami, OK",2012,3,0,3,32140,0.0933416303671437
33060,"Miami, OK",2013,1,2,3,32130,0.0933706816059757
33060,"Miami, OK",2014,8,0,8,31905,0.25074439742987
33060,"Miami, OK",2015,8,0,8,31845,0.251216831527712
33060,"Miami, OK",2016,8,0,8,31578,0.25334093356134
33060,"Miami, OK",2017,9,2,11,31325,0.351157222665603
33060,"Miami, OK",2018,10,0,10,31175,0.320769847634322
33100,"Miami-Fort Lauderdale-West Palm Beach, FL",1990,11122,9488,20610,2131937,9.66726502706224
33100,"Miami-Fort Lauderdale-West Palm Beach, FL",1991,10067,3964,14031,2180100,6.43594330535297
33100,"Miami-Fort Lauderdale-West Palm Beach, FL",1992,13135,3900,17035,2224128,7.65918148595764
33100,"Miami-Fort Lauderdale-West Palm Beach, FL",1993,16854,5017,21871,2288314,9.55769182026593
33100,"Miami-Fort Lauderdale-West Palm Beach, FL",1994,19250,8121,27371,2345259,11.6707792188411
33100,"Miami-Fort Lauderdale-West Palm Beach, FL",1995,15601,7554,23155,2390981,9.68430949472204
33100,"Miami-Fort Lauderdale-West Palm Beach, FL",1996,17912,6478,24390,2436430,10.0105482201418
33100,"Miami-Fort Lauderdale-West Palm Beach, FL",1997,13684,8281,21965,2490828,8.81835277265231
33100,"Miami-Fort Lauderdale-West Palm Beach, FL",1998,15140,7078,22218,2539297,8.74966575394686
33100,"Miami-Fort Lauderdale-West Palm Beach, FL",1999,21713,14375,36088,4765886,7.57214922891567
33100,"Miami-Fort Lauderdale-West Palm Beach, FL",2000,21927,13022,34949,5025895,6.95378634054233
33100,"Miami-Fort Lauderdale-West Palm Beach, FL",2001,22641,12891,35532,5110780,6.95236343571823
33100,"Miami-Fort Lauderdale-West Palm Beach, FL",2002,21516,18078,39594,5197205,7.61832561925112
33100,"Miami-Fort Lauderdale-West Palm Beach, FL",2003,23540,16055,39595,5261713,7.52511587005981
33100,"Miami-Fort Lauderdale-West Palm Beach, FL",2004,24653,21431,46084,5336368,8.63583620919697
33100,"Miami-Fort Lauderdale-West Palm Beach, FL",2005,22220,23342,45562,5411148,8.42002473412296
33100,"Miami-Fort Lauderdale-West Palm Beach, FL",2006,14750,20360,35110,5429748,6.46623010865329
33100,"Miami-Fort Lauderdale-West Palm Beach, FL",2007,7101,8044,15145,5422987,2.79274134346994
33100,"Miami-Fort Lauderdale-West Palm Beach, FL",2008,3272,4549,7821,5454633,1.43382698707686
33100,"Miami-Fort Lauderdale-West Palm Beach, FL",2009,2289,1586,3875,5504624,0.703953621537093
33100,"Miami-Fort Lauderdale-West Palm Beach, FL",2010,3171,2706,5877,5583547,1.05255673499301
33100,"Miami-Fort Lauderdale-West Palm Beach, FL",2011,4303,3229,7532,5693531,1.32290488977754
33100,"Miami-Fort Lauderdale-West Palm Beach, FL",2012,5089,8172,13261,5771731,2.29757762445963
33100,"Miami-Fort Lauderdale-West Palm Beach, FL",2013,6369,13552,19921,5849411,3.40564203814709
33100,"Miami-Fort Lauderdale-West Palm Beach, FL",2014,5791,9468,15259,5921030,2.57708540574866
33100,"Miami-Fort Lauderdale-West Palm Beach, FL",2015,7142,16308,23450,5998284,3.90945143644416
33100,"Miami-Fort Lauderdale-West Palm Beach, FL",2016,6705,12037,18742,6086935,3.07905374379717
33100,"Miami-Fort Lauderdale-West Palm Beach, FL",2017,6655,13068,19723,6149687,3.20715509586098
33100,"Miami-Fort Lauderdale-West Palm Beach, FL",2018,7022,12531,19553,6198782,3.15432935050789
33180,"Middlesborough, KY",1990,63,0,63,31467,2.00209743540852
33180,"Middlesborough, KY",1991,71,0,71,31114,2.28193096355338
33180,"Middlesborough, KY",1992,71,46,117,30790,3.7999350438454
33180,"Middlesborough, KY",1993,105,8,113,30768,3.67264690587623
33180,"Middlesborough, KY",1994,85,20,105,30658,3.42488094461478
33180,"Middlesborough, KY",1995,58,31,89,30320,2.9353562005277
33180,"Middlesborough, KY",1996,57,21,78,30044,2.59619225136466
33180,"Middlesborough, KY",1997,42,14,56,29778,1.88058298072402
33180,"Middlesborough, KY",1998,62,10,72,29137,2.47108487490133
33180,"Middlesborough, KY",1999,61,6,67,29012,2.30938921825452
33180,"Middlesborough, KY",2000,65,4,69,30015,2.29885057471264
33180,"Middlesborough, KY",2001,62,4,66,29561,2.23267142518859
33180,"Middlesborough, KY",2002,62,4,66,29691,2.22289582701829
33180,"Middlesborough, KY",2003,59,4,63,29478,2.1371870547527
33180,"Middlesborough, KY",2004,58,2,60,29275,2.04953031596926
33180,"Middlesborough, KY",2005,54,0,54,29130,1.85375901132853
33180,"Middlesborough, KY",2006,32,0,32,28960,1.10497237569061
33180,"Middlesborough, KY",2007,20,0,20,28794,0.694589150517469
33180,"Middlesborough, KY",2008,22,0,22,28836,0.762935219864059
33180,"Middlesborough, KY",2009,20,8,28,28667,0.976732828688038
33180,"Middlesborough, KY",2010,22,0,22,28709,0.766310216308475
33180,"Middlesborough, KY",2011,19,0,19,28657,0.663014272254598
33180,"Middlesborough, KY",2012,14,0,14,28296,0.494769578739044
33180,"Middlesborough, KY",2013,21,0,21,28047,0.748743181088886
33180,"Middlesborough, KY",2014,20,0,20,27847,0.718210220131432
33180,"Middlesborough, KY",2015,20,0,20,27391,0.730166843123654
33180,"Middlesborough, KY",2016,26,0,26,27231,0.954794168411002
33180,"Middlesborough, KY",2017,28,0,28,26904,1.04073743681237
33180,"Middlesborough, KY",2018,34,0,34,26569,1.27968685309948
33220,"Midland, MI",1990,348,109,457,75990,6.01394920384261
33220,"Midland, MI",1991,393,80,473,76672,6.16913606010017
33220,"Midland, MI",1992,379,16,395,77740,5.08103936197582
33220,"Midland, MI",1993,403,99,502,78451,6.39889867560643
33220,"Midland, MI",1994,386,106,492,79137,6.21706660601236
33220,"Midland, MI",1995,249,14,263,79575,3.30505812126924
33220,"Midland, MI",1996,307,17,324,80577,4.02099854797275
33220,"Midland, MI",1997,283,4,287,81275,3.53122116271916
33220,"Midland, MI",1998,236,52,288,81657,3.52694808773283
33220,"Midland, MI",1999,242,58,300,82122,3.6531014831592
33220,"Midland, MI",2000,234,65,299,82913,3.60618962044553
33220,"Midland, MI",2001,251,96,347,83576,4.15190963913085
33220,"Midland, MI",2002,238,0,238,83664,2.84471218206158
33220,"Midland, MI",2003,239,16,255,84012,3.0352806741894
33220,"Midland, MI",2004,211,13,224,84058,2.66482666730115
33220,"Midland, MI",2005,198,0,198,83930,2.35910878112713
33220,"Midland, MI",2006,175,4,179,83693,2.1387690726823
33220,"Midland, MI",2007,117,20,137,83600,1.63875598086124
33220,"Midland, MI",2008,97,0,97,83605,1.16021769032953
33220,"Midland, MI",2009,70,2,72,83639,0.860842429966882
33220,"Midland, MI",2010,113,10,123,83658,1.47027182098544
33220,"Midland, MI",2011,131,14,145,83800,1.73031026252983
33220,"Midland, MI",2012,194,2,196,83715,2.34127695156185
33220,"Midland, MI",2013,138,62,200,83645,2.39105744515512
33220,"Midland, MI",2014,107,155,262,83479,3.13851387774171
33220,"Midland, MI",2015,108,22,130,83626,1.55454045392581
33220,"Midland, MI",2016,109,92,201,83384,2.41053439508779
33220,"Midland, MI",2017,118,24,142,83245,1.70580815664604
33220,"Midland, MI",2018,84,4,88,83209,1.0575779062361
33260,"Midland, TX",1990,220,0,220,111651,1.97042570151633
33260,"Midland, TX",1991,225,0,225,113568,1.98119188503804
33260,"Midland, TX",1992,177,0,177,115581,1.53139356814701
33260,"Midland, TX",1993,274,0,274,116831,2.3452679511431
33260,"Midland, TX",1994,227,0,227,118224,1.92008390851265
33260,"Midland, TX",1995,249,0,249,119111,2.09048702470805
33260,"Midland, TX",1996,292,0,292,119930,2.43475360627032
33260,"Midland, TX",1997,268,2,270,122568,2.20285882122577
33260,"Midland, TX",1998,246,0,246,124211,1.98050092181852
33260,"Midland, TX",1999,128,0,128,123572,1.03583336030816
33260,"Midland, TX",2000,159,0,159,120280,1.321915530429
33260,"Midland, TX",2001,162,0,162,120877,1.34020533269356
33260,"Midland, TX",2002,228,0,228,122371,1.86318653929444
33260,"Midland, TX",2003,260,0,260,123717,2.10157051981539
33260,"Midland, TX",2004,292,0,292,125144,2.33331202454772
33260,"Midland, TX",2005,400,0,400,126963,3.15052416845853
33260,"Midland, TX",2006,470,0,470,130287,3.60742054080607
33260,"Midland, TX",2007,514,0,514,133448,3.85168754870811
33260,"Midland, TX",2008,483,0,483,137060,3.52400408580184
33260,"Midland, TX",2009,331,0,331,140948,2.34838380111814
33260,"Midland, TX",2010,403,0,403,141794,2.84215128989943
33260,"Midland, TX",2011,541,0,541,145112,3.72815480456475
33260,"Midland, TX",2012,603,410,1013,152337,6.64973053165022
33260,"Midland, TX",2013,733,1092,1825,157667,11.5750283826038
33260,"Midland, TX",2014,920,636,1556,162249,9.59019778242085
33260,"Midland, TX",2015,766,264,1030,168012,6.13051448706045
33260,"Midland, TX",2016,636,40,676,169500,3.9882005899705
33260,"Midland, TX",2017,766,0,766,170948,4.4808947750193
33260,"Midland, TX",2018,1227,0,1227,178331,6.88046385653644
33300,"Milledgeville, GA",1990,40,35,75,48473,1.54725310997875
33300,"Milledgeville, GA",1991,115,8,123,48882,2.51626365533325
33300,"Milledgeville, GA",1992,143,0,143,49332,2.89872699262142
33300,"Milledgeville, GA",1993,167,14,181,49996,3.62028962316985
33300,"Milledgeville, GA",1994,145,31,176,50053,3.51627275088406
33300,"Milledgeville, GA",1995,94,0,94,50489,1.86179167739508
33300,"Milledgeville, GA",1996,102,92,194,50632,3.83156896824143
33300,"Milledgeville, GA",1997,139,22,161,50902,3.16294055243409
33300,"Milledgeville, GA",1998,173,94,267,51038,5.23139621458521
33300,"Milledgeville, GA",1999,165,73,238,51103,4.65726082617459
33300,"Milledgeville, GA",2000,148,40,188,54750,3.4337899543379
33300,"Milledgeville, GA",2001,168,86,254,54786,4.63622093235498
33300,"Milledgeville, GA",2002,179,149,328,55032,5.96016862916122
33300,"Milledgeville, GA",2003,198,35,233,55197,4.22124390818342
33300,"Milledgeville, GA",2004,269,174,443,55640,7.96189791516894
33300,"Milledgeville, GA",2005,267,256,523,55938,9.34963709821588
33300,"Milledgeville, GA",2006,264,245,509,56163,9.06290618378648
33300,"Milledgeville, GA",2007,481,56,537,57225,9.38401048492792
33300,"Milledgeville, GA",2008,147,168,315,57663,5.46277508974559
33300,"Milledgeville, GA",2009,70,76,146,56595,2.57973319197809
33300,"Milledgeville, GA",2010,73,0,73,55135,1.32402285299719
33300,"Milledgeville, GA",2011,46,48,94,54567,1.72265288544358
33300,"Milledgeville, GA",2012,41,77,118,55591,2.12264575201022
33300,"Milledgeville, GA",2013,28,64,92,55135,1.66863154076358
33300,"Milledgeville, GA",2014,49,5,54,54488,0.991043899574218
33300,"Milledgeville, GA",2015,75,85,160,54121,2.95633857467526
33300,"Milledgeville, GA",2016,69,9,78,53862,1.44814526010917
33300,"Milledgeville, GA",2017,81,13,94,53466,1.75812665993342
33300,"Milledgeville, GA",2018,99,37,136,53171,2.55778525888172
33340,"Milwaukee-Waukesha-West Allis, WI",1990,3653,4513,8166,1434316,5.69330607760075
33340,"Milwaukee-Waukesha-West Allis, WI",1991,3441,2547,5988,1444800,4.14451827242525
33340,"Milwaukee-Waukesha-West Allis, WI",1992,4533,2986,7519,1453778,5.1720413983428
33340,"Milwaukee-Waukesha-West Allis, WI",1993,4476,2725,7201,1457863,4.9394216054595
33340,"Milwaukee-Waukesha-West Allis, WI",1994,4386,2559,6945,1459583,4.75820833758683
33340,"Milwaukee-Waukesha-West Allis, WI",1995,3532,2644,6176,1460870,4.22761778939947
33340,"Milwaukee-Waukesha-West Allis, WI",1996,3693,2753,6446,1461824,4.40955956394203
33340,"Milwaukee-Waukesha-West Allis, WI",1997,3351,3078,6429,1459586,4.40467365403614
33340,"Milwaukee-Waukesha-West Allis, WI",1998,3844,3297,7141,1459427,4.89301623171286
33340,"Milwaukee-Waukesha-West Allis, WI",1999,4200,2973,7173,1461106,4.90929473973825
33340,"Milwaukee-Waukesha-West Allis, WI",2000,3581,2050,5631,1502420,3.7479533020061
33340,"Milwaukee-Waukesha-West Allis, WI",2001,3564,2315,5879,1507257,3.90046289385287
33340,"Milwaukee-Waukesha-West Allis, WI",2002,3456,2480,5936,1514251,3.92008986621108
33340,"Milwaukee-Waukesha-West Allis, WI",2003,3939,2528,6467,1519746,4.2553163489162
33340,"Milwaukee-Waukesha-West Allis, WI",2004,3840,2062,5902,1522302,3.87702308740316
33340,"Milwaukee-Waukesha-West Allis, WI",2005,3361,2083,5444,1522391,3.57595387781457
33340,"Milwaukee-Waukesha-West Allis, WI",2006,2624,1666,4290,1523907,2.81513241949804
33340,"Milwaukee-Waukesha-West Allis, WI",2007,2082,1184,3266,1530492,2.13395431011727
33340,"Milwaukee-Waukesha-West Allis, WI",2008,1234,1210,2444,1538232,1.58883705448853
33340,"Milwaukee-Waukesha-West Allis, WI",2009,891,552,1443,1549613,0.931200241608711
33340,"Milwaukee-Waukesha-West Allis, WI",2010,967,974,1941,1556684,1.24688119104455
33340,"Milwaukee-Waukesha-West Allis, WI",2011,915,678,1593,1561175,1.02038528672314
33340,"Milwaukee-Waukesha-West Allis, WI",2012,1064,729,1793,1567241,1.14404868172795
33340,"Milwaukee-Waukesha-West Allis, WI",2013,1326,674,2000,1571822,1.27240870785623
33340,"Milwaukee-Waukesha-West Allis, WI",2014,1318,1098,2416,1575157,1.53381535935783
33340,"Milwaukee-Waukesha-West Allis, WI",2015,1416,1632,3048,1576781,1.93305221207003
33340,"Milwaukee-Waukesha-West Allis, WI",2016,1671,2384,4055,1576331,2.57242926771091
33340,"Milwaukee-Waukesha-West Allis, WI",2017,1588,2105,3693,1575151,2.34453712691672
33340,"Milwaukee-Waukesha-West Allis, WI",2018,1734,2057,3791,1576113,2.40528439267997
33420,"Mineral Wells, TX",1990,3,0,3,25034,0.119837021650555
33420,"Mineral Wells, TX",1991,1,0,1,25066,0.0398946780499481
33420,"Mineral Wells, TX",1992,4,0,4,24715,0.161845033380538
33420,"Mineral Wells, TX",1993,3,0,3,24910,0.120433560818948
33420,"Mineral Wells, TX",1994,1,0,1,25028,0.0399552501198658
33420,"Mineral Wells, TX",1995,4,0,4,24998,0.160012801024082
33420,"Mineral Wells, TX",1996,0,0,0,25312,0
33420,"Mineral Wells, TX",1997,12,0,12,25524,0.470145745181006
33420,"Mineral Wells, TX",1998,6,0,6,25889,0.231758661979992
33420,"Mineral Wells, TX",1999,6,0,6,26166,0.229305205228159
33420,"Mineral Wells, TX",2000,4,0,4,27074,0.147743222279678
33420,"Mineral Wells, TX",2001,5,0,5,27128,0.184311412562666
33420,"Mineral Wells, TX",2002,8,0,8,27144,0.294724432655467
33420,"Mineral Wells, TX",2003,6,0,6,27294,0.21982853374368
33420,"Mineral Wells, TX",2004,7,0,7,27276,0.256635870362223
33420,"Mineral Wells, TX",2005,13,2,15,27511,0.545236450874196
33420,"Mineral Wells, TX",2006,15,0,15,27859,0.538425643418644
33420,"Mineral Wells, TX",2007,13,0,13,27679,0.469670147042885
33420,"Mineral Wells, TX",2008,9,0,9,27916,0.322395758704685
33420,"Mineral Wells, TX",2009,6,0,6,28071,0.213743721278187
33420,"Mineral Wells, TX",2010,16,80,96,28084,3.41831647913403
33420,"Mineral Wells, TX",2011,8,0,8,28051,0.28519482371395
33420,"Mineral Wells, TX",2012,9,0,9,27859,0.323055386051186
33420,"Mineral Wells, TX",2013,11,0,11,27876,0.39460467785909
33420,"Mineral Wells, TX",2014,5,0,5,28034,0.178354854819148
33420,"Mineral Wells, TX",2015,7,0,7,27966,0.250303940499178
33420,"Mineral Wells, TX",2016,9,0,9,28136,0.319874893375036
33420,"Mineral Wells, TX",2017,4,0,4,28575,0.139982502187227
33420,"Mineral Wells, TX",2018,11,0,11,28875,0.380952380952381
33460,"Minneapolis-St. Paul-Bloomington, MN-WI",1990,12307,3565,15872,2604538,6.09397904733968
33460,"Minneapolis-St. Paul-Bloomington, MN-WI",1991,12751,1707,14458,2638222,5.48020598721412
33460,"Minneapolis-St. Paul-Bloomington, MN-WI",1992,16490,2308,18798,2674074,7.02972318641892
33460,"Minneapolis-St. Paul-Bloomington, MN-WI",1993,16949,2663,19612,2713088,7.22866342706171
33460,"Minneapolis-St. Paul-Bloomington, MN-WI",1994,15191,2742,17933,2749033,6.52338476838947
33460,"Minneapolis-St. Paul-Bloomington, MN-WI",1995,14276,3831,18107,2785048,6.50150374428017
33460,"Minneapolis-St. Paul-Bloomington, MN-WI",1996,15504,3103,18607,2820801,6.59635330532001
33460,"Minneapolis-St. Paul-Bloomington, MN-WI",1997,13902,3067,16969,2855853,5.94183244025515
33460,"Minneapolis-St. Paul-Bloomington, MN-WI",1998,17248,3991,21239,2892608,7.34250890545833
33460,"Minneapolis-St. Paul-Bloomington, MN-WI",1999,18658,4876,23534,2934097,8.02086638580797
33460,"Minneapolis-St. Paul-Bloomington, MN-WI",2000,17144,5623,22767,3044425,7.47825944143804
33460,"Minneapolis-St. Paul-Bloomington, MN-WI",2001,17550,5950,23500,3086645,7.61344437082982
33460,"Minneapolis-St. Paul-Bloomington, MN-WI",2002,18087,8192,26279,3116197,8.43303552374898
33460,"Minneapolis-St. Paul-Bloomington, MN-WI",2003,20948,7255,28203,3143413,8.97209498083771
33460,"Minneapolis-St. Paul-Bloomington, MN-WI",2004,20859,7552,28411,3171902,8.95708631603372
33460,"Minneapolis-St. Paul-Bloomington, MN-WI",2005,17619,5032,22651,3199046,7.08054838848832
33460,"Minneapolis-St. Paul-Bloomington, MN-WI",2006,12243,3825,16068,3234367,4.96789634571463
33460,"Minneapolis-St. Paul-Bloomington, MN-WI",2007,7819,2409,10228,3269613,3.12819896421992
33460,"Minneapolis-St. Paul-Bloomington, MN-WI",2008,4284,1620,5904,3301252,1.78841239626663
33460,"Minneapolis-St. Paul-Bloomington, MN-WI",2009,3703,1043,4746,3330508,1.42500783664234
33460,"Minneapolis-St. Paul-Bloomington, MN-WI",2010,3867,1921,5788,3355273,1.72504592025746
33460,"Minneapolis-St. Paul-Bloomington, MN-WI",2011,3832,1396,5228,3388292,1.54296028795629
33460,"Minneapolis-St. Paul-Bloomington, MN-WI",2012,5829,5743,11572,3421051,3.38258622861805
33460,"Minneapolis-St. Paul-Bloomington, MN-WI",2013,7262,4865,12127,3456095,3.50887345399938
33460,"Minneapolis-St. Paul-Bloomington, MN-WI",2014,6689,4736,11425,3491584,3.27215384192389
33460,"Minneapolis-St. Paul-Bloomington, MN-WI",2015,6770,4903,11673,3519501,3.31666335653833
33460,"Minneapolis-St. Paul-Bloomington, MN-WI",2016,7889,6271,14160,3554690,3.9834697259114
33460,"Minneapolis-St. Paul-Bloomington, MN-WI",2017,8782,6318,15100,3592669,4.20300339385565
33460,"Minneapolis-St. Paul-Bloomington, MN-WI",2018,8985,9221,18206,3629190,5.01654639189461
33500,"Minot, ND",1990,38,6,44,67395,0.652867423399362
33500,"Minot, ND",1991,56,2,58,66669,0.869969551065713
33500,"Minot, ND",1992,102,42,144,66722,2.15820868678996
33500,"Minot, ND",1993,109,47,156,66696,2.33897085282476
33500,"Minot, ND",1994,145,221,366,67066,5.45731070885396
33500,"Minot, ND",1995,156,141,297,67804,4.38027255029202
33500,"Minot, ND",1996,132,87,219,68778,3.18415772485388
33500,"Minot, ND",1997,126,150,276,68078,4.05417315432298
33500,"Minot, ND",1998,133,87,220,67435,3.2624008304293
33500,"Minot, ND",1999,120,109,229,67050,3.41536167039523
33500,"Minot, ND",2000,94,64,158,67401,2.34417886974971
33500,"Minot, ND",2001,81,58,139,66651,2.08549009017119
33500,"Minot, ND",2002,86,69,155,66085,2.34546417492623
33500,"Minot, ND",2003,109,52,161,65472,2.45906647116325
33500,"Minot, ND",2004,112,94,206,66240,3.10990338164251
33500,"Minot, ND",2005,186,55,241,65965,3.6534525884939
33500,"Minot, ND",2006,158,106,264,66036,3.99781937125204
33500,"Minot, ND",2007,135,56,191,66082,2.890348355074
33500,"Minot, ND",2008,185,128,313,66412,4.71300367403481
33500,"Minot, ND",2009,204,236,440,68018,6.46887588579494
33500,"Minot, ND",2010,252,468,720,70005,10.2849796443111
33500,"Minot, ND",2011,575,650,1225,72195,16.9679340674562
33500,"Minot, ND",2012,697,861,1558,73205,21.2826992691756
33500,"Minot, ND",2013,367,1051,1418,75911,18.6797697303421
33500,"Minot, ND",2014,307,582,889,77415,11.4835626170639
33500,"Minot, ND",2015,191,131,322,79239,4.0636555231641
33500,"Minot, ND",2016,91,2,93,77942,1.19319493982705
33500,"Minot, ND",2017,122,14,136,76751,1.77196388320673
33500,"Minot, ND",2018,94,2,96,75934,1.26425580109042
33540,"Missoula, MT",1990,194,122,316,78951,4.0024825524692504
33540,"Missoula, MT",1991,267,231,498,80437,6.19118067555975
33540,"Missoula, MT",1992,414,75,489,82326,5.93980030610014
33540,"Missoula, MT",1993,446,297,743,84426,8.80060644825054
33540,"Missoula, MT",1994,411,164,575,85621,6.71564219058409
33540,"Missoula, MT",1995,342,471,813,87358,9.30653174294283
33540,"Missoula, MT",1996,309,283,592,88262,6.70730325621445
33540,"Missoula, MT",1997,247,166,413,88836,4.64901616461795
33540,"Missoula, MT",1998,270,279,549,88918,6.17422794034954
33540,"Missoula, MT",1999,290,132,422,89229,4.72940411749543
33540,"Missoula, MT",2000,299,272,571,96178,5.93690864854748
33540,"Missoula, MT",2001,283,240,523,97435,5.36768101811464
33540,"Missoula, MT",2002,396,731,1127,98968,11.3875191981246
33540,"Missoula, MT",2003,428,519,947,99976,9.47227334560294
33540,"Missoula, MT",2004,400,188,588,100934,5.82558899875166
33540,"Missoula, MT",2005,491,147,638,102298,6.23668106903361
33540,"Missoula, MT",2006,403,115,518,104372,4.96301690108458
33540,"Missoula, MT",2007,513,154,667,106110,6.28592969559891
33540,"Missoula, MT",2008,323,116,439,107747,4.07435937891542
33540,"Missoula, MT",2009,207,18,225,108717,2.06959353183035
33540,"Missoula, MT",2010,190,178,368,109466,3.3617744322438
33540,"Missoula, MT",2011,132,431,563,110231,5.1074561602453
33540,"Missoula, MT",2012,179,158,337,111035,3.03507902913496
33540,"Missoula, MT",2013,251,318,569,111889,5.08539713466024
33540,"Missoula, MT",2014,227,351,578,112793,5.12443148067699
33540,"Missoula, MT",2015,292,282,574,114114,5.03005766163661
33540,"Missoula, MT",2016,361,569,930,116352,7.99298679867987
33540,"Missoula, MT",2017,395,577,972,117863,8.24686288317793
33540,"Missoula, MT",2018,459,230,689,118791,5.8001027013831
33580,"Mitchell, SD",1990,11,19,30,17508,1.71350239890336
33580,"Mitchell, SD",1991,25,12,37,17465,2.11852275980532
33580,"Mitchell, SD",1992,19,82,101,17543,5.75728210682323
33580,"Mitchell, SD",1993,16,44,60,17635,3.40232492203005
33580,"Mitchell, SD",1994,35,46,81,17627,4.59522323707948
33580,"Mitchell, SD",1995,39,102,141,17666,7.98143326163251
33580,"Mitchell, SD",1996,61,20,81,17746,4.56440888087456
33580,"Mitchell, SD",1997,58,50,108,17796,6.06877950101146
33580,"Mitchell, SD",1998,43,8,51,17744,2.87421100090171
33580,"Mitchell, SD",1999,40,41,81,17901,4.52488687782805
33580,"Mitchell, SD",2000,56,14,70,18763,3.73074668230027
33580,"Mitchell, SD",2001,63,79,142,18868,7.5259698961204204
33580,"Mitchell, SD",2002,54,46,100,18862,5.30166472272294
33580,"Mitchell, SD",2003,66,24,90,18907,4.76014174644312
33580,"Mitchell, SD",2004,74,21,95,22607,4.20223824479144
33580,"Mitchell, SD",2005,93,28,121,22637,5.345231258559
33580,"Mitchell, SD",2006,69,15,84,22818,3.68130423349987
33580,"Mitchell, SD",2007,62,5,67,22768,2.9427266338721
33580,"Mitchell, SD",2008,29,8,37,22717,1.62873618875732
33580,"Mitchell, SD",2009,32,4,36,22722,1.584367573277
33580,"Mitchell, SD",2010,38,49,87,22813,3.81361504405383
33580,"Mitchell, SD",2011,30,2,32,23091,1.38582131566411
33580,"Mitchell, SD",2012,26,40,66,23328,2.82921810699589
33580,"Mitchell, SD",2013,42,260,302,23343,12.9374973225378
33580,"Mitchell, SD",2014,32,8,40,23387,1.71035190490443
33580,"Mitchell, SD",2015,49,28,77,23297,3.30514658539726
33580,"Mitchell, SD",2016,55,149,204,23379,8.72577954574618
33580,"Mitchell, SD",2017,58,12,70,23259,3.00958768648695
33580,"Mitchell, SD",2018,43,10,53,23166,2.28783562116895
33620,"Moberly, MO",1990,8,0,8,24353,0.328501621976758
33620,"Moberly, MO",1991,3,0,3,23743,0.126353030366845
33620,"Moberly, MO",1992,3,3,6,23924,0.250794181574987
33620,"Moberly, MO",1993,5,0,5,24025,0.208116545265349
33620,"Moberly, MO",1994,16,8,24,24062,0.997423323082038
33620,"Moberly, MO",1995,14,4,18,23890,0.753453327752198
33620,"Moberly, MO",1996,17,66,83,24119,3.44127036775986
33620,"Moberly, MO",1997,12,70,82,23943,3.4248005680157
33620,"Moberly, MO",1998,19,26,45,23939,1.87977776849492
33620,"Moberly, MO",1999,23,0,23,23888,0.962826523777629
33620,"Moberly, MO",2000,21,0,21,24660,0.851581508515815
33620,"Moberly, MO",2001,9,0,9,24679,0.364682523603063
33620,"Moberly, MO",2002,18,4,22,24701,0.890652200315777
33620,"Moberly, MO",2003,33,0,33,25010,1.31947221111555
33620,"Moberly, MO",2004,34,46,80,25211,3.17321803974456
33620,"Moberly, MO",2005,34,0,34,25451,1.3359003575498
33620,"Moberly, MO",2006,27,2,29,25480,1.138147566719
33620,"Moberly, MO",2007,15,12,27,25597,1.05481111067703
33620,"Moberly, MO",2008,20,6,26,25597,1.01574403250381
33620,"Moberly, MO",2009,53,19,72,25364,2.83866897965621
33620,"Moberly, MO",2010,5,0,5,25454,0.196432780702444
33620,"Moberly, MO",2011,18,0,18,25277,0.712109823159394
33620,"Moberly, MO",2012,13,0,13,25327,0.513286216290915
33620,"Moberly, MO",2013,14,0,14,24944,0.561257216164208
33620,"Moberly, MO",2014,14,0,14,25045,0.558993811139948
33620,"Moberly, MO",2015,13,0,13,25030,0.519376747902517
33620,"Moberly, MO",2016,18,0,18,24956,0.721269434204199
33620,"Moberly, MO",2017,22,0,22,24932,0.88240012834911
33620,"Moberly, MO",2018,54,2,56,24763,2.26143843637685
33660,"Mobile, AL",1990,492,4,496,379179,1.30808931929247
33660,"Mobile, AL",1991,1062,120,1182,383035,3.08587988042868
33660,"Mobile, AL",1992,1610,338,1948,388197,5.01807072182423
33660,"Mobile, AL",1993,1805,142,1947,393890,4.94300439208916
33660,"Mobile, AL",1994,1485,321,1806,395886,4.56191934041618
33660,"Mobile, AL",1995,1400,358,1758,395917,4.44032461349222
33660,"Mobile, AL",1996,1495,183,1678,396468,4.23237184337702
33660,"Mobile, AL",1997,1763,589,2352,398281,5.90537836351722
33660,"Mobile, AL",1998,1795,269,2064,398903,5.17419021666922
33660,"Mobile, AL",1999,1829,282,2111,399809,5.28002121012784
33660,"Mobile, AL",2000,1746,412,2158,400073,5.39401559215443
33660,"Mobile, AL",2001,1863,496,2359,400129,5.89559866942911
33660,"Mobile, AL",2002,1640,88,1728,398549,4.33572785278598
33660,"Mobile, AL",2003,1665,19,1684,398082,4.23028421280038
33660,"Mobile, AL",2004,1749,621,2370,397959,5.95538736402494
33660,"Mobile, AL",2005,1861,322,2183,398942,5.47197336956249
33660,"Mobile, AL",2006,2316,461,2777,402916,6.89225545771327
33660,"Mobile, AL",2007,1828,656,2484,405715,6.1225244321753
33660,"Mobile, AL",2008,1434,982,2416,409196,5.90426103871983
33660,"Mobile, AL",2009,1217,1418,2635,411994,6.39572420957587
33660,"Mobile, AL",2010,895,131,1026,413319,2.48234414580506
33660,"Mobile, AL",2011,706,835,1541,413242,3.72904980616685
33660,"Mobile, AL",2012,712,184,896,413922,2.16465904204174
33660,"Mobile, AL",2013,624,248,872,414210,2.10521233190894
33660,"Mobile, AL",2014,746,0,746,414590,1.79936805036301
33660,"Mobile, AL",2015,648,259,907,414935,2.18588453613217
33660,"Mobile, AL",2016,754,441,1195,415499,2.87605987018019
33660,"Mobile, AL",2017,660,338,998,414515,2.40763301689927
33660,"Mobile, AL",2018,763,20,783,413757,1.89241511321863
33700,"Modesto, CA",1990,3471,486,3957,375256,10.544801415567
33700,"Modesto, CA",1991,1397,241,1638,385875,4.24489795918367
33700,"Modesto, CA",1992,1983,72,2055,394191,5.21320882516344
33700,"Modesto, CA",1993,1831,146,1977,401023,4.92989180171711
33700,"Modesto, CA",1994,1409,74,1483,405245,3.65951461461585
33700,"Modesto, CA",1995,1272,38,1310,409058,3.20247984393411
33700,"Modesto, CA",1996,1303,98,1401,413622,3.38715058676763
33700,"Modesto, CA",1997,1370,72,1442,419465,3.4377123240318
33700,"Modesto, CA",1998,1838,113,1951,426681,4.57250264248935
33700,"Modesto, CA",1999,2095,88,2183,436242,5.00410322710789
33700,"Modesto, CA",2000,2799,224,3023,449471,6.725684193196
33700,"Modesto, CA",2001,3011,204,3215,463761,6.93245011978153
33700,"Modesto, CA",2002,2991,182,3173,477469,6.6454576108606
33700,"Modesto, CA",2003,3868,251,4119,487357,8.4517099374791
33700,"Modesto, CA",2004,4027,494,4521,492613,9.17758971038117
33700,"Modesto, CA",2005,4085,440,4525,500020,9.04963801447942
33700,"Modesto, CA",2006,2271,373,2644,504651,5.23926436289634
33700,"Modesto, CA",2007,1352,513,1865,507834,3.67245989831323
33700,"Modesto, CA",2008,460,21,481,509032,0.944930770560593
33700,"Modesto, CA",2009,279,85,364,511536,0.711582371524194
33700,"Modesto, CA",2010,159,133,292,515165,0.5668086923607
33700,"Modesto, CA",2011,113,51,164,517614,0.316838416271585
33700,"Modesto, CA",2012,183,102,285,520594,0.547451564943123
33700,"Modesto, CA",2013,280,39,319,523722,0.609101775369375
33700,"Modesto, CA",2014,404,50,454,528346,0.859285392526867
33700,"Modesto, CA",2015,413,0,413,533534,0.774083750988691
33700,"Modesto, CA",2016,573,0,573,539542,1.06201185449882
33700,"Modesto, CA",2017,644,75,719,545267,1.31862005219461
33700,"Modesto, CA",2018,684,75,759,549815,1.3804643380046
33740,"Monroe, LA",1990,262,0,262,162906,1.60828944299166
33740,"Monroe, LA",1991,279,2,281,163926,1.71418810926882
33740,"Monroe, LA",1992,370,8,378,165926,2.27812398298037
33740,"Monroe, LA",1993,431,42,473,166801,2.83571441418217
33740,"Monroe, LA",1994,459,72,531,167150,3.17678731678133
33740,"Monroe, LA",1995,467,116,583,167972,3.47081656466554
33740,"Monroe, LA",1996,468,77,545,168272,3.23880384139964
33740,"Monroe, LA",1997,459,94,553,168777,3.27651279498984
33740,"Monroe, LA",1998,494,118,612,168835,3.62484082091983
33740,"Monroe, LA",1999,450,224,674,168453,4.00111603830148
33740,"Monroe, LA",2000,368,29,397,170033,2.33484088382843
33740,"Monroe, LA",2001,455,27,482,169572,2.84245040454792
33740,"Monroe, LA",2002,567,44,611,170352,3.58669108669109
33740,"Monroe, LA",2003,457,86,543,171306,3.16976638296382
33740,"Monroe, LA",2004,567,133,700,171969,4.07050107868279
33740,"Monroe, LA",2005,877,219,1096,172241,6.36317717616595
33740,"Monroe, LA",2006,681,202,883,174102,5.07173955497352
33740,"Monroe, LA",2007,474,81,555,173927,3.1909939227377
33740,"Monroe, LA",2008,297,14,311,174425,1.7830012899527
33740,"Monroe, LA",2009,255,21,276,175667,1.5711545139383
33740,"Monroe, LA",2010,333,108,441,176799,2.49435799976244
33740,"Monroe, LA",2011,312,93,405,177388,2.28313076420051
33740,"Monroe, LA",2012,413,200,613,177760,3.4484698469847
33740,"Monroe, LA",2013,477,156,633,178505,3.54611915632615
33740,"Monroe, LA",2014,504,222,726,178912,4.05786084779109
33740,"Monroe, LA",2015,555,50,605,179369,3.37293512256856
33740,"Monroe, LA",2016,566,104,670,179453,3.73356812090074
33740,"Monroe, LA",2017,660,92,752,178211,4.21971707694811
33740,"Monroe, LA",2018,425,65,490,176805,2.77141483555329
33780,"Monroe, MI",1990,434,243,677,133905,5.05582315820918
33780,"Monroe, MI",1991,444,105,549,134728,4.07487678878926
33780,"Monroe, MI",1992,514,246,760,135391,5.61337164213279
33780,"Monroe, MI",1993,512,99,611,135789,4.49962809947787
33780,"Monroe, MI",1994,694,104,798,137003,5.82468997029262
33780,"Monroe, MI",1995,635,211,846,138909,6.09031812193594
33780,"Monroe, MI",1996,628,112,740,140458,5.26847883353031
33780,"Monroe, MI",1997,674,186,860,142122,6.05113916212831
33780,"Monroe, MI",1998,676,167,843,143468,5.87587475952826
33780,"Monroe, MI",1999,756,140,896,145048,6.17726545695218
33780,"Monroe, MI",2000,720,482,1202,146364,8.21240195676532
33780,"Monroe, MI",2001,678,143,821,147605,5.56214220385488
33780,"Monroe, MI",2002,805,149,954,148561,6.42160459339934
33780,"Monroe, MI",2003,992,168,1160,149747,7.74639892618884
33780,"Monroe, MI",2004,1077,105,1182,151117,7.8217540051748
33780,"Monroe, MI",2005,870,64,934,152374,6.12965466549411
33780,"Monroe, MI",2006,560,112,672,153460,4.37899126808289
33780,"Monroe, MI",2007,309,91,400,153424,2.60715403066013
33780,"Monroe, MI",2008,114,0,114,152806,0.746044003507716
33780,"Monroe, MI",2009,80,0,80,152296,0.525292850764301
33780,"Monroe, MI",2010,113,4,117,151931,0.770086420809446
33780,"Monroe, MI",2011,110,0,110,151475,0.726192440996864
33780,"Monroe, MI",2012,136,0,136,150791,0.901910591480924
33780,"Monroe, MI",2013,200,0,200,150135,1.33213441236221
33780,"Monroe, MI",2014,239,0,239,149852,1.59490697488188
33780,"Monroe, MI",2015,243,48,291,149386,1.94797370570201
33780,"Monroe, MI",2016,269,242,511,149227,3.42431329451105
33780,"Monroe, MI",2017,298,152,450,149592,3.0081822557356
33780,"Monroe, MI",2018,265,227,492,150439,3.27042854578932
33860,"Montgomery, AL",1990,846,114,960,305824,3.13906037459454
33860,"Montgomery, AL",1991,1086,174,1260,310028,4.06414904460242
33860,"Montgomery, AL",1992,1587,76,1663,314970,5.27986792392926
33860,"Montgomery, AL",1993,1811,126,1937,319767,6.05753564314016
33860,"Montgomery, AL",1994,1761,845,2606,323778,8.04872474349709
33860,"Montgomery, AL",1995,1523,729,2252,326836,6.89030584146177
33860,"Montgomery, AL",1996,1445,449,1894,329273,5.75206591490951
33860,"Montgomery, AL",1997,1143,74,1217,332226,3.66316904757605
33860,"Montgomery, AL",1998,1400,627,2027,334508,6.059645808172
33860,"Montgomery, AL",1999,1268,580,1848,336029,5.49952533858685
33860,"Montgomery, AL",2000,1221,52,1273,347080,3.66774230724905
33860,"Montgomery, AL",2001,1244,280,1524,348725,4.37020574951609
33860,"Montgomery, AL",2002,1576,40,1616,350984,4.60419848198208
33860,"Montgomery, AL",2003,1467,305,1772,352411,5.02821989097957
33860,"Montgomery, AL",2004,1749,311,2060,355009,5.80266979147008
33860,"Montgomery, AL",2005,1702,694,2396,358659,6.68044019528298
33860,"Montgomery, AL",2006,1584,6,1590,365989,4.34439286426641
33860,"Montgomery, AL",2007,1192,702,1894,369390,5.12737215409188
33860,"Montgomery, AL",2008,641,8,649,370249,1.75287441694643
33860,"Montgomery, AL",2009,437,30,467,371860,1.25584897542086
33860,"Montgomery, AL",2010,472,521,993,375130,2.64708234478714
33860,"Montgomery, AL",2011,668,304,972,375524,2.58838316592282
33860,"Montgomery, AL",2012,776,474,1250,374866,3.33452487022029
33860,"Montgomery, AL",2013,744,110,854,374120,2.28269004597455
33860,"Montgomery, AL",2014,737,392,1129,373488,3.02285481728998
33860,"Montgomery, AL",2015,764,335,1099,373359,2.94354763110036
33860,"Montgomery, AL",2016,716,89,805,373830,2.15338522857984
33860,"Montgomery, AL",2017,761,0,761,374042,2.03453088155876
33860,"Montgomery, AL",2018,654,0,654,373225,1.75229419251122
33940,"Montrose, CO",1990,79,25,104,24473,4.2495811710865
33940,"Montrose, CO",1991,93,34,127,25034,5.07310058320684
33940,"Montrose, CO",1992,164,18,182,25522,7.13110257816786
33940,"Montrose, CO",1993,213,44,257,26527,9.68824216835677
33940,"Montrose, CO",1994,294,70,364,27596,13.1903174373098
33940,"Montrose, CO",1995,180,78,258,28748,8.97453735912063
33940,"Montrose, CO",1996,210,14,224,29486,7.59682561215492
33940,"Montrose, CO",1997,195,18,213,30205,7.05181261380566
33940,"Montrose, CO",1998,263,29,292,30744,9.49778818631278
33940,"Montrose, CO",1999,272,48,320,31243,10.2422942739174
33940,"Montrose, CO",2000,286,23,309,33599,9.19670228280604
33940,"Montrose, CO",2001,280,103,383,34361,11.1463577893542
33940,"Montrose, CO",2002,279,25,304,35154,8.64766456164305
33940,"Montrose, CO",2003,336,32,368,35767,10.2888137109626
33940,"Montrose, CO",2004,420,79,499,36310,13.7427705866153
33940,"Montrose, CO",2005,532,73,605,37227,16.2516453111989
33940,"Montrose, CO",2006,501,64,565,38282,14.7588945196176
33940,"Montrose, CO",2007,351,45,396,39673,9.9815995765382
33940,"Montrose, CO",2008,154,43,197,40658,4.84529489891288
33940,"Montrose, CO",2009,87,31,118,41535,2.84097748886481
33940,"Montrose, CO",2010,62,0,62,41186,1.50536590103433
33940,"Montrose, CO",2011,51,0,51,40972,1.24475251391194
33940,"Montrose, CO",2012,51,0,51,40654,1.25448910316328
33940,"Montrose, CO",2013,68,0,68,40555,1.6767352977438
33940,"Montrose, CO",2014,89,0,89,40596,2.19233422012021
33940,"Montrose, CO",2015,124,0,124,40576,3.05599369085173
33940,"Montrose, CO",2016,114,0,114,41168,2.76914108045084
33940,"Montrose, CO",2017,199,11,210,41785,5.02572693550317
33940,"Montrose, CO",2018,309,77,386,42214,9.14388591462548
33980,"Morehead City, NC",1990,354,31,385,52701,7.30536422458777
33980,"Morehead City, NC",1991,331,21,352,53439,6.58694960609293
33980,"Morehead City, NC",1992,483,59,542,54564,9.93328934828825
33980,"Morehead City, NC",1993,511,62,573,55449,10.3338202672726
33980,"Morehead City, NC",1994,670,90,760,56046,13.5602897619812
33980,"Morehead City, NC",1995,583,137,720,57355,12.5533955191352
33980,"Morehead City, NC",1996,570,96,666,58371,11.4097754021689
33980,"Morehead City, NC",1997,510,152,662,59332,11.1575541023394
33980,"Morehead City, NC",1998,532,69,601,59750,10.0585774058577
33980,"Morehead City, NC",1999,565,116,681,59934,11.3624987486235
33980,"Morehead City, NC",2000,444,15,459,59406,7.72649227350773
33980,"Morehead City, NC",2001,501,59,560,59790,9.3661147349055
33980,"Morehead City, NC",2002,544,106,650,60311,10.7774701132463
33980,"Morehead City, NC",2003,481,133,614,61067,10.0545302700313
33980,"Morehead City, NC",2004,605,139,744,62127,11.9754696025882
33980,"Morehead City, NC",2005,839,196,1035,62833,16.472235926981
33980,"Morehead City, NC",2006,637,120,757,64028,11.8229524582995
33980,"Morehead City, NC",2007,433,20,453,64258,7.04970587319867
33980,"Morehead City, NC",2008,247,50,297,64700,4.59041731066461
33980,"Morehead City, NC",2009,163,8,171,65670,2.603928734582
33980,"Morehead City, NC",2010,211,5,216,66698,3.23847791537977
33980,"Morehead City, NC",2011,245,362,607,67405,9.0052666716119
33980,"Morehead City, NC",2012,264,13,277,67763,4.08777651520741
33980,"Morehead City, NC",2013,258,0,258,68384,3.77281235376696
33980,"Morehead City, NC",2014,225,5,230,68634,3.351108779905
33980,"Morehead City, NC",2015,311,34,345,68711,5.02103011162696
33980,"Morehead City, NC",2016,321,8,329,68811,4.78121230617198
33980,"Morehead City, NC",2017,411,220,631,68919,9.15567550312686
33980,"Morehead City, NC",2018,364,14,378,69524,5.43697140555779
34020,"Morgan City, LA",1990,28,0,28,58061,0.482251425225194
34020,"Morgan City, LA",1991,56,0,56,58110,0.963689554293581
34020,"Morgan City, LA",1992,84,0,84,57824,1.45268400664084
34020,"Morgan City, LA",1993,139,0,139,57197,2.43019738797489
34020,"Morgan City, LA",1994,85,0,85,56928,1.49311410905003
34020,"Morgan City, LA",1995,74,30,104,57219,1.81757807721211
34020,"Morgan City, LA",1996,96,0,96,57060,1.68243953732913
34020,"Morgan City, LA",1997,159,4,163,56937,2.8628132848587
34020,"Morgan City, LA",1998,123,2,125,57222,2.1844745028136
34020,"Morgan City, LA",1999,109,18,127,56810,2.23552191515578
34020,"Morgan City, LA",2000,90,12,102,53377,1.91093542162355
34020,"Morgan City, LA",2001,93,0,93,53044,1.75326144333007
34020,"Morgan City, LA",2002,77,60,137,53109,2.57960044436913
34020,"Morgan City, LA",2003,100,6,106,53245,1.99079725795849
34020,"Morgan City, LA",2004,113,3,116,53288,2.17685032277436
34020,"Morgan City, LA",2005,90,2,92,53015,1.7353579175705
34020,"Morgan City, LA",2006,94,4,98,54152,1.80972078593588
34020,"Morgan City, LA",2007,103,2,105,54104,1.94070678692888
34020,"Morgan City, LA",2008,78,2,80,54352,1.47188695908154
34020,"Morgan City, LA",2009,53,0,53,54551,0.971567890597789
34020,"Morgan City, LA",2010,52,4,56,54557,1.02644940154334
34020,"Morgan City, LA",2011,49,0,49,54190,0.904225871932091
34020,"Morgan City, LA",2012,52,0,52,53570,0.970692551801381
34020,"Morgan City, LA",2013,67,2,69,53590,1.28755364806867
34020,"Morgan City, LA",2014,58,0,58,53283,1.08852729763714
34020,"Morgan City, LA",2015,57,0,57,52881,1.07789187042605
34020,"Morgan City, LA",2016,43,0,43,52059,0.825985900612766
34020,"Morgan City, LA",2017,21,0,21,50672,0.414430059993685
34020,"Morgan City, LA",2018,15,0,15,49774,0.301362156949411
34060,"Morgantown, WV",1990,63,22,85,104590,0.812697198584951
34060,"Morgantown, WV",1991,55,102,157,105693,1.48543422932455
34060,"Morgantown, WV",1992,59,49,108,106490,1.0141797351864
34060,"Morgantown, WV",1993,60,54,114,107159,1.0638397148163
34060,"Morgantown, WV",1994,53,95,148,107624,1.37515795733294
34060,"Morgantown, WV",1995,45,96,141,107922,1.30649913826653
34060,"Morgantown, WV",1996,38,4,42,107778,0.389689918165117
34060,"Morgantown, WV",1997,32,33,65,107562,0.604302634759488
34060,"Morgantown, WV",1998,32,80,112,107262,1.04417221383155
34060,"Morgantown, WV",1999,28,68,96,106800,0.898876404494382
34060,"Morgantown, WV",2000,24,60,84,111338,0.75445939391762
34060,"Morgantown, WV",2001,38,57,95,112764,0.842467454152034
34060,"Morgantown, WV",2002,28,43,71,114343,0.620938754449332
34060,"Morgantown, WV",2003,27,63,90,116466,0.772757714697852
34060,"Morgantown, WV",2004,29,93,122,118062,1.03335535566059
34060,"Morgantown, WV",2005,40,78,118,119937,0.98384985450695
34060,"Morgantown, WV",2006,156,9,165,121894,1.35363512560093
34060,"Morgantown, WV",2007,30,73,103,123507,0.833960828131199
34060,"Morgantown, WV",2008,34,230,264,125267,2.10749838345294
34060,"Morgantown, WV",2009,36,12,48,127498,0.376476493748922
34060,"Morgantown, WV",2010,21,280,301,130313,2.30982327166131
34060,"Morgantown, WV",2011,37,362,399,132672,3.00741678726483
34060,"Morgantown, WV",2012,25,598,623,134817,4.62107894405008
34060,"Morgantown, WV",2013,27,110,137,135956,1.00767895495602
34060,"Morgantown, WV",2014,16,85,101,137404,0.735058659136561
34060,"Morgantown, WV",2015,24,142,166,138550,1.1981234211476
34060,"Morgantown, WV",2016,19,2,21,139495,0.150543030216137
34060,"Morgantown, WV",2017,25,52,77,139739,0.551027272271878
34060,"Morgantown, WV",2018,21,245,266,140259,1.89649149074213
34100,"Morristown, TN",1990,60,78,138,83732,1.64811541585057
34100,"Morristown, TN",1991,66,48,114,84476,1.34949571475922
34100,"Morristown, TN",1992,94,53,147,85800,1.71328671328671
34100,"Morristown, TN",1993,432,102,534,87719,6.08762069791037
34100,"Morristown, TN",1994,486,116,602,89183,6.75016539026496
34100,"Morristown, TN",1995,467,298,765,91429,8.36714827899244
34100,"Morristown, TN",1996,478,223,701,93690,7.48212189134379
34100,"Morristown, TN",1997,538,108,646,95894,6.73660500135566
34100,"Morristown, TN",1998,523,203,726,97573,7.44058294815164
34100,"Morristown, TN",1999,643,60,703,99246,7.0834089031296
34100,"Morristown, TN",2000,529,99,628,102796,6.10918712790381
34100,"Morristown, TN",2001,492,100,592,103821,5.70212192138392
34100,"Morristown, TN",2002,472,52,524,103919,5.04238878357182
34100,"Morristown, TN",2003,539,59,598,105291,5.67949777283908
34100,"Morristown, TN",2004,628,78,706,106314,6.64070583366255
34100,"Morristown, TN",2005,675,72,747,107703,6.93573995153338
34100,"Morristown, TN",2006,673,11,684,109708,6.23473219819885
34100,"Morristown, TN",2007,705,21,726,111776,6.49513312338964
34100,"Morristown, TN",2008,301,38,339,113115,2.99695000663042
34100,"Morristown, TN",2009,207,10,217,113618,1.90990864123642
34100,"Morristown, TN",2010,197,7,204,114221,1.786011328915
34100,"Morristown, TN",2011,126,8,134,114732,1.16793919743402
34100,"Morristown, TN",2012,142,25,167,114941,1.45291932382701
34100,"Morristown, TN",2013,163,8,171,115167,1.48480033342885
34100,"Morristown, TN",2014,141,10,151,115367,1.30886648695034
34100,"Morristown, TN",2015,186,2,188,116356,1.615731032349
34100,"Morristown, TN",2016,220,16,236,116787,2.02077285999298
34100,"Morristown, TN",2017,252,16,268,117843,2.27421229941532
34100,"Morristown, TN",2018,286,16,302,118581,2.54678236817028
34140,"Moscow, ID",1990,64,16,80,30654,2.60977360214001
34140,"Moscow, ID",1991,70,18,88,31038,2.8352342290096
34140,"Moscow, ID",1992,102,120,222,31687,7.006027708524
34140,"Moscow, ID",1993,89,136,225,32148,6.99888017917133
34140,"Moscow, ID",1994,95,124,219,32625,6.71264367816092
34140,"Moscow, ID",1995,99,172,271,32956,8.22308532588906
34140,"Moscow, ID",1996,111,114,225,33146,6.7881493996259
34140,"Moscow, ID",1997,69,52,121,33091,3.65658336103472
34140,"Moscow, ID",1998,86,23,109,32635,3.33997242224605
34140,"Moscow, ID",1999,76,15,91,32472,2.80241438778024
34140,"Moscow, ID",2000,74,53,127,34878,3.64126383393543
34140,"Moscow, ID",2001,80,51,131,35285,3.71262576165509
34140,"Moscow, ID",2002,81,170,251,35183,7.13412727737828
34140,"Moscow, ID",2003,72,51,123,35473,3.46742592958024
34140,"Moscow, ID",2004,98,192,290,35864,8.08610305598929
34140,"Moscow, ID",2005,112,227,339,35958,9.42766560987819
34140,"Moscow, ID",2006,120,198,318,36251,8.77217180215718
34140,"Moscow, ID",2007,101,33,134,36179,3.70380607534758
34140,"Moscow, ID",2008,66,30,96,36524,2.62840871755558
34140,"Moscow, ID",2009,53,196,249,36939,6.74084301145131
34140,"Moscow, ID",2010,59,48,107,37254,2.87217480002147
34140,"Moscow, ID",2011,57,34,91,37848,2.40435425914183
34140,"Moscow, ID",2012,49,137,186,38089,4.8832996403161
34140,"Moscow, ID",2013,48,50,98,38216,2.56437094410718
34140,"Moscow, ID",2014,61,75,136,38513,3.53127515384416
34140,"Moscow, ID",2015,55,44,99,38796,2.55180946489329
34140,"Moscow, ID",2016,78,49,127,39038,3.2532404323992
34140,"Moscow, ID",2017,107,201,308,39714,7.75545147806819
34140,"Moscow, ID",2018,87,106,193,40134,4.80889021777047
34180,"Moses Lake, WA",1990,105,4,109,55042,1.98030594818502
34180,"Moses Lake, WA",1991,138,56,194,57090,3.39814328253635
34180,"Moses Lake, WA",1992,201,37,238,59032,4.03171161403984
34180,"Moses Lake, WA",1993,263,82,345,60881,5.66679259539101
34180,"Moses Lake, WA",1994,294,77,371,62985,5.89029133920775
34180,"Moses Lake, WA",1995,307,73,380,65284,5.82072176949942
34180,"Moses Lake, WA",1996,233,62,295,67081,4.39766849033258
34180,"Moses Lake, WA",1997,263,81,344,69070,4.98045461126394
34180,"Moses Lake, WA",1998,245,166,411,70616,5.82021071711793
34180,"Moses Lake, WA",1999,250,99,349,71819,4.85943831019647
34180,"Moses Lake, WA",2000,188,34,222,74918,2.96323980885768
34180,"Moses Lake, WA",2001,183,4,187,76044,2.45910262479617
34180,"Moses Lake, WA",2002,208,112,320,76944,4.15886878768975
34180,"Moses Lake, WA",2003,279,35,314,77955,4.0279648515169
34180,"Moses Lake, WA",2004,285,112,397,78734,5.04229430741484
34180,"Moses Lake, WA",2005,570,69,639,79531,8.03460285926243
34180,"Moses Lake, WA",2006,625,128,753,81036,9.29216644454317
34180,"Moses Lake, WA",2007,655,153,808,82645,9.77675600459798
34180,"Moses Lake, WA",2008,343,319,662,84944,7.79336974948201
34180,"Moses Lake, WA",2009,218,10,228,87340,2.61048774902679
34180,"Moses Lake, WA",2010,205,23,228,89569,2.54552356283982
34180,"Moses Lake, WA",2011,171,16,187,90611,2.06376709229564
34180,"Moses Lake, WA",2012,251,24,275,91332,3.01099286120965
34180,"Moses Lake, WA",2013,236,43,279,91749,3.0409050779845
34180,"Moses Lake, WA",2014,230,34,264,92968,2.83968677394372
34180,"Moses Lake, WA",2015,228,239,467,93670,4.98558770150528
34180,"Moses Lake, WA",2016,264,386,650,94512,6.87743355341121
34180,"Moses Lake, WA",2017,350,95,445,95821,4.64407593325054
34180,"Moses Lake, WA",2018,383,68,451,97331,4.63367272503108
34220,"Moultrie, GA",1990,14,2,16,36707,0.435884163783475
34220,"Moultrie, GA",1991,4,22,26,36750,0.707482993197279
34220,"Moultrie, GA",1992,14,0,14,37092,0.377439879219239
34220,"Moultrie, GA",1993,19,40,59,37340,1.58007498660953
34220,"Moultrie, GA",1994,13,38,51,37631,1.35526560548484
34220,"Moultrie, GA",1995,20,0,20,38189,0.523711016261227
34220,"Moultrie, GA",1996,31,0,31,38775,0.799484203739523
34220,"Moultrie, GA",1997,18,0,18,39603,0.454511021892281
34220,"Moultrie, GA",1998,11,6,17,40143,0.423486037416237
34220,"Moultrie, GA",1999,10,0,10,40567,0.246505780560554
34220,"Moultrie, GA",2000,9,0,9,42140,0.213573801613669
34220,"Moultrie, GA",2001,8,0,8,42223,0.189470193970111
34220,"Moultrie, GA",2002,12,43,55,42570,1.29198966408269
34220,"Moultrie, GA",2003,12,39,51,42554,1.19847722893265
34220,"Moultrie, GA",2004,105,44,149,42987,3.46616418917347
34220,"Moultrie, GA",2005,178,72,250,42993,5.81490010001628
34220,"Moultrie, GA",2006,195,28,223,43700,5.10297482837529
34220,"Moultrie, GA",2007,158,0,158,44209,3.57393290958855
34220,"Moultrie, GA",2008,123,56,179,44872,3.98912462114459
34220,"Moultrie, GA",2009,81,50,131,45152,2.90131112686038
34220,"Moultrie, GA",2010,63,4,67,45638,1.46807484990578
34220,"Moultrie, GA",2011,64,2,66,45782,1.44161460836136
34220,"Moultrie, GA",2012,65,4,69,46033,1.49892468446549
34220,"Moultrie, GA",2013,72,2,74,46150,1.60346695557963
34220,"Moultrie, GA",2014,40,48,88,45893,1.91750375874316
34220,"Moultrie, GA",2015,35,4,39,45509,0.856973345931574
34220,"Moultrie, GA",2016,56,4,60,45492,1.31891321551042
34220,"Moultrie, GA",2017,36,10,46,45543,1.01003447291571
34220,"Moultrie, GA",2018,63,15,78,45592,1.71082646078259
34260,"Mountain Home, AR",1990,53,8,61,31285,1.94981620584945
34260,"Mountain Home, AR",1991,79,10,89,31722,2.80562385725995
34260,"Mountain Home, AR",1992,98,8,106,32475,3.26404926866821
34260,"Mountain Home, AR",1993,108,127,235,33439,7.02772212087682
34260,"Mountain Home, AR",1994,118,60,178,34504,5.15882216554602
34260,"Mountain Home, AR",1995,89,92,181,35543,5.09242326196438
34260,"Mountain Home, AR",1996,85,20,105,36012,2.91569476841053
34260,"Mountain Home, AR",1997,72,12,84,36260,2.31660231660232
34260,"Mountain Home, AR",1998,66,48,114,36375,3.1340206185567
34260,"Mountain Home, AR",1999,41,40,81,36648,2.21021611001965
34260,"Mountain Home, AR",2000,58,73,131,38446,3.40737658013838
34260,"Mountain Home, AR",2001,51,88,139,38331,3.62630768829407
34260,"Mountain Home, AR",2002,28,102,130,38506,3.37609723160027
34260,"Mountain Home, AR",2003,42,79,121,38772,3.12080883111524
34260,"Mountain Home, AR",2004,59,46,105,39334,2.66944628057152
34260,"Mountain Home, AR",2005,118,50,168,39992,4.20084016803361
34260,"Mountain Home, AR",2006,126,18,144,40867,3.52362541904226
34260,"Mountain Home, AR",2007,65,63,128,41491,3.08500638692729
34260,"Mountain Home, AR",2008,36,0,36,41519,0.867072906380212
34260,"Mountain Home, AR",2009,15,2,17,41561,0.409037318640071
34260,"Mountain Home, AR",2010,15,2,17,41511,0.4095300040953
34260,"Mountain Home, AR",2011,4,0,4,41347,0.0967422062060125
34260,"Mountain Home, AR",2012,42,0,42,41082,1.02234555279685
34260,"Mountain Home, AR",2013,15,40,55,40984,1.34198711692368
34260,"Mountain Home, AR",2014,8,0,8,40884,0.195675569905097
34260,"Mountain Home, AR",2015,11,28,39,41136,0.948074679113185
34260,"Mountain Home, AR",2016,18,6,24,41139,0.583388025960767
34260,"Mountain Home, AR",2017,18,62,80,41316,1.93629586600833
34260,"Mountain Home, AR",2018,11,30,41,41619,0.98512698527115
34300,"Mountain Home, ID",1990,47,0,47,21231,2.21374405350666
34300,"Mountain Home, ID",1991,30,0,30,20697,1.4494854326714
34300,"Mountain Home, ID",1992,77,0,77,20533,3.75006087761165
34300,"Mountain Home, ID",1993,63,2,65,22234,2.92345057119727
34300,"Mountain Home, ID",1994,62,12,74,22599,3.27448117173326
34300,"Mountain Home, ID",1995,79,12,91,23374,3.89321468298109
34300,"Mountain Home, ID",1996,279,213,492,23616,20.8333333333333
34300,"Mountain Home, ID",1997,138,66,204,24689,8.2627890963587
34300,"Mountain Home, ID",1998,161,12,173,25353,6.82365006113675
34300,"Mountain Home, ID",1999,134,14,148,25570,5.78803285099726
34300,"Mountain Home, ID",2000,137,58,195,28610,6.81579867179308
34300,"Mountain Home, ID",2001,135,10,145,27613,5.25114982073661
34300,"Mountain Home, ID",2002,113,16,129,27047,4.76947535771065
34300,"Mountain Home, ID",2003,111,20,131,25972,5.04389342368705
34300,"Mountain Home, ID",2004,232,48,280,26355,10.6241699867198
34300,"Mountain Home, ID",2005,204,101,305,25919,11.7674292989699
34300,"Mountain Home, ID",2006,230,78,308,25927,11.8795078489605
34300,"Mountain Home, ID",2007,166,72,238,26595,8.94905057341606
34300,"Mountain Home, ID",2008,95,43,138,26930,5.12439658373561
34300,"Mountain Home, ID",2009,95,0,95,26769,3.54888116851582
34300,"Mountain Home, ID",2010,37,0,37,27120,1.36430678466077
34300,"Mountain Home, ID",2011,15,0,15,26217,0.572147843002632
34300,"Mountain Home, ID",2012,49,0,49,26287,1.86403925894929
34300,"Mountain Home, ID",2013,56,0,56,26265,2.1321149819151
34300,"Mountain Home, ID",2014,45,12,57,26226,2.17341569434912
34300,"Mountain Home, ID",2015,52,0,52,25796,2.01581640564429
34300,"Mountain Home, ID",2016,58,0,58,26084,2.22358533967183
34300,"Mountain Home, ID",2017,38,0,38,26800,1.41791044776119
34300,"Mountain Home, ID",2018,38,0,38,27259,1.39403499761547
34340,"Mount Airy, NC",1990,143,44,187,61894,3.02129447119268
34340,"Mount Airy, NC",1991,180,4,184,62493,2.94432976493367
34340,"Mount Airy, NC",1992,190,0,190,63062,3.01290793187657
34340,"Mount Airy, NC",1993,185,117,302,63826,4.7316140757685
34340,"Mount Airy, NC",1994,252,24,276,64523,4.27754444151698
34340,"Mount Airy, NC",1995,223,8,231,65155,3.54539175811526
34340,"Mount Airy, NC",1996,190,4,194,65573,2.95853476278346
34340,"Mount Airy, NC",1997,219,17,236,66376,3.5555019886706
34340,"Mount Airy, NC",1998,278,12,290,67256,4.31188295468062
34340,"Mount Airy, NC",1999,207,9,216,67848,3.18358684117439
34340,"Mount Airy, NC",2000,214,8,222,71308,3.11325517473495
34340,"Mount Airy, NC",2001,213,8,221,71782,3.07876626452314
34340,"Mount Airy, NC",2002,226,0,226,72152,3.13227630557711
34340,"Mount Airy, NC",2003,221,0,221,72404,3.05231755151649
34340,"Mount Airy, NC",2004,228,0,228,72219,3.15706393054459
34340,"Mount Airy, NC",2005,188,0,188,72562,2.59088779250848
34340,"Mount Airy, NC",2006,295,0,295,72807,4.05180820525499
34340,"Mount Airy, NC",2007,177,0,177,73027,2.42376107467101
34340,"Mount Airy, NC",2008,186,0,186,73404,2.5339218571195
34340,"Mount Airy, NC",2009,99,0,99,73505,1.34684715325488
34340,"Mount Airy, NC",2010,88,0,88,73769,1.19291301224091
34340,"Mount Airy, NC",2011,83,0,83,73487,1.12945146760652
34340,"Mount Airy, NC",2012,74,0,74,73292,1.00965999017628
34340,"Mount Airy, NC",2013,80,56,136,72644,1.87214360442707
34340,"Mount Airy, NC",2014,73,0,73,72492,1.00700766981184
34340,"Mount Airy, NC",2015,92,62,154,71971,2.1397507329341
34340,"Mount Airy, NC",2016,89,65,154,71964,2.13995886832305
34340,"Mount Airy, NC",2017,113,0,113,72118,1.56687650794531
34340,"Mount Airy, NC",2018,99,60,159,71948,2.20992939345083
34380,"Mount Pleasant, MI",1990,180,258,438,54828,7.98861895381922
34380,"Mount Pleasant, MI",1991,161,12,173,55788,3.10102531010253
34380,"Mount Pleasant, MI",1992,159,4,163,56317,2.89433030878775
34380,"Mount Pleasant, MI",1993,138,12,150,56424,2.65844321565291
34380,"Mount Pleasant, MI",1994,146,44,190,56587,3.35766165373672
34380,"Mount Pleasant, MI",1995,149,36,185,56794,3.25738634362785
34380,"Mount Pleasant, MI",1996,207,133,340,57211,5.94291307615668
34380,"Mount Pleasant, MI",1997,213,340,553,57711,9.58222869123737
34380,"Mount Pleasant, MI",1998,291,221,512,58375,8.77087794432548
34380,"Mount Pleasant, MI",1999,318,212,530,58878,9.00166445871123
34380,"Mount Pleasant, MI",2000,299,911,1210,63444,19.0719374566547
34380,"Mount Pleasant, MI",2001,278,234,512,64231,7.97122884588439
34380,"Mount Pleasant, MI",2002,239,214,453,64907,6.97921641733557
34380,"Mount Pleasant, MI",2003,286,306,592,66036,8.96480707492883
34380,"Mount Pleasant, MI",2004,522,191,713,67067,10.6311598848912
34380,"Mount Pleasant, MI",2005,406,4,410,67788,6.04826813005252
34380,"Mount Pleasant, MI",2006,310,26,336,68556,4.90110274811833
34380,"Mount Pleasant, MI",2007,148,8,156,69012,2.26047643888019
34380,"Mount Pleasant, MI",2008,67,144,211,69328,3.04350334641126
34380,"Mount Pleasant, MI",2009,47,0,47,70026,0.671179276268814
34380,"Mount Pleasant, MI",2010,44,8,52,70293,0.739760715860754
34380,"Mount Pleasant, MI",2011,32,38,70,70611,0.991346957272946
34380,"Mount Pleasant, MI",2012,48,8,56,70664,0.792482735197555
34380,"Mount Pleasant, MI",2013,61,362,423,70225,6.02349590601638
34380,"Mount Pleasant, MI",2014,56,55,111,70097,1.58351997945704
34380,"Mount Pleasant, MI",2015,54,60,114,70782,1.61057896075273
34380,"Mount Pleasant, MI",2016,36,24,60,71311,0.841384919577625
34380,"Mount Pleasant, MI",2017,59,34,93,71125,1.30755711775044
34380,"Mount Pleasant, MI",2018,45,0,45,70562,0.637737025594513
34420,"Mount Pleasant, TX",1990,25,0,25,24053,1.03937138818443
34420,"Mount Pleasant, TX",1991,35,0,35,24256,1.4429419525066
34420,"Mount Pleasant, TX",1992,34,76,110,24566,4.47773345273956
34420,"Mount Pleasant, TX",1993,28,0,28,24398,1.14763505205345
34420,"Mount Pleasant, TX",1994,36,5,41,24389,1.6810857353725
34420,"Mount Pleasant, TX",1995,22,10,32,24661,1.29759539353635
34420,"Mount Pleasant, TX",1996,27,29,56,24743,2.26326637836964
34420,"Mount Pleasant, TX",1997,20,10,30,25094,1.1955049015701
34420,"Mount Pleasant, TX",1998,37,16,53,25435,2.08374287399253
34420,"Mount Pleasant, TX",1999,27,32,59,25281,2.33376844270401
34420,"Mount Pleasant, TX",2000,28,0,28,28138,0.995095600255882
34420,"Mount Pleasant, TX",2001,33,0,33,28100,1.17437722419929
34420,"Mount Pleasant, TX",2002,23,8,31,28387,1.09204917744038
34420,"Mount Pleasant, TX",2003,40,12,52,28947,1.79638649946454
34420,"Mount Pleasant, TX",2004,51,0,51,29461,1.73110213502597
34420,"Mount Pleasant, TX",2005,46,0,46,28803,1.59705586223657
34420,"Mount Pleasant, TX",2006,32,14,46,29541,1.55715784841407
34420,"Mount Pleasant, TX",2007,34,12,46,30231,1.52161688333168
34420,"Mount Pleasant, TX",2008,9,75,84,30963,2.71291541517295
34420,"Mount Pleasant, TX",2009,10,0,10,31749,0.314970550253551
34420,"Mount Pleasant, TX",2010,4,0,4,32421,0.123376823663675
34420,"Mount Pleasant, TX",2011,7,0,7,32454,0.215689899550132
34420,"Mount Pleasant, TX",2012,13,2,15,32627,0.459741931529102
34420,"Mount Pleasant, TX",2013,0,0,0,32607,0
34420,"Mount Pleasant, TX",2014,22,0,22,32530,0.676298801106671
34420,"Mount Pleasant, TX",2015,20,122,142,32697,4.34290607701012
34420,"Mount Pleasant, TX",2016,19,0,19,32583,0.583126170088697
34420,"Mount Pleasant, TX",2017,26,0,26,32806,0.792537950374931
34420,"Mount Pleasant, TX",2018,22,4,26,33033,0.787091696182605
34460,"Mount Sterling, KY",1990,27,32,59,29280,2.01502732240437
34460,"Mount Sterling, KY",1991,31,18,49,29254,1.67498461748821
34460,"Mount Sterling, KY",1992,58,28,86,29533,2.91199674939898
34460,"Mount Sterling, KY",1993,63,42,105,29961,3.50455592269951
34460,"Mount Sterling, KY",1994,99,6,105,30220,3.47452018530774
34460,"Mount Sterling, KY",1995,82,10,92,30453,3.02104882934358
34460,"Mount Sterling, KY",1996,118,108,226,30651,7.37333202831882
34460,"Mount Sterling, KY",1997,123,50,173,31105,5.56180678347533
34460,"Mount Sterling, KY",1998,140,16,156,31588,4.93858427250855
34460,"Mount Sterling, KY",1999,116,44,160,32365,4.94361192646377
34460,"Mount Sterling, KY",2000,130,8,138,33778,4.0854994375037
34460,"Mount Sterling, KY",2001,104,61,165,34131,4.83431484574141
34460,"Mount Sterling, KY",2002,126,74,200,34654,5.77133952790443
34460,"Mount Sterling, KY",2003,164,29,193,35022,5.51082176917366
34460,"Mount Sterling, KY",2004,200,58,258,35346,7.2992700729927
34460,"Mount Sterling, KY",2005,200,24,224,36029,6.21721391101612
34460,"Mount Sterling, KY",2006,160,130,290,36643,7.91419916491554
34460,"Mount Sterling, KY",2007,93,24,117,37020,3.16045380875203
34460,"Mount Sterling, KY",2008,51,16,67,37628,1.78058892314234
34460,"Mount Sterling, KY",2009,43,8,51,37951,1.34383810703275
34460,"Mount Sterling, KY",2010,29,0,29,38167,0.759818691539812
34460,"Mount Sterling, KY",2011,22,2,24,38472,0.623830318153462
34460,"Mount Sterling, KY",2012,33,2,35,38652,0.905515885335817
34460,"Mount Sterling, KY",2013,55,2,57,39213,1.45359957157065
34460,"Mount Sterling, KY",2014,41,15,56,39503,1.4176138521125
34460,"Mount Sterling, KY",2015,24,2,26,39787,0.653479779827582
34460,"Mount Sterling, KY",2016,47,14,61,39923,1.52794128697743
34460,"Mount Sterling, KY",2017,76,17,93,40334,2.30574701244608
34460,"Mount Sterling, KY",2018,85,24,109,40586,2.68565515202287
34500,"Mount Vernon, IL",1990,21,4,25,37069,0.674417977285602
34500,"Mount Vernon, IL",1991,27,0,27,37058,0.728587619407415
34500,"Mount Vernon, IL",1992,39,15,54,37119,1.45478057059727
34500,"Mount Vernon, IL",1993,46,2,48,38230,1.25555846194088
34500,"Mount Vernon, IL",1994,38,150,188,38750,4.85161290322581
34500,"Mount Vernon, IL",1995,27,0,27,39032,0.691740110678418
34500,"Mount Vernon, IL",1996,31,0,31,39048,0.793894693710305
34500,"Mount Vernon, IL",1997,22,8,30,39063,0.767990169725827
34500,"Mount Vernon, IL",1998,19,0,19,39024,0.486879868798688
34500,"Mount Vernon, IL",1999,30,0,30,39225,0.764818355640535
34500,"Mount Vernon, IL",2000,29,58,87,40041,2.17277290776954
34500,"Mount Vernon, IL",2001,57,8,65,39874,1.63013492501379
34500,"Mount Vernon, IL",2002,21,0,21,39805,0.527571913076247
34500,"Mount Vernon, IL",2003,20,0,20,39730,0.503397936068462
34500,"Mount Vernon, IL",2004,60,0,60,39638,1.51369897573036
34500,"Mount Vernon, IL",2005,37,0,37,39624,0.933777508580658
34500,"Mount Vernon, IL",2006,31,0,31,39545,0.783917056517891
34500,"Mount Vernon, IL",2007,23,8,31,39412,0.786562468283771
34500,"Mount Vernon, IL",2008,3,0,3,39277,0.0763805789647885
34500,"Mount Vernon, IL",2009,8,0,8,38970,0.205286117526302
34500,"Mount Vernon, IL",2010,0,0,0,38759,0
34500,"Mount Vernon, IL",2011,0,0,0,38749,0
34500,"Mount Vernon, IL",2012,10,4,14,38658,0.362150137099695
34500,"Mount Vernon, IL",2013,6,6,12,38647,0.310502755711957
34500,"Mount Vernon, IL",2014,7,0,7,38377,0.182400917216041
34500,"Mount Vernon, IL",2015,14,0,14,38290,0.36563071297989
34500,"Mount Vernon, IL",2016,10,0,10,38247,0.261458415039088
34500,"Mount Vernon, IL",2017,9,39,48,38111,1.25947889060901
34500,"Mount Vernon, IL",2018,6,0,6,37820,0.158646218931782
34540,"Mount Vernon, OH",1990,154,26,180,47631,3.77905145808402
34540,"Mount Vernon, OH",1991,153,23,176,47866,3.67693143358543
34540,"Mount Vernon, OH",1992,210,0,210,48610,4.32009874511417
34540,"Mount Vernon, OH",1993,254,5,259,49208,5.26337180946188
34540,"Mount Vernon, OH",1994,297,16,313,49978,6.26275561246949
34540,"Mount Vernon, OH",1995,307,36,343,50968,6.72971276094805
34540,"Mount Vernon, OH",1996,294,29,323,51838,6.23095026814306
34540,"Mount Vernon, OH",1997,283,36,319,52654,6.05841911345767
34540,"Mount Vernon, OH",1998,385,16,401,53339,7.51795121768312
34540,"Mount Vernon, OH",1999,338,80,418,53831,7.76504244766027
34540,"Mount Vernon, OH",2000,290,35,325,54616,5.95063717591914
34540,"Mount Vernon, OH",2001,321,4,325,55460,5.86007933645871
34540,"Mount Vernon, OH",2002,345,10,355,56377,6.29689412349008
34540,"Mount Vernon, OH",2003,375,19,394,57232,6.88426055353648
34540,"Mount Vernon, OH",2004,372,4,376,57995,6.48331752737305
34540,"Mount Vernon, OH",2005,365,8,373,58641,6.36073736805307
34540,"Mount Vernon, OH",2006,267,70,337,59194,5.69314457546373
34540,"Mount Vernon, OH",2007,200,9,209,59843,3.4924719683171
34540,"Mount Vernon, OH",2008,123,2,125,60348,2.07131967919401
34540,"Mount Vernon, OH",2009,100,0,100,60633,1.64926690086257
34540,"Mount Vernon, OH",2010,117,108,225,61095,3.68278909894427
34540,"Mount Vernon, OH",2011,110,0,110,61279,1.79506845738344
34540,"Mount Vernon, OH",2012,100,0,100,60764,1.64571127641367
34540,"Mount Vernon, OH",2013,114,8,122,60856,2.00473248323912
34540,"Mount Vernon, OH",2014,119,0,119,60996,1.95094760312152
34540,"Mount Vernon, OH",2015,117,4,121,60987,1.9840293833112
34540,"Mount Vernon, OH",2016,138,10,148,60897,2.4303331855428
34540,"Mount Vernon, OH",2017,120,12,132,61303,2.15323883007357
34540,"Mount Vernon, OH",2018,133,0,133,61893,2.14886982372805
34580,"Mount Vernon-Anacortes, WA",1990,748,398,1146,80445,14.2457579712847
34580,"Mount Vernon-Anacortes, WA",1991,599,290,889,83697,10.6216471319163
34580,"Mount Vernon-Anacortes, WA",1992,723,181,904,86325,10.4720532869968
34580,"Mount Vernon-Anacortes, WA",1993,690,169,859,89352,9.61366281672486
34580,"Mount Vernon-Anacortes, WA",1994,752,102,854,91591,9.32406022425784
34580,"Mount Vernon-Anacortes, WA",1995,538,364,902,93753,9.6210254605186
34580,"Mount Vernon-Anacortes, WA",1996,525,74,599,95380,6.28014258754456
34580,"Mount Vernon-Anacortes, WA",1997,490,34,524,97113,5.39577605469916
34580,"Mount Vernon-Anacortes, WA",1998,485,157,642,99414,6.4578429597441
34580,"Mount Vernon-Anacortes, WA",1999,528,124,652,101139,6.44657352752153
34580,"Mount Vernon-Anacortes, WA",2000,564,113,677,103420,6.54612260684587
34580,"Mount Vernon-Anacortes, WA",2001,505,214,719,104534,6.87814490979012
34580,"Mount Vernon-Anacortes, WA",2002,610,277,887,105563,8.40256529276356
34580,"Mount Vernon-Anacortes, WA",2003,713,191,904,107369,8.41956244353584
34580,"Mount Vernon-Anacortes, WA",2004,770,81,851,109030,7.80519123177107
34580,"Mount Vernon-Anacortes, WA",2005,934,84,1018,110683,9.1974377275643
34580,"Mount Vernon-Anacortes, WA",2006,902,107,1009,112621,8.9592527148578
34580,"Mount Vernon-Anacortes, WA",2007,793,14,807,114066,7.07485140182
34580,"Mount Vernon-Anacortes, WA",2008,397,41,438,115808,3.78212213318596
34580,"Mount Vernon-Anacortes, WA",2009,251,39,290,116557,2.48805305558654
34580,"Mount Vernon-Anacortes, WA",2010,203,4,207,116954,1.76992663782342
34580,"Mount Vernon-Anacortes, WA",2011,179,0,179,117579,1.52238069723335
34580,"Mount Vernon-Anacortes, WA",2012,227,2,229,117721,1.9452773931584
34580,"Mount Vernon-Anacortes, WA",2013,283,0,283,118277,2.3926883502287
34580,"Mount Vernon-Anacortes, WA",2014,262,12,274,119992,2.28348556570438
34580,"Mount Vernon-Anacortes, WA",2015,410,28,438,121604,3.60185520213151
34580,"Mount Vernon-Anacortes, WA",2016,420,85,505,123709,4.08216055420382
34580,"Mount Vernon-Anacortes, WA",2017,534,129,663,126026,5.26081919603891
34580,"Mount Vernon-Anacortes, WA",2018,542,43,585,128206,4.56296897181099
34620,"Muncie, IN",1990,171,87,258,119678,2.15578468891526
34620,"Muncie, IN",1991,282,119,401,119490,3.35592936647418
34620,"Muncie, IN",1992,290,130,420,119480,3.51523267492467
34620,"Muncie, IN",1993,256,87,343,119673,2.86614357457405
34620,"Muncie, IN",1994,286,43,329,118873,2.76765960310584
34620,"Muncie, IN",1995,281,64,345,118681,2.90695225014956
34620,"Muncie, IN",1996,255,18,273,118177,2.31009418076275
34620,"Muncie, IN",1997,267,22,289,117758,2.45418570288218
34620,"Muncie, IN",1998,239,48,287,116365,2.46637734714046
34620,"Muncie, IN",1999,291,74,365,115292,3.16587447524546
34620,"Muncie, IN",2000,270,132,402,118776,3.38452212568196
34620,"Muncie, IN",2001,302,34,336,120281,2.79345865099226
34620,"Muncie, IN",2002,293,20,313,119949,2.60944234633052
34620,"Muncie, IN",2003,290,273,563,119935,4.69420936340518
34620,"Muncie, IN",2004,289,70,359,118938,3.01837932368125
34620,"Muncie, IN",2005,256,11,267,118170,2.25945671490226
34620,"Muncie, IN",2006,153,55,208,117326,1.77283807510697
34620,"Muncie, IN",2007,120,14,134,117229,1.14306187035631
34620,"Muncie, IN",2008,71,4,75,117007,0.640987291358637
34620,"Muncie, IN",2009,44,0,44,117490,0.374499957443187
34620,"Muncie, IN",2010,46,4,50,117652,0.424982150749668
34620,"Muncie, IN",2011,72,10,82,117878,0.6956344695363
34620,"Muncie, IN",2012,44,216,260,117007,2.22208927670994
34620,"Muncie, IN",2013,58,226,284,116817,2.43115299999144
34620,"Muncie, IN",2014,54,44,98,116476,0.841375047220028
34620,"Muncie, IN",2015,46,0,46,115765,0.397356714032739
34620,"Muncie, IN",2016,82,42,124,115676,1.07195961132819
34620,"Muncie, IN",2017,68,4,72,115389,0.623976288901022
34620,"Muncie, IN",2018,52,0,52,114772,0.453072177883107
34660,"Murray, KY",1990,16,49,65,30786,2.11134931462353
34660,"Murray, KY",1991,22,34,56,30897,1.81247370294851
34660,"Murray, KY",1992,18,61,79,31403,2.51568321497946
34660,"Murray, KY",1993,30,57,87,31725,2.74231678486998
34660,"Murray, KY",1994,30,63,93,32102,2.8970157622578
34660,"Murray, KY",1995,20,122,142,32284,4.39846363523727
34660,"Murray, KY",1996,20,118,138,32585,4.23507748964247
34660,"Murray, KY",1997,20,119,139,33172,4.19028095984565
34660,"Murray, KY",1998,22,160,182,33444,5.44193278315991
34660,"Murray, KY",1999,18,231,249,33347,7.46693855519237
34660,"Murray, KY",2000,22,43,65,34160,1.90281030444965
34660,"Murray, KY",2001,24,26,50,34439,1.45184238799036
34660,"Murray, KY",2002,23,80,103,34499,2.98559378532711
34660,"Murray, KY",2003,18,67,85,34896,2.43580926180651
34660,"Murray, KY",2004,16,98,114,35327,3.226993517706
34660,"Murray, KY",2005,36,85,121,35788,3.38102157147647
34660,"Murray, KY",2006,42,46,88,36375,2.4192439862543
34660,"Murray, KY",2007,66,143,209,36585,5.71272379390461
34660,"Murray, KY",2008,14,31,45,36686,1.226625960857
34660,"Murray, KY",2009,18,18,36,36886,0.975980046630158
34660,"Murray, KY",2010,31,15,46,37347,1.23169196990387
34660,"Murray, KY",2011,22,0,22,37668,0.584050122119571
34660,"Murray, KY",2012,30,59,89,38054,2.33878173122405
34660,"Murray, KY",2013,30,75,105,38435,2.73188500065045
34660,"Murray, KY",2014,40,251,291,38465,7.56531912127908
34660,"Murray, KY",2015,15,86,101,38658,2.61265456050494
34660,"Murray, KY",2016,27,92,119,38759,3.07025465053278
34660,"Murray, KY",2017,18,74,92,38865,2.36716840344783
34660,"Murray, KY",2018,18,37,55,39135,1.40539159320302
34700,"Muscatine, IA",1990,73,0,73,39957,1.82696398628526
34700,"Muscatine, IA",1991,72,0,72,40476,1.77883190038541
34700,"Muscatine, IA",1992,108,4,112,40718,2.7506262586571
34700,"Muscatine, IA",1993,98,2,100,41028,2.43735985180852
34700,"Muscatine, IA",1994,107,8,115,41032,2.80269058295964
34700,"Muscatine, IA",1995,108,2,110,41175,2.67152398299939
34700,"Muscatine, IA",1996,103,125,228,40960,5.56640625
34700,"Muscatine, IA",1997,105,0,105,40917,2.5661705403622
34700,"Muscatine, IA",1998,111,28,139,41003,3.38999585396191
34700,"Muscatine, IA",1999,93,48,141,41123,3.42873817571675
34700,"Muscatine, IA",2000,111,0,111,41791,2.65607427436529
34700,"Muscatine, IA",2001,100,26,126,41760,3.01724137931034
34700,"Muscatine, IA",2002,126,72,198,41757,4.74171995114592
34700,"Muscatine, IA",2003,141,128,269,41654,6.45796322081913
34700,"Muscatine, IA",2004,131,36,167,41758,3.99923367977394
34700,"Muscatine, IA",2005,136,80,216,41894,5.15586957559555
34700,"Muscatine, IA",2006,101,48,149,42145,3.53541345355321
34700,"Muscatine, IA",2007,77,116,193,42325,4.55995274660366
34700,"Muscatine, IA",2008,44,10,54,42515,1.27013995060567
34700,"Muscatine, IA",2009,38,12,50,42783,1.1686884977678
34700,"Muscatine, IA",2010,32,14,46,42749,1.07604856253947
34700,"Muscatine, IA",2011,25,4,29,42786,0.67779180105642
34700,"Muscatine, IA",2012,32,0,32,42863,0.746564636166391
34700,"Muscatine, IA",2013,37,60,97,42960,2.25791433891993
34700,"Muscatine, IA",2014,25,26,51,42982,1.18654320413196
34700,"Muscatine, IA",2015,23,4,27,43020,0.627615062761506
34700,"Muscatine, IA",2016,62,0,62,42925,1.44437973209086
34700,"Muscatine, IA",2017,35,56,91,42892,2.12160775902266
34700,"Muscatine, IA",2018,9,4,13,42929,0.302825595751124
34740,"Muskegon, MI",1990,627,64,691,159345,4.33650255734413
34740,"Muskegon, MI",1991,508,47,555,160686,3.45394122698928
34740,"Muskegon, MI",1992,531,10,541,161773,3.34419217051053
34740,"Muskegon, MI",1993,602,136,738,162558,4.5399180600155
34740,"Muskegon, MI",1994,612,168,780,162993,4.78548158509875
34740,"Muskegon, MI",1995,883,86,969,163609,5.92265706654279
34740,"Muskegon, MI",1996,834,111,945,164747,5.73606803158783
34740,"Muskegon, MI",1997,817,21,838,165894,5.05141837558923
34740,"Muskegon, MI",1998,839,118,957,166796,5.7375476630135
34740,"Muskegon, MI",1999,852,67,919,167810,5.47643167868423
34740,"Muskegon, MI",2000,803,33,836,170396,4.9062184558323
34740,"Muskegon, MI",2001,816,82,898,171055,5.2497734646751
34740,"Muskegon, MI",2002,680,312,992,171563,5.78213251108922
34740,"Muskegon, MI",2003,739,230,969,172269,5.62492381101649
34740,"Muskegon, MI",2004,703,63,766,172771,4.43361443760816
34740,"Muskegon, MI",2005,590,67,657,173608,3.78438781622967
34740,"Muskegon, MI",2006,425,55,480,173710,2.76322606643256
34740,"Muskegon, MI",2007,280,66,346,173738,1.99150444922815
34740,"Muskegon, MI",2008,189,19,208,173846,1.1964612358064
34740,"Muskegon, MI",2009,67,26,93,172755,0.538334635755839
34740,"Muskegon, MI",2010,84,22,106,171911,0.616598123447598
34740,"Muskegon, MI",2011,93,2,95,170004,0.558810380932213
34740,"Muskegon, MI",2012,136,2,138,170144,0.811077675380854
34740,"Muskegon, MI",2013,168,16,184,172268,1.06810318805582
34740,"Muskegon, MI",2014,172,9,181,172266,1.05070066060627
34740,"Muskegon, MI",2015,241,0,241,172462,1.39740928436409
34740,"Muskegon, MI",2016,233,0,233,173242,1.34493944886344
34740,"Muskegon, MI",2017,257,0,257,173656,1.47993734739946
34740,"Muskegon, MI",2018,221,12,233,173588,1.34225868147568
34780,"Muskogee, OK",1990,105,0,105,68172,1.54022179193804
34780,"Muskogee, OK",1991,96,7,103,68521,1.50318880343252
34780,"Muskogee, OK",1992,92,3,95,68932,1.37816979051819
34780,"Muskogee, OK",1993,122,3,125,69142,1.80787365132626
34780,"Muskogee, OK",1994,128,0,128,69574,1.83976772932417
34780,"Muskogee, OK",1995,117,3,120,69629,1.72341983943472
34780,"Muskogee, OK",1996,128,3,131,69763,1.87778621905595
34780,"Muskogee, OK",1997,100,24,124,69804,1.77640249842416
34780,"Muskogee, OK",1998,89,0,89,70126,1.26914411202692
34780,"Muskogee, OK",1999,82,0,82,70150,1.16892373485388
34780,"Muskogee, OK",2000,76,0,76,69418,1.09481690627791
34780,"Muskogee, OK",2001,64,190,254,69428,3.65846632482572
34780,"Muskogee, OK",2002,102,8,110,69334,1.58652320650763
34780,"Muskogee, OK",2003,127,29,156,69666,2.23925587804668
34780,"Muskogee, OK",2004,168,71,239,69592,3.43430279342453
34780,"Muskogee, OK",2005,185,50,235,69806,3.36647279603473
34780,"Muskogee, OK",2006,128,14,142,69958,2.02978930215272
34780,"Muskogee, OK",2007,133,2,135,70119,1.92529842125529
34780,"Muskogee, OK",2008,45,0,45,70050,0.642398286937902
34780,"Muskogee, OK",2009,18,0,18,70677,0.254679740226665
34780,"Muskogee, OK",2010,62,0,62,71118,0.871790545290925
34780,"Muskogee, OK",2011,27,0,27,70756,0.381593080445475
34780,"Muskogee, OK",2012,30,19,49,70542,0.694621643843384
34780,"Muskogee, OK",2013,22,8,30,70192,0.427399133804422
34780,"Muskogee, OK",2014,22,0,22,69743,0.315443843826621
34780,"Muskogee, OK",2015,64,0,64,69331,0.923107989211175
34780,"Muskogee, OK",2016,11,0,11,69026,0.159360241068583
34780,"Muskogee, OK",2017,18,0,18,68959,0.261024666831015
34780,"Muskogee, OK",2018,24,0,24,68362,0.351072233111963
34820,"Myrtle Beach-Conway-North Myrtle Beach, SC-NC",1990,1626,435,2061,196164,10.5065149568728
34820,"Myrtle Beach-Conway-North Myrtle Beach, SC-NC",1991,1543,367,1910,201118,9.49691226046401
34820,"Myrtle Beach-Conway-North Myrtle Beach, SC-NC",1992,1697,579,2276,205604,11.069823544289
34820,"Myrtle Beach-Conway-North Myrtle Beach, SC-NC",1993,1877,509,2386,204583,11.6627481266772
34820,"Myrtle Beach-Conway-North Myrtle Beach, SC-NC",1994,2356,909,3265,210513,15.5097309904851
34820,"Myrtle Beach-Conway-North Myrtle Beach, SC-NC",1995,2792,1374,4166,218140,19.0978270835243
34820,"Myrtle Beach-Conway-North Myrtle Beach, SC-NC",1996,2998,2178,5176,226817,22.8201589827923
34820,"Myrtle Beach-Conway-North Myrtle Beach, SC-NC",1997,3306,2598,5904,235192,25.1028946562808
34820,"Myrtle Beach-Conway-North Myrtle Beach, SC-NC",1998,3469,3291,6760,242976,27.8216778611879
34820,"Myrtle Beach-Conway-North Myrtle Beach, SC-NC",1999,3554,2752,6306,249782,25.2460145246655
34820,"Myrtle Beach-Conway-North Myrtle Beach, SC-NC",2000,3240,2701,5941,271736,21.8631318632791
34820,"Myrtle Beach-Conway-North Myrtle Beach, SC-NC",2001,4040,2332,6372,277987,22.9219351984086
34820,"Myrtle Beach-Conway-North Myrtle Beach, SC-NC",2002,4883,1776,6659,284862,23.3762312979618
34820,"Myrtle Beach-Conway-North Myrtle Beach, SC-NC",2003,6194,1806,8000,292309,27.3682986155062
34820,"Myrtle Beach-Conway-North Myrtle Beach, SC-NC",2004,7811,3086,10897,302421,36.0325506495911
34820,"Myrtle Beach-Conway-North Myrtle Beach, SC-NC",2005,10744,5794,16538,317745,52.0480259327448
34820,"Myrtle Beach-Conway-North Myrtle Beach, SC-NC",2006,10613,4140,14753,336132,43.8904954006164
34820,"Myrtle Beach-Conway-North Myrtle Beach, SC-NC",2007,7200,1499,8699,351472,24.7501934720262
34820,"Myrtle Beach-Conway-North Myrtle Beach, SC-NC",2008,3888,1212,5100,363866,14.0161488020315
34820,"Myrtle Beach-Conway-North Myrtle Beach, SC-NC",2009,2490,444,2934,371417,7.89947686831782
34820,"Myrtle Beach-Conway-North Myrtle Beach, SC-NC",2010,2297,290,2587,378322,6.83809030402673
34820,"Myrtle Beach-Conway-North Myrtle Beach, SC-NC",2011,2395,295,2690,385542,6.97719055252087
34820,"Myrtle Beach-Conway-North Myrtle Beach, SC-NC",2012,3198,359,3557,393219,9.04584976819533
34820,"Myrtle Beach-Conway-North Myrtle Beach, SC-NC",2013,4370,568,4938,403653,12.2332795742878
34820,"Myrtle Beach-Conway-North Myrtle Beach, SC-NC",2014,5027,419,5446,416016,13.0908426598977
34820,"Myrtle Beach-Conway-North Myrtle Beach, SC-NC",2015,5763,391,6154,431167,14.2728919421013
34820,"Myrtle Beach-Conway-North Myrtle Beach, SC-NC",2016,6209,316,6525,447414,14.5838082849441
34820,"Myrtle Beach-Conway-North Myrtle Beach, SC-NC",2017,7468,1119,8587,463386,18.5309871252045
34820,"Myrtle Beach-Conway-North Myrtle Beach, SC-NC",2018,6741,705,7446,480891,15.4837582737044
34860,"Nacogdoches, TX",1990,34,30,64,54821,1.16743583663195
34860,"Nacogdoches, TX",1991,30,24,54,54841,0.984664758118926
34860,"Nacogdoches, TX",1992,49,21,70,54742,1.27872565854371
34860,"Nacogdoches, TX",1993,109,72,181,55193,3.27940137336256
34860,"Nacogdoches, TX",1994,87,0,87,55862,1.55740933013498
34860,"Nacogdoches, TX",1995,61,0,61,55857,1.09207440428236
34860,"Nacogdoches, TX",1996,45,2,47,56030,0.838836337676245
34860,"Nacogdoches, TX",1997,34,74,108,57040,1.89340813464236
34860,"Nacogdoches, TX",1998,44,14,58,56707,1.02280141781438
34860,"Nacogdoches, TX",1999,2,0,2,56643,0.0353088642903801
34860,"Nacogdoches, TX",2000,42,58,100,59224,1.68850466027286
34860,"Nacogdoches, TX",2001,86,145,231,59541,3.87967954854638
34860,"Nacogdoches, TX",2002,64,230,294,59422,4.94766248190906
34860,"Nacogdoches, TX",2003,62,0,62,59816,1.03651197004146
34860,"Nacogdoches, TX",2004,69,33,102,60427,1.68798715805848
34860,"Nacogdoches, TX",2005,101,2,103,60939,1.6902148049689
34860,"Nacogdoches, TX",2006,52,204,256,61750,4.14574898785425
34860,"Nacogdoches, TX",2007,59,40,99,62274,1.58974853068696
34860,"Nacogdoches, TX",2008,42,15,57,62957,0.905379862445796
34860,"Nacogdoches, TX",2009,40,12,52,64012,0.812347684809098
34860,"Nacogdoches, TX",2010,38,212,250,64686,3.86482391862227
34860,"Nacogdoches, TX",2011,50,14,64,65653,0.974822171111754
34860,"Nacogdoches, TX",2012,38,206,244,65869,3.70432221530614
34860,"Nacogdoches, TX",2013,35,2,37,65198,0.567502070615663
34860,"Nacogdoches, TX",2014,32,36,68,65248,1.04217753800883
34860,"Nacogdoches, TX",2015,13,8,21,65538,0.320424791723885
34860,"Nacogdoches, TX",2016,24,4,28,65693,0.426225016363996
34860,"Nacogdoches, TX",2017,2,2,4,65599,0.0609765392765134
34860,"Nacogdoches, TX",2018,0,4,4,65711,0.0608726088478337
34900,"Napa, CA",1990,652,55,707,111223,6.35659890490276
34900,"Napa, CA",1991,419,337,756,111925,6.75452311815948
34900,"Napa, CA",1992,313,104,417,113757,3.66570848387352
34900,"Napa, CA",1993,291,124,415,114154,3.6354398444207
34900,"Napa, CA",1994,382,12,394,114999,3.42611674884129
34900,"Napa, CA",1995,299,17,316,115361,2.73922729518641
34900,"Napa, CA",1996,228,4,232,116391,1.99328126745195
34900,"Napa, CA",1997,370,0,370,117922,3.1376672715863
34900,"Napa, CA",1998,455,35,490,119410,4.10350891885102
34900,"Napa, CA",1999,590,123,713,120566,5.91377336894315
34900,"Napa, CA",2000,538,4,542,124565,4.35114197406976
34900,"Napa, CA",2001,777,134,911,126818,7.18352284376035
34900,"Napa, CA",2002,610,393,1003,128744,7.7906543217548
34900,"Napa, CA",2003,568,39,607,130138,4.6642794571916
34900,"Napa, CA",2004,640,277,917,130387,7.03290972259504
34900,"Napa, CA",2005,628,59,687,130381,5.26917265552496
34900,"Napa, CA",2006,267,240,507,131440,3.8572732805843
34900,"Napa, CA",2007,272,58,330,132583,2.48900688625239
34900,"Napa, CA",2008,216,14,230,134093,1.71522749136793
34900,"Napa, CA",2009,125,6,131,135280,0.96836191602602
34900,"Napa, CA",2010,110,0,110,136808,0.804046546985556
34900,"Napa, CA",2011,128,26,154,137750,1.11796733212341
34900,"Napa, CA",2012,104,8,112,138625,0.807935076645627
34900,"Napa, CA",2013,63,152,215,139706,1.53894607246647
34900,"Napa, CA",2014,92,55,147,140567,1.04576465315472
34900,"Napa, CA",2015,170,2,172,141096,1.21902817939559
34900,"Napa, CA",2016,207,5,212,141185,1.50157594645323
34900,"Napa, CA",2017,83,100,183,140386,1.30354878691607
34900,"Napa, CA",2018,102,167,269,139417,1.92946340833614
34940,"Naples-Immokalee-Marco Island, FL",1990,2138,3708,5846,154231,37.9041826870085
34940,"Naples-Immokalee-Marco Island, FL",1991,1664,1588,3252,162205,20.048703800746
34940,"Naples-Immokalee-Marco Island, FL",1992,1949,2396,4345,168722,25.752421142471
34940,"Naples-Immokalee-Marco Island, FL",1993,1702,1957,3659,176206,20.765467691225
34940,"Naples-Immokalee-Marco Island, FL",1994,1964,2358,4322,184158,23.4689777256486
34940,"Naples-Immokalee-Marco Island, FL",1995,1957,2300,4257,190682,22.3251276995207
34940,"Naples-Immokalee-Marco Island, FL",1996,2383,3066,5449,198081,27.5089483595095
34940,"Naples-Immokalee-Marco Island, FL",1997,2811,3353,6164,207360,29.7260802469136
34940,"Naples-Immokalee-Marco Island, FL",1998,2804,4040,6844,217143,31.5184003168419
34940,"Naples-Immokalee-Marco Island, FL",1999,3765,3777,7542,226072,33.3610531158215
34940,"Naples-Immokalee-Marco Island, FL",2000,4065,3905,7970,254015,31.3760998366238
34940,"Naples-Immokalee-Marco Island, FL",2001,3878,4280,8158,264240,30.8734483802604
34940,"Naples-Immokalee-Marco Island, FL",2002,4173,3109,7282,275490,26.4329013757305
34940,"Naples-Immokalee-Marco Island, FL",2003,3376,2444,5820,285321,20.3980779543041
34940,"Naples-Immokalee-Marco Island, FL",2004,4202,2719,6921,296021,23.3800980335855
34940,"Naples-Immokalee-Marco Island, FL",2005,4052,2570,6622,307452,21.5383214290361
34940,"Naples-Immokalee-Marco Island, FL",2006,2829,1959,4788,312621,15.315669772664
34940,"Naples-Immokalee-Marco Island, FL",2007,1069,1026,2095,314437,6.66270190849041
34940,"Naples-Immokalee-Marco Island, FL",2008,652,299,951,316641,3.00340132831819
34940,"Naples-Immokalee-Marco Island, FL",2009,630,314,944,318485,2.96403284299104
34940,"Naples-Immokalee-Marco Island, FL",2010,766,493,1259,322595,3.90272632867837
34940,"Naples-Immokalee-Marco Island, FL",2011,920,400,1320,327632,4.02891048493432
34940,"Naples-Immokalee-Marco Island, FL",2012,1296,316,1612,332277,4.85137400421937
34940,"Naples-Immokalee-Marco Island, FL",2013,1760,918,2678,339065,7.89819061241945
34940,"Naples-Immokalee-Marco Island, FL",2014,2477,1133,3610,347326,10.3936935328769
34940,"Naples-Immokalee-Marco Island, FL",2015,3078,982,4060,356107,11.4010676566313
34940,"Naples-Immokalee-Marco Island, FL",2016,2892,937,3829,365345,10.4805047284074
34940,"Naples-Immokalee-Marco Island, FL",2017,2930,1264,4194,372345,11.2637473311042
34940,"Naples-Immokalee-Marco Island, FL",2018,3253,1133,4386,378488,11.5882141573841
34980,"Nashville-Davidson--Murfreesboro--Franklin, TN",1990,5944,1263,7207,1107433,6.50784291239289
34980,"Nashville-Davidson--Murfreesboro--Franklin, TN",1991,5890,636,6526,1125277,5.79946093273034
34980,"Nashville-Davidson--Murfreesboro--Franklin, TN",1992,7268,289,7557,1145816,6.59529976889832
34980,"Nashville-Davidson--Murfreesboro--Franklin, TN",1993,8882,578,9460,1171295,8.07653067758336
34980,"Nashville-Davidson--Murfreesboro--Franklin, TN",1994,9296,1772,11068,1199528,9.22696260529141
34980,"Nashville-Davidson--Murfreesboro--Franklin, TN",1995,9813,2498,12311,1226336,10.0388474284372
34980,"Nashville-Davidson--Murfreesboro--Franklin, TN",1996,10954,5758,16712,1252505,13.3428609067429
34980,"Nashville-Davidson--Murfreesboro--Franklin, TN",1997,10224,3419,13643,1278226,10.6733863964588
34980,"Nashville-Davidson--Murfreesboro--Franklin, TN",1998,11114,2151,13265,1299267,10.2096027991167
34980,"Nashville-Davidson--Murfreesboro--Franklin, TN",1999,11850,2692,14542,1317856,11.0345895150912
34980,"Nashville-Davidson--Murfreesboro--Franklin, TN",2000,9550,1944,11494,1387417,8.28445953884088
34980,"Nashville-Davidson--Murfreesboro--Franklin, TN",2001,11253,1748,13001,1409191,9.22586079530738
34980,"Nashville-Davidson--Murfreesboro--Franklin, TN",2002,11882,1146,13028,1427867,9.12409909326289
34980,"Nashville-Davidson--Murfreesboro--Franklin, TN",2003,12904,2032,14936,1450015,10.3005830974162
34980,"Nashville-Davidson--Murfreesboro--Franklin, TN",2004,14567,3416,17983,1478449,12.1634226138338
34980,"Nashville-Davidson--Murfreesboro--Franklin, TN",2005,16000,2590,18590,1511310,12.3005869080467
34980,"Nashville-Davidson--Murfreesboro--Franklin, TN",2006,15625,1658,17283,1553397,11.1259388295458
34980,"Nashville-Davidson--Murfreesboro--Franklin, TN",2007,12039,2821,14860,1592365,9.33203128679668
34980,"Nashville-Davidson--Murfreesboro--Franklin, TN",2008,6291,2525,8816,1626925,5.41881156168846
34980,"Nashville-Davidson--Murfreesboro--Franklin, TN",2009,4324,976,5300,1654243,3.20388238003727
34980,"Nashville-Davidson--Murfreesboro--Franklin, TN",2010,4279,1154,5433,1675475,3.24266252853668
34980,"Nashville-Davidson--Murfreesboro--Franklin, TN",2011,4487,1309,5796,1698280,3.41286478083708
34980,"Nashville-Davidson--Murfreesboro--Franklin, TN",2012,5882,2907,8789,1726925,5.08939299622161
34980,"Nashville-Davidson--Murfreesboro--Franklin, TN",2013,7697,3881,11578,1758982,6.58221630465804
34980,"Nashville-Davidson--Murfreesboro--Franklin, TN",2014,9075,5869,14944,1792933,8.33494614690008
34980,"Nashville-Davidson--Murfreesboro--Franklin, TN",2015,11417,6874,18291,1829347,9.99864979142831
34980,"Nashville-Davidson--Murfreesboro--Franklin, TN",2016,12830,7352,20182,1866873,10.8105907579144
34980,"Nashville-Davidson--Murfreesboro--Franklin, TN",2017,13650,6981,20631,1900584,10.8550845424354
34980,"Nashville-Davidson--Murfreesboro--Franklin, TN",2018,13470,5689,19159,1930961,9.92200256763342
35020,"Natchez, MS-LA",1990,31,0,31,56062,0.5529592237166
35020,"Natchez, MS-LA",1991,32,0,32,55926,0.572184672603083
35020,"Natchez, MS-LA",1992,36,0,36,55480,0.648882480173035
35020,"Natchez, MS-LA",1993,59,0,59,55497,1.06312052903761
35020,"Natchez, MS-LA",1994,45,0,45,55510,0.810664745090975
35020,"Natchez, MS-LA",1995,27,0,27,55438,0.487030556657888
35020,"Natchez, MS-LA",1996,28,0,28,55292,0.506402372856833
35020,"Natchez, MS-LA",1997,22,0,22,55194,0.398594050077907
35020,"Natchez, MS-LA",1998,32,0,32,54892,0.582962908984916
35020,"Natchez, MS-LA",1999,32,0,32,54266,0.58968783400287506
35020,"Natchez, MS-LA",2000,45,0,45,54471,0.826127664261717
35020,"Natchez, MS-LA",2001,39,78,117,54079,2.16350154403743
35020,"Natchez, MS-LA",2002,40,15,55,53862,1.0211280680257
35020,"Natchez, MS-LA",2003,30,0,30,53556,0.560161326462021
35020,"Natchez, MS-LA",2004,35,20,55,52757,1.04251568512235
35020,"Natchez, MS-LA",2005,34,10,44,52559,0.837154435967199
35020,"Natchez, MS-LA",2006,32,20,52,53535,0.971327169141683
35020,"Natchez, MS-LA",2007,21,10,31,53133,0.583441552330943
35020,"Natchez, MS-LA",2008,43,0,43,53049,0.810571358555298
35020,"Natchez, MS-LA",2009,39,0,39,53031,0.735418905922951
35020,"Natchez, MS-LA",2010,24,0,24,53416,0.44930357945185
35020,"Natchez, MS-LA",2011,11,0,11,53273,0.206483584555028
35020,"Natchez, MS-LA",2012,15,0,15,52691,0.284678597863013
35020,"Natchez, MS-LA",2013,16,0,16,52615,0.304095790173905
35020,"Natchez, MS-LA",2014,22,0,22,52551,0.418640939278035
35020,"Natchez, MS-LA",2015,48,0,48,51802,0.926605150380294
35020,"Natchez, MS-LA",2016,43,0,43,51536,0.83436820863086
35020,"Natchez, MS-LA",2017,25,0,25,51186,0.488414800922127
35020,"Natchez, MS-LA",2018,46,0,46,50764,0.906153967378457
35060,"Natchitoches, LA",1990,11,0,11,37074,0.296703889518261
35060,"Natchitoches, LA",1991,10,0,10,36749,0.272116248061172
35060,"Natchitoches, LA",1992,34,0,34,36796,0.924013479726057
35060,"Natchitoches, LA",1993,85,0,85,36959,2.29984577504803
35060,"Natchitoches, LA",1994,86,0,86,37299,2.30569184160433
35060,"Natchitoches, LA",1995,92,14,106,37412,2.83331551373891
35060,"Natchitoches, LA",1996,108,0,108,37229,2.90096430202262
35060,"Natchitoches, LA",1997,95,0,95,37128,2.55871579400991
35060,"Natchitoches, LA",1998,92,68,160,37034,4.32035426905006
35060,"Natchitoches, LA",1999,86,72,158,37383,4.22652007597036
35060,"Natchitoches, LA",2000,68,55,123,39089,3.14666530225895
35060,"Natchitoches, LA",2001,75,65,140,38844,3.60416023066625
35060,"Natchitoches, LA",2002,65,148,213,39178,5.43672469242942
35060,"Natchitoches, LA",2003,90,127,217,38924,5.57496660158257
35060,"Natchitoches, LA",2004,127,8,135,38950,3.46598202824133
35060,"Natchitoches, LA",2005,98,16,114,39107,2.91507914184161
35060,"Natchitoches, LA",2006,173,0,173,38984,4.43771803816951
35060,"Natchitoches, LA",2007,63,88,151,39114,3.86051030321624
35060,"Natchitoches, LA",2008,57,0,57,39244,1.45245133013964
35060,"Natchitoches, LA",2009,43,14,57,39425,1.44578313253012
35060,"Natchitoches, LA",2010,46,8,54,39527,1.36615478027677
35060,"Natchitoches, LA",2011,65,6,71,39380,1.80294565769426
35060,"Natchitoches, LA",2012,43,0,43,39335,1.09317401805008
35060,"Natchitoches, LA",2013,53,0,53,39114,1.3550135501355
35060,"Natchitoches, LA",2014,38,0,38,39117,0.971444640437661
35060,"Natchitoches, LA",2015,54,0,54,38996,1.38475741101651
35060,"Natchitoches, LA",2016,55,0,55,39005,1.41007563132932
35060,"Natchitoches, LA",2017,80,2,82,39038,2.10051744454122
35060,"Natchitoches, LA",2018,76,2,78,38659,2.01764142890401
35100,"New Bern, NC",1990,504,45,549,102857,5.33750741320474
35100,"New Bern, NC",1991,509,28,537,103948,5.16604456074191
35100,"New Bern, NC",1992,544,39,583,105088,5.54773142509135
35100,"New Bern, NC",1993,523,60,583,105048,5.54984388089254
35100,"New Bern, NC",1994,636,50,686,105362,6.51088627778516
35100,"New Bern, NC",1995,622,129,751,106799,7.03190104776262
35100,"New Bern, NC",1996,601,203,804,108234,7.42834968678973
35100,"New Bern, NC",1997,947,145,1092,109591,9.96432188774626
35100,"New Bern, NC",1998,701,198,899,110428,8.14105118267106
35100,"New Bern, NC",1999,572,91,663,111649,5.93825291762577
35100,"New Bern, NC",2000,503,48,551,115156,4.78481364410018
35100,"New Bern, NC",2001,506,181,687,116388,5.90267037838952
35100,"New Bern, NC",2002,673,52,725,115664,6.26815603817955
35100,"New Bern, NC",2003,731,105,836,115776,7.2208402432283
35100,"New Bern, NC",2004,1113,34,1147,116520,9.84380363886028
35100,"New Bern, NC",2005,1260,157,1417,117787,12.0301900888893
35100,"New Bern, NC",2006,1183,36,1219,119915,10.1655339198599
35100,"New Bern, NC",2007,765,39,804,120873,6.65160954059219
35100,"New Bern, NC",2008,541,98,639,122491,5.21670979908728
35100,"New Bern, NC",2009,428,100,528,125202,4.21718502899315
35100,"New Bern, NC",2010,457,76,533,127429,4.18272135856045
35100,"New Bern, NC",2011,387,12,399,128133,3.1139519093442
35100,"New Bern, NC",2012,358,0,358,128413,2.78787973180285
35100,"New Bern, NC",2013,356,0,356,127190,2.79896218256152
35100,"New Bern, NC",2014,264,0,264,126803,2.08196966948731
35100,"New Bern, NC",2015,315,120,435,125434,3.46795924549963
35100,"New Bern, NC",2016,292,0,292,125131,2.33355443495217
35100,"New Bern, NC",2017,295,0,295,125010,2.35981121510279
35100,"New Bern, NC",2018,389,0,389,125219,3.10655731159009
35140,"Newberry, SC",1990,125,0,125,33195,3.7656273535171
35140,"Newberry, SC",1991,94,0,94,33484,2.80731095448572
35140,"Newberry, SC",1992,101,4,105,33509,3.13348652600794
35140,"Newberry, SC",1993,107,0,107,33641,3.18064266817277
35140,"Newberry, SC",1994,122,0,122,33497,3.64211720452578
35140,"Newberry, SC",1995,90,0,90,33913,2.65384955621738
35140,"Newberry, SC",1996,117,0,117,34165,3.42455729547783
35140,"Newberry, SC",1997,111,0,111,34241,3.24172775327823
35140,"Newberry, SC",1998,127,0,127,34472,3.68414945462984
35140,"Newberry, SC",1999,111,0,111,34517,3.21580670394298
35140,"Newberry, SC",2000,128,0,128,35958,3.55970854886256
35140,"Newberry, SC",2001,166,0,166,36053,4.6043325104707
35140,"Newberry, SC",2002,132,0,132,36244,3.64198212117868
35140,"Newberry, SC",2003,104,0,104,36226,2.87086622867554
35140,"Newberry, SC",2004,137,0,137,36312,3.77285745758978
35140,"Newberry, SC",2005,118,0,118,36399,3.24184730349735
35140,"Newberry, SC",2006,148,48,196,36746,5.33391389538997
35140,"Newberry, SC",2007,136,0,136,37061,3.66962575213837
35140,"Newberry, SC",2008,107,44,151,37192,4.06001290600129
35140,"Newberry, SC",2009,78,0,78,37413,2.08483682142571
35140,"Newberry, SC",2010,69,0,69,37610,1.83461845253922
35140,"Newberry, SC",2011,57,0,57,37502,1.51991893765666
35140,"Newberry, SC",2012,78,0,78,37537,2.07794975624051
35140,"Newberry, SC",2013,94,0,94,37470,2.50867360555111
35140,"Newberry, SC",2014,59,0,59,37669,1.56627465555231
35140,"Newberry, SC",2015,78,0,78,37776,2.06480304955527
35140,"Newberry, SC",2016,92,0,92,37947,2.42443407911034
35140,"Newberry, SC",2017,109,0,109,38428,2.83647340480899
35140,"Newberry, SC",2018,77,0,77,38520,1.99896157840083
35220,"New Castle, IN",1990,122,40,162,48159,3.36385722294898
35220,"New Castle, IN",1991,110,40,150,48224,3.11048440610484
35220,"New Castle, IN",1992,136,6,142,48641,2.91934787524928
35220,"New Castle, IN",1993,168,5,173,48697,3.55258024108261
35220,"New Castle, IN",1994,187,5,192,48889,3.92726380167318
35220,"New Castle, IN",1995,179,4,183,49109,3.72640452870146
35220,"New Castle, IN",1996,160,38,198,49011,4.03990940809206
35220,"New Castle, IN",1997,171,4,175,48879,3.58026964545101
35220,"New Castle, IN",1998,192,2,194,48687,3.9846365559595
35220,"New Castle, IN",1999,172,72,244,48424,5.03882372377334
35220,"New Castle, IN",2000,175,34,209,48469,4.31203449627597
35220,"New Castle, IN",2001,136,90,226,48397,4.66971093249582
35220,"New Castle, IN",2002,109,120,229,48258,4.74532719963529
35220,"New Castle, IN",2003,94,0,94,48145,1.95243535154222
35220,"New Castle, IN",2004,103,65,168,48184,3.48663456749128
35220,"New Castle, IN",2005,83,61,144,48064,2.99600532623169
35220,"New Castle, IN",2006,62,0,62,48375,1.28165374677003
35220,"New Castle, IN",2007,35,0,35,48030,0.728711222152821
35220,"New Castle, IN",2008,20,0,20,49420,0.404694455685957
35220,"New Castle, IN",2009,18,0,18,49305,0.36507453605111
35220,"New Castle, IN",2010,20,2,22,49530,0.444175247324854
35220,"New Castle, IN",2011,23,0,23,49212,0.467365683166707
35220,"New Castle, IN",2012,16,0,16,49111,0.325792592290933
35220,"New Castle, IN",2013,13,0,13,48847,0.266137122034106
35220,"New Castle, IN",2014,18,0,18,48889,0.36818098140686
35220,"New Castle, IN",2015,23,8,31,48661,0.63706047964489
35220,"New Castle, IN",2016,27,24,51,48348,1.05485232067511
35220,"New Castle, IN",2017,34,0,34,48247,0.704707028416275
35220,"New Castle, IN",2018,27,24,51,48271,1.05653497959437
35260,"New Castle, PA",1990,184,167,351,96245,3.64694269832199
35260,"New Castle, PA",1991,134,4,138,96168,1.43498876965311
35260,"New Castle, PA",1992,138,34,172,96428,1.78371427386236
35260,"New Castle, PA",1993,156,8,164,96489,1.69967561069137
35260,"New Castle, PA",1994,182,4,186,96260,1.93226677747766
35260,"New Castle, PA",1995,173,34,207,96031,2.15555393570826
35260,"New Castle, PA",1996,185,72,257,95682,2.6859806442173
35260,"New Castle, PA",1997,184,52,236,95265,2.47730016270404
35260,"New Castle, PA",1998,220,164,384,94884,4.04704692045023
35260,"New Castle, PA",1999,229,15,244,94413,2.58438986156567
35260,"New Castle, PA",2000,177,93,270,94547,2.85572255068908
35260,"New Castle, PA",2001,220,14,234,94085,2.48711271722379
35260,"New Castle, PA",2002,191,31,222,93938,2.36326087419362
35260,"New Castle, PA",2003,175,26,201,93696,2.14523565573771
35260,"New Castle, PA",2004,214,14,228,93250,2.44504021447721
35260,"New Castle, PA",2005,169,0,169,92741,1.82227925081679
35260,"New Castle, PA",2006,119,0,119,92248,1.29000086722747
35260,"New Castle, PA",2007,84,13,97,92007,1.05426761007315
35260,"New Castle, PA",2008,89,16,105,91798,1.14381576940674
35260,"New Castle, PA",2009,50,52,102,91391,1.11608364062107
35260,"New Castle, PA",2010,103,2,105,91003,1.15380811621595
35260,"New Castle, PA",2011,33,2,35,90499,0.386744604912761
35260,"New Castle, PA",2012,39,2,41,89867,0.456229761759044
35260,"New Castle, PA",2013,43,0,43,89243,0.481830507714891
35260,"New Castle, PA",2014,41,0,41,88631,0.462592095316537
35260,"New Castle, PA",2015,49,4,53,88113,0.601500346146426
35260,"New Castle, PA",2016,70,28,98,87332,1.12215453671048
35260,"New Castle, PA",2017,48,62,110,86652,1.2694455984859
35260,"New Castle, PA",2018,46,0,46,86184,0.533741761811937
35300,"New Haven-Milford, CT",1990,1393,482,1875,804635,2.33024911916583
35300,"New Haven-Milford, CT",1991,1429,761,2190,803826,2.72447022116727
35300,"New Haven-Milford, CT",1992,1660,232,1892,802058,2.35893164833466
35300,"New Haven-Milford, CT",1993,1811,499,2310,799463,2.88943953628873
35300,"New Haven-Milford, CT",1994,1798,166,1964,796764,2.46497080691397
35300,"New Haven-Milford, CT",1995,1733,208,1941,793859,2.44501857382734
35300,"New Haven-Milford, CT",1996,1561,177,1738,792787,2.1922660184892
35300,"New Haven-Milford, CT",1997,1584,445,2029,792368,2.56067887648163
35300,"New Haven-Milford, CT",1998,1749,552,2301,793211,2.90086748670908
35300,"New Haven-Milford, CT",1999,1857,477,2334,793337,2.94200320922887
35300,"New Haven-Milford, CT",2000,1597,321,1918,824911,2.32509931374415
35300,"New Haven-Milford, CT",2001,1363,223,1586,829875,1.911131194457
35300,"New Haven-Milford, CT",2002,1602,99,1701,835099,2.03688424965184
35300,"New Haven-Milford, CT",2003,1340,486,1826,841939,2.16880320308241
35300,"New Haven-Milford, CT",2004,1752,782,2534,844505,3.00057430092184
35300,"New Haven-Milford, CT",2005,1693,558,2251,847162,2.6571069051728
35300,"New Haven-Milford, CT",2006,1156,498,1654,850207,1.94540858873192
35300,"New Haven-Milford, CT",2007,786,470,1256,853598,1.47141863031544
35300,"New Haven-Milford, CT",2008,615,305,920,856622,1.07398595880096
35300,"New Haven-Milford, CT",2009,393,116,509,860025,0.591843260370338
35300,"New Haven-Milford, CT",2010,452,567,1019,863382,1.18024234927298
35300,"New Haven-Milford, CT",2011,422,267,689,863827,0.797613411018641
35300,"New Haven-Milford, CT",2012,466,203,669,864589,0.773778061020901
35300,"New Haven-Milford, CT",2013,460,355,815,862889,0.944501552343349
35300,"New Haven-Milford, CT",2014,484,656,1140,862996,1.32097947151551
35300,"New Haven-Milford, CT",2015,422,739,1161,860292,1.34954178348747
35300,"New Haven-Milford, CT",2016,378,540,918,857991,1.06994129309049
35300,"New Haven-Milford, CT",2017,469,281,750,857794,0.874335796240123
35300,"New Haven-Milford, CT",2018,406,760,1166,857620,1.35957650241366
35380,"New Orleans-Metairie, LA",1990,1979,303,2282,1218511,1.87277751288253
35380,"New Orleans-Metairie, LA",1991,2340,140,2480,1290258,1.92209620091486
35380,"New Orleans-Metairie, LA",1992,3031,261,3292,1298587,2.53506311090439
35380,"New Orleans-Metairie, LA",1993,3373,260,3633,1303079,2.78801208522277
35380,"New Orleans-Metairie, LA",1994,3622,508,4130,1307583,3.15849930750094
35380,"New Orleans-Metairie, LA",1995,3268,752,4020,1310770,3.06689960862699
35380,"New Orleans-Metairie, LA",1996,3682,1057,4739,1308321,3.62219975067281
35380,"New Orleans-Metairie, LA",1997,3597,537,4134,1307368,3.1620783130687
35380,"New Orleans-Metairie, LA",1998,3700,681,4381,1306055,3.35437634709105
35380,"New Orleans-Metairie, LA",1999,3754,1179,4933,1305578,3.77840312872919
35380,"New Orleans-Metairie, LA",2000,3489,694,4183,1339280,3.12331999283197
35380,"New Orleans-Metairie, LA",2001,3518,939,4457,1344528,3.31491794890103
35380,"New Orleans-Metairie, LA",2002,4357,1057,5414,1354638,3.99663969267066
35380,"New Orleans-Metairie, LA",2003,5386,772,6158,1365146,4.51087282971931
35380,"New Orleans-Metairie, LA",2004,5792,702,6494,1377699,4.71365661149496
35380,"New Orleans-Metairie, LA",2005,4660,293,4953,1386429,3.57248730371335
35380,"New Orleans-Metairie, LA",2006,5100,659,5759,1040195,5.53646191339124
35380,"New Orleans-Metairie, LA",2007,4054,3025,7079,1096365,6.45679130581513
35380,"New Orleans-Metairie, LA",2008,2803,2037,4840,1135831,4.26119730840239
35380,"New Orleans-Metairie, LA",2009,2231,646,2877,1167842,2.46351818139783
35380,"New Orleans-Metairie, LA",2010,1911,300,2211,1195320,1.84971388414818
35380,"New Orleans-Metairie, LA",2011,2071,385,2456,1213891,2.02324590922908
35380,"New Orleans-Metairie, LA",2012,2062,278,2340,1226858,1.9073111965688
35380,"New Orleans-Metairie, LA",2013,2494,175,2669,1239607,2.15310174918341
35380,"New Orleans-Metairie, LA",2014,2440,551,2991,1248964,2.39478479764028
35380,"New Orleans-Metairie, LA",2015,2093,402,2495,1260452,1.9794486422331
35380,"New Orleans-Metairie, LA",2016,2494,492,2986,1267894,2.35508646621878
35380,"New Orleans-Metairie, LA",2017,2720,246,2966,1270465,2.33457828432897
35380,"New Orleans-Metairie, LA",2018,3046,818,3864,1270399,3.04156410702464
35420,"New Philadelphia-Dover, OH",1990,141,38,179,84135,2.12753313127711
35420,"New Philadelphia-Dover, OH",1991,107,24,131,84809,1.54464738412197
35420,"New Philadelphia-Dover, OH",1992,128,15,143,85357,1.67531661140855
35420,"New Philadelphia-Dover, OH",1993,181,20,201,85733,2.34448812009378
35420,"New Philadelphia-Dover, OH",1994,184,30,214,86453,2.47533341815784
35420,"New Philadelphia-Dover, OH",1995,152,52,204,87270,2.33757304915779
35420,"New Philadelphia-Dover, OH",1996,151,95,246,87739,2.80377027319664
35420,"New Philadelphia-Dover, OH",1997,144,80,224,88073,2.54334472539825
35420,"New Philadelphia-Dover, OH",1998,139,54,193,88502,2.18074167815417
35420,"New Philadelphia-Dover, OH",1999,138,18,156,88626,1.76020580867917
35420,"New Philadelphia-Dover, OH",2000,143,30,173,91043,1.90020100392122
35420,"New Philadelphia-Dover, OH",2001,159,26,185,91319,2.02586537303299
35420,"New Philadelphia-Dover, OH",2002,148,12,160,91735,1.74415435766065
35420,"New Philadelphia-Dover, OH",2003,162,33,195,92015,2.11921969244145
35420,"New Philadelphia-Dover, OH",2004,207,22,229,92348,2.47975050894443
35420,"New Philadelphia-Dover, OH",2005,146,18,164,92286,1.77708428147281
35420,"New Philadelphia-Dover, OH",2006,115,26,141,92271,1.52810742270052
35420,"New Philadelphia-Dover, OH",2007,94,14,108,92511,1.16742873820411
35420,"New Philadelphia-Dover, OH",2008,63,18,81,92634,0.87440896431116
35420,"New Philadelphia-Dover, OH",2009,47,0,47,92584,0.507647109651776
35420,"New Philadelphia-Dover, OH",2010,38,5,43,92551,0.464608702229041
35420,"New Philadelphia-Dover, OH",2011,28,14,42,92484,0.454132606721163
35420,"New Philadelphia-Dover, OH",2012,48,14,62,92418,0.670864983011967
35420,"New Philadelphia-Dover, OH",2013,62,0,62,92610,0.669474138861894
35420,"New Philadelphia-Dover, OH",2014,53,6,59,92668,0.636681486597315
35420,"New Philadelphia-Dover, OH",2015,60,8,68,92773,0.732971877593696
35420,"New Philadelphia-Dover, OH",2016,67,0,67,92600,0.72354211663067
35420,"New Philadelphia-Dover, OH",2017,82,8,90,92411,0.973910032355455
35420,"New Philadelphia-Dover, OH",2018,48,18,66,92176,0.716021524040965
35440,"Newport, OR",1990,296,38,334,39078,8.54700854700855
35440,"Newport, OR",1991,273,51,324,39936,8.11298076923077
35440,"Newport, OR",1992,287,61,348,40835,8.52210113872903
35440,"Newport, OR",1993,351,116,467,42049,11.1060905134486
35440,"Newport, OR",1994,281,199,480,43136,11.1275964391691
35440,"Newport, OR",1995,265,140,405,44189,9.16517685396818
35440,"Newport, OR",1996,217,175,392,44813,8.74746167406779
35440,"Newport, OR",1997,187,57,244,45420,5.37208278291502
35440,"Newport, OR",1998,208,78,286,45260,6.31904551480336
35440,"Newport, OR",1999,186,47,233,45077,5.16893315881714
35440,"Newport, OR",2000,177,137,314,44317,7.08531714691879
35440,"Newport, OR",2001,164,15,179,43854,4.08172572627354
35440,"Newport, OR",2002,206,19,225,44270,5.08244861079738
35440,"Newport, OR",2003,252,2,254,44421,5.71801625357376
35440,"Newport, OR",2004,326,54,380,44877,8.46758918822559
35440,"Newport, OR",2005,396,47,443,45347,9.76911372306878
35440,"Newport, OR",2006,401,46,447,45529,9.81791824990665
35440,"Newport, OR",2007,364,40,404,45798,8.82134591030176
35440,"Newport, OR",2008,169,158,327,45915,7.1218556027442
35440,"Newport, OR",2009,100,0,100,45989,2.17443301659092
35440,"Newport, OR",2010,118,0,118,46000,2.56521739130435
35440,"Newport, OR",2011,94,0,94,45868,2.04935903026075
35440,"Newport, OR",2012,109,0,109,46162,2.36124951258611
35440,"Newport, OR",2013,106,0,106,46323,2.28828012002677
35440,"Newport, OR",2014,115,29,144,46348,3.10693018037456
35440,"Newport, OR",2015,132,18,150,47008,3.19094622191967
35440,"Newport, OR",2016,130,37,167,47839,3.49087564539393
35440,"Newport, OR",2017,161,6,167,48820,3.42072920934043
35440,"Newport, OR",2018,169,65,234,49388,4.73799303474528
35460,"Newport, TN",1990,11,34,45,29181,1.54209931119564
35460,"Newport, TN",1991,9,28,37,29214,1.26651605394674
35460,"Newport, TN",1992,4,40,44,29392,1.49700598802395
35460,"Newport, TN",1993,11,30,41,29644,1.38307920658481
35460,"Newport, TN",1994,13,27,40,30696,1.30310138128746
35460,"Newport, TN",1995,12,28,40,30957,1.29211486901186
35460,"Newport, TN",1996,14,23,37,31273,1.18312921689636
35460,"Newport, TN",1997,14,25,39,31657,1.23195501784755
35460,"Newport, TN",1998,14,22,36,31928,1.12753695815585
35460,"Newport, TN",1999,15,21,36,32284,1.11510345682072
35460,"Newport, TN",2000,6,0,6,33595,0.178598005655604
35460,"Newport, TN",2001,0,0,0,33618,0
35460,"Newport, TN",2002,0,0,0,33920,0
35460,"Newport, TN",2003,4,0,4,34234,0.116842904714611
35460,"Newport, TN",2004,4,0,4,34393,0.116302736021865
35460,"Newport, TN",2005,4,0,4,34644,0.115460108532502
35460,"Newport, TN",2006,4,0,4,35001,0.114282449072884
35460,"Newport, TN",2007,3,0,3,35272,0.0850533000680426
35460,"Newport, TN",2008,3,0,3,35666,0.0841137217518085
35460,"Newport, TN",2009,2,0,2,35811,0.0558487615537125
35460,"Newport, TN",2010,2,0,2,35639,0.0561182973708578
35460,"Newport, TN",2011,4,0,4,35403,0.112984775301528
35460,"Newport, TN",2012,0,0,0,35455,0
35460,"Newport, TN",2013,1,0,1,35327,0.0283069606816316
35460,"Newport, TN",2014,1,0,1,35205,0.0284050560999858
35460,"Newport, TN",2015,2,0,2,35068,0.0570320520132314
35460,"Newport, TN",2016,6,0,6,35150,0.170697012802276
35460,"Newport, TN",2017,0,0,0,35481,0
35460,"Newport, TN",2018,0,0,0,35774,0
35500,"Newton, IA",1990,41,46,87,34819,2.49863580229185
35500,"Newton, IA",1991,31,116,147,34740,4.2314335060449
35500,"Newton, IA",1992,63,18,81,34833,2.3253811041254
35500,"Newton, IA",1993,63,46,109,35003,3.11401879838871
35500,"Newton, IA",1994,97,34,131,35168,3.72497725204732
35500,"Newton, IA",1995,101,106,207,35191,5.8821857861385
35500,"Newton, IA",1996,94,21,115,35457,3.24336520292185
35500,"Newton, IA",1997,87,134,221,35785,6.17577197149644
35500,"Newton, IA",1998,100,128,228,36548,6.23837145671446
35500,"Newton, IA",1999,85,29,114,36703,3.10601313244149
35500,"Newton, IA",2000,66,14,80,37252,2.14753570278106
35500,"Newton, IA",2001,87,20,107,37377,2.86272306498649
35500,"Newton, IA",2002,118,6,124,37552,3.30208777162335
35500,"Newton, IA",2003,99,22,121,37703,3.20929369015728
35500,"Newton, IA",2004,92,17,109,37645,2.89547084606189
35500,"Newton, IA",2005,80,57,137,37482,3.65508777546556
35500,"Newton, IA",2006,87,13,100,37288,2.68182793391976
35500,"Newton, IA",2007,46,4,50,37167,1.3452794145344
35500,"Newton, IA",2008,44,2,46,37103,1.23979193057165
35500,"Newton, IA",2009,28,14,42,36879,1.13885951354429
35500,"Newton, IA",2010,26,6,32,36813,0.869258142504007
35500,"Newton, IA",2011,28,0,28,36617,0.764672146817052
35500,"Newton, IA",2012,28,2,30,36574,0.820254825832559
35500,"Newton, IA",2013,37,2,39,36729,1.0618312505105
35500,"Newton, IA",2014,33,0,33,36882,0.894745404262242
35500,"Newton, IA",2015,43,0,43,36740,1.17038649972782
35500,"Newton, IA",2016,57,2,59,36703,1.60749802468463
35500,"Newton, IA",2017,63,14,77,36985,2.08192510477221
35500,"Newton, IA",2018,73,2,75,37147,2.01900557245538
35580,"New Ulm, MN",1990,55,0,55,26973,2.03907611315019
35580,"New Ulm, MN",1991,67,0,67,26959,2.48525538781112
35580,"New Ulm, MN",1992,76,0,76,27074,2.80712122331388
35580,"New Ulm, MN",1993,60,2,62,27212,2.27840658533
35580,"New Ulm, MN",1994,73,21,94,27132,3.46454371222173
35580,"New Ulm, MN",1995,78,24,102,27096,3.7643932683791
35580,"New Ulm, MN",1996,62,39,101,27317,3.6973313321375
35580,"New Ulm, MN",1997,43,6,49,27234,1.79922156128369
35580,"New Ulm, MN",1998,94,30,124,27054,4.58342574111037
35580,"New Ulm, MN",1999,64,0,64,26981,2.37203958341055
35580,"New Ulm, MN",2000,37,2,39,26877,1.4510548052238
35580,"New Ulm, MN",2001,64,12,76,26932,2.82192187732066
35580,"New Ulm, MN",2002,55,40,95,26905,3.53094220405129
35580,"New Ulm, MN",2003,58,122,180,26754,6.72796591163938
35580,"New Ulm, MN",2004,68,49,117,26666,4.38760969024226
35580,"New Ulm, MN",2005,65,0,65,26260,2.47524752475248
35580,"New Ulm, MN",2006,74,26,100,26252,3.80923358220326
35580,"New Ulm, MN",2007,53,6,59,26130,2.25794106391121
35580,"New Ulm, MN",2008,48,6,54,25992,2.07756232686981
35580,"New Ulm, MN",2009,28,4,32,25890,1.23599845500193
35580,"New Ulm, MN",2010,23,4,27,25843,1.04477034400031
35580,"New Ulm, MN",2011,30,0,30,25655,1.16936269732996
35580,"New Ulm, MN",2012,31,0,31,25412,1.21989611207304
35580,"New Ulm, MN",2013,49,72,121,25266,4.78904456581968
35580,"New Ulm, MN",2014,46,44,90,25271,3.56139448379566
35580,"New Ulm, MN",2015,36,0,36,25237,1.42647699805841
35580,"New Ulm, MN",2016,52,0,52,25262,2.05842767793524
35580,"New Ulm, MN",2017,42,43,85,25172,3.37676783727952
35580,"New Ulm, MN",2018,41,6,47,25111,1.87168969774203
35620,"New York-Newark-Jersey City, NY-NJ-PA",1990,16806,10320,27126,17438919,1.55548632343553
35620,"New York-Newark-Jersey City, NY-NJ-PA",1991,16625,5698,22323,17457466,1.27870791786162
35620,"New York-Newark-Jersey City, NY-NJ-PA",1992,19520,5736,25256,17522183,1.44137291569207
35620,"New York-Newark-Jersey City, NY-NJ-PA",1993,22292,7605,29897,17606537,1.69806248667753
35620,"New York-Newark-Jersey City, NY-NJ-PA",1994,22774,7287,30061,17663174,1.70190250064909
35620,"New York-Newark-Jersey City, NY-NJ-PA",1995,20749,8096,28845,17725544,1.62731253833451
35620,"New York-Newark-Jersey City, NY-NJ-PA",1996,22812,13472,36284,17787590,2.03984913077039
35620,"New York-Newark-Jersey City, NY-NJ-PA",1997,25182,13333,38515,17864660,2.15593243868061
35620,"New York-Newark-Jersey City, NY-NJ-PA",1998,27790,15917,43707,17959856,2.43359412235822
35620,"New York-Newark-Jersey City, NY-NJ-PA",1999,28248,18568,46816,18067637,2.59115234604282
35620,"New York-Newark-Jersey City, NY-NJ-PA",2000,27734,24479,52213,18980010,2.75094691730932
35620,"New York-Newark-Jersey City, NY-NJ-PA",2001,23226,24005,47231,19109150,2.47164316570857
35620,"New York-Newark-Jersey City, NY-NJ-PA",2002,23245,26530,49775,19195261,2.59308795019771
35620,"New York-Newark-Jersey City, NY-NJ-PA",2003,21869,30852,52721,19248311,2.73899356676022
35620,"New York-Newark-Jersey City, NY-NJ-PA",2004,22277,37359,59636,19253664,3.0973844770533
35620,"New York-Newark-Jersey City, NY-NJ-PA",2005,23583,46466,70049,19227714,3.64312679083951
35620,"New York-Newark-Jersey City, NY-NJ-PA",2006,18253,44934,63187,19200372,3.29092582164554
35620,"New York-Newark-Jersey City, NY-NJ-PA",2007,13891,44534,58425,19236108,3.03725680891374
35620,"New York-Newark-Jersey City, NY-NJ-PA",2008,9773,43738,53511,19338823,2.76702465294811
35620,"New York-Newark-Jersey City, NY-NJ-PA",2009,7167,10445,17612,19469123,0.904611882106862
35620,"New York-Newark-Jersey City, NY-NJ-PA",2010,7817,12194,20011,19594977,1.02123110427739
35620,"New York-Newark-Jersey City, NY-NJ-PA",2011,6650,16079,22729,19724708,1.15231110138614
35620,"New York-Newark-Jersey City, NY-NJ-PA",2012,7620,20727,28347,19822685,1.43002827316279
35620,"New York-Newark-Jersey City, NY-NJ-PA",2013,10957,30020,40977,19901696,2.05897025057563
35620,"New York-Newark-Jersey City, NY-NJ-PA",2014,11799,36185,47984,19957669,2.40428879745425
35620,"New York-Newark-Jersey City, NY-NJ-PA",2015,11167,75257,86424,19999935,4.32121404394564
35620,"New York-Newark-Jersey City, NY-NJ-PA",2016,10397,32834,43231,20016916,2.15972330602776
35620,"New York-Newark-Jersey City, NY-NJ-PA",2017,11289,39289,50578,19998951,2.52903264776237
35620,"New York-Newark-Jersey City, NY-NJ-PA",2018,11077,38615,49692,19979477,2.48715219122102
35660,"Niles-Benton Harbor, MI",1990,458,96,554,161346,3.43361471619997
35660,"Niles-Benton Harbor, MI",1991,408,64,472,161275,2.92667803441327
35660,"Niles-Benton Harbor, MI",1992,488,8,496,161354,3.07398639017316
35660,"Niles-Benton Harbor, MI",1993,495,44,539,161360,3.34035696579078
35660,"Niles-Benton Harbor, MI",1994,551,53,604,161170,3.74759570639697
35660,"Niles-Benton Harbor, MI",1995,513,34,547,161558,3.38578095792223
35660,"Niles-Benton Harbor, MI",1996,579,119,698,161134,4.33179837898892
35660,"Niles-Benton Harbor, MI",1997,461,86,547,160401,3.41020317828442
35660,"Niles-Benton Harbor, MI",1998,447,222,669,159774,4.18716436967216
35660,"Niles-Benton Harbor, MI",1999,487,171,658,159487,4.12572811577119
35660,"Niles-Benton Harbor, MI",2000,485,22,507,162471,3.12055689938512
35660,"Niles-Benton Harbor, MI",2001,522,22,544,161153,3.37567404888522
35660,"Niles-Benton Harbor, MI",2002,608,6,614,160604,3.82306791860726
35660,"Niles-Benton Harbor, MI",2003,588,20,608,160314,3.79255710667814
35660,"Niles-Benton Harbor, MI",2004,685,46,731,159742,4.57612900802544
35660,"Niles-Benton Harbor, MI",2005,689,127,816,158510,5.14794019304776
35660,"Niles-Benton Harbor, MI",2006,572,53,625,157537,3.96732196245961
35660,"Niles-Benton Harbor, MI",2007,441,26,467,157378,2.96737790542515
35660,"Niles-Benton Harbor, MI",2008,227,54,281,157380,1.78548735544542
35660,"Niles-Benton Harbor, MI",2009,104,16,120,157059,0.764044085343724
35660,"Niles-Benton Harbor, MI",2010,133,0,133,156742,0.848528154546963
35660,"Niles-Benton Harbor, MI",2011,130,6,136,156875,0.866932270916335
35660,"Niles-Benton Harbor, MI",2012,145,6,151,156626,0.964080037797045
35660,"Niles-Benton Harbor, MI",2013,146,45,191,156138,1.22327684484238
35660,"Niles-Benton Harbor, MI",2014,184,0,184,155989,1.17957035431986
35660,"Niles-Benton Harbor, MI",2015,168,40,208,155071,1.34132107228302
35660,"Niles-Benton Harbor, MI",2016,246,66,312,154473,2.01977044532054
35660,"Niles-Benton Harbor, MI",2017,224,13,237,154362,1.53535196486182
35660,"Niles-Benton Harbor, MI",2018,237,65,302,154141,1.95924510675291
35700,"Nogales, AZ",1990,205,38,243,29887,8.13062535550574
35700,"Nogales, AZ",1991,218,25,243,31088,7.81652084405558
35700,"Nogales, AZ",1992,217,71,288,32324,8.90978839252568
35700,"Nogales, AZ",1993,244,57,301,33723,8.92565904575512
35700,"Nogales, AZ",1994,306,79,385,34985,11.0047163069887
35700,"Nogales, AZ",1995,313,46,359,35825,10.0209351011863
35700,"Nogales, AZ",1996,290,77,367,36187,10.1417636167685
35700,"Nogales, AZ",1997,332,83,415,37245,11.1424352262049
35700,"Nogales, AZ",1998,340,72,412,38172,10.79325159803
35700,"Nogales, AZ",1999,284,90,374,39283,9.52065779090192
35700,"Nogales, AZ",2000,329,111,440,38589,11.4022130658996
35700,"Nogales, AZ",2001,312,116,428,39288,10.8939116269599
35700,"Nogales, AZ",2002,379,16,395,40009,9.87277862480942
35700,"Nogales, AZ",2003,509,25,534,40625,13.1446153846154
35700,"Nogales, AZ",2004,508,122,630,41623,15.1358623837782
35700,"Nogales, AZ",2005,695,150,845,42961,19.6690021182002
35700,"Nogales, AZ",2006,690,66,756,44298,17.0662332385209
35700,"Nogales, AZ",2007,364,38,402,45338,8.86673430676254
35700,"Nogales, AZ",2008,171,104,275,46144,5.95960471567268
35700,"Nogales, AZ",2009,72,0,72,47011,1.53155644423646
35700,"Nogales, AZ",2010,53,0,53,47420,1.11767186840995
35700,"Nogales, AZ",2011,51,0,51,47684,1.06954114587702
35700,"Nogales, AZ",2012,34,0,34,47396,0.717360114777618
35700,"Nogales, AZ",2013,44,4,48,46991,1.02147219680364
35700,"Nogales, AZ",2014,44,0,44,46703,0.942123632314841
35700,"Nogales, AZ",2015,66,0,66,46602,1.41624822968971
35700,"Nogales, AZ",2016,70,0,70,46468,1.50641301540845
35700,"Nogales, AZ",2017,93,0,93,46636,1.9941675958487
35700,"Nogales, AZ",2018,148,0,148,46511,3.18204295757993
35740,"Norfolk, NE",1990,118,76,194,46764,4.14849029167736
35740,"Norfolk, NE",1991,80,26,106,46869,2.26162282105443
35740,"Norfolk, NE",1992,130,20,150,47116,3.18363188725698
35740,"Norfolk, NE",1993,117,84,201,47443,4.2366629428999
35740,"Norfolk, NE",1994,131,53,184,47854,3.84502862874577
35740,"Norfolk, NE",1995,147,192,339,48448,6.9971928665786
35740,"Norfolk, NE",1996,177,5,182,48662,3.74008466565287
35740,"Norfolk, NE",1997,147,74,221,48887,4.52062920612842
35740,"Norfolk, NE",1998,158,37,195,48772,3.99819568604937
35740,"Norfolk, NE",1999,133,40,173,48136,3.59398371281369
35740,"Norfolk, NE",2000,110,20,130,49470,2.62785526581767
35740,"Norfolk, NE",2001,117,53,170,49706,3.42011024825977
35740,"Norfolk, NE",2002,127,8,135,49942,2.70313563733931
35740,"Norfolk, NE",2003,138,40,178,49910,3.56641955519936
35740,"Norfolk, NE",2004,179,22,201,49625,4.05037783375315
35740,"Norfolk, NE",2005,171,13,184,49515,3.71604564273452
35740,"Norfolk, NE",2006,131,11,142,49194,2.88653087774932
35740,"Norfolk, NE",2007,99,8,107,47860,2.23568742164647
35740,"Norfolk, NE",2008,116,14,130,47750,2.72251308900524
35740,"Norfolk, NE",2009,73,2,75,48026,1.56165410402699
35740,"Norfolk, NE",2010,72,15,87,48365,1.79882146180089
35740,"Norfolk, NE",2011,57,0,57,48374,1.1783189316575
35740,"Norfolk, NE",2012,79,2,81,48365,1.6747648092629
35740,"Norfolk, NE",2013,72,12,84,48426,1.73460537727667
35740,"Norfolk, NE",2014,93,13,106,48400,2.1900826446281
35740,"Norfolk, NE",2015,86,13,99,48152,2.05598936700449
35740,"Norfolk, NE",2016,82,8,90,48149,1.86919769880994
35740,"Norfolk, NE",2017,86,18,104,48357,2.15067105072689
35740,"Norfolk, NE",2018,82,79,161,48504,3.31931387102095
35820,"North Platte, NE",1990,38,2,40,32492,1.23107226394189
35820,"North Platte, NE",1991,39,8,47,32776,1.43397608005858
35820,"North Platte, NE",1992,47,12,59,33062,1.78452604198173
35820,"North Platte, NE",1993,81,0,81,32991,2.45521505865236
35820,"North Platte, NE",1994,77,6,83,33306,2.49204347565003
35820,"North Platte, NE",1995,101,16,117,33454,3.49733963053745
35820,"North Platte, NE",1996,112,2,114,33516,3.40136054421769
35820,"North Platte, NE",1997,100,160,260,33489,7.76374331870166
35820,"North Platte, NE",1998,103,52,155,33488,4.62852365026278
35820,"North Platte, NE",1999,133,6,139,33842,4.10732226227764
35820,"North Platte, NE",2000,109,52,161,34660,4.64512406231968
35820,"North Platte, NE",2001,105,2,107,34669,3.08633072773948
35820,"North Platte, NE",2002,110,34,144,34525,4.1708906589428
35820,"North Platte, NE",2003,123,67,190,34776,5.46353807223372
35820,"North Platte, NE",2004,114,58,172,35177,4.88955851835006
35820,"North Platte, NE",2005,130,4,134,35577,3.76647834274953
35820,"North Platte, NE",2006,127,0,127,35973,3.53042559697551
35820,"North Platte, NE",2007,80,2,82,36011,2.27708200272139
35820,"North Platte, NE",2008,64,4,68,36301,1.87322663287513
35820,"North Platte, NE",2009,45,0,45,36280,1.24035281146637
35820,"North Platte, NE",2010,49,34,83,36251,2.28959201125486
35820,"North Platte, NE",2011,41,0,41,36029,1.13797218906992
35820,"North Platte, NE",2012,38,0,38,35975,1.05628908964559
35820,"North Platte, NE",2013,44,0,44,35938,1.22433079191942
35820,"North Platte, NE",2014,54,0,54,35652,1.51464153483676
35820,"North Platte, NE",2015,60,16,76,36001,2.1110524707647
35820,"North Platte, NE",2016,59,8,67,36004,1.86090434396178
35820,"North Platte, NE",2017,47,14,61,35808,1.70352993744415
35820,"North Platte, NE",2018,42,0,42,35677,1.1772290271043
35840,"North Port-Sarasota-Bradenton, FL",1990,3901,1967,5868,492507,11.914551468304
35840,"North Port-Sarasota-Bradenton, FL",1991,2699,1155,3854,500995,7.69269154382778
35840,"North Port-Sarasota-Bradenton, FL",1992,3209,807,4016,503734,7.97246165635038
35840,"North Port-Sarasota-Bradenton, FL",1993,3811,807,4618,509939,9.05598512763291
35840,"North Port-Sarasota-Bradenton, FL",1994,4156,999,5155,517658,9.95831224476392
35840,"North Port-Sarasota-Bradenton, FL",1995,3687,1324,5011,523484,9.57240335903294
35840,"North Port-Sarasota-Bradenton, FL",1996,4107,2085,6192,528948,11.7062546790989
35840,"North Port-Sarasota-Bradenton, FL",1997,4457,1822,6279,535339,11.7290165670725
35840,"North Port-Sarasota-Bradenton, FL",1998,5168,2264,7432,542935,13.6885630876624
35840,"North Port-Sarasota-Bradenton, FL",1999,5584,1424,7008,547769,12.7937141386241
35840,"North Port-Sarasota-Bradenton, FL",2000,5889,1221,7110,592809,11.9937450342353
35840,"North Port-Sarasota-Bradenton, FL",2001,7013,2635,9648,605988,15.9211073486604
35840,"North Port-Sarasota-Bradenton, FL",2002,6903,3283,10186,620540,16.4147355529055
35840,"North Port-Sarasota-Bradenton, FL",2003,7897,1128,9025,634862,14.2156878187701
35840,"North Port-Sarasota-Bradenton, FL",2004,10989,3507,14496,653934,22.1673746891888
35840,"North Port-Sarasota-Bradenton, FL",2005,11395,2650,14045,674757,20.8149007716852
35840,"North Port-Sarasota-Bradenton, FL",2006,5983,1688,7671,685132,11.1963825948868
35840,"North Port-Sarasota-Bradenton, FL",2007,2215,466,2681,691735,3.87576167173845
35840,"North Port-Sarasota-Bradenton, FL",2008,1583,489,2072,695944,2.97725104318738
35840,"North Port-Sarasota-Bradenton, FL",2009,1317,446,1763,697973,2.52588567179533
35840,"North Port-Sarasota-Bradenton, FL",2010,1704,251,1955,703364,2.77949966162613
35840,"North Port-Sarasota-Bradenton, FL",2011,1838,547,2385,709772,3.36023399063361
35840,"North Port-Sarasota-Bradenton, FL",2012,2655,447,3102,720351,4.30623404423677
35840,"North Port-Sarasota-Bradenton, FL",2013,3779,1644,5423,731930,7.40917847335128
35840,"North Port-Sarasota-Bradenton, FL",2014,4174,1484,5658,747417,7.57007132564552
35840,"North Port-Sarasota-Bradenton, FL",2015,4992,2149,7141,767429,9.30509532477923
35840,"North Port-Sarasota-Bradenton, FL",2016,5814,2290,8104,788429,10.278668085522
35840,"North Port-Sarasota-Bradenton, FL",2017,5989,2190,8179,805139,10.1584943717793
35840,"North Port-Sarasota-Bradenton, FL",2018,6383,3906,10289,821573,12.5235371659
35860,"North Vernon, IN",1990,83,2,85,23691,3.58786036891647
35860,"North Vernon, IN",1991,60,0,60,23943,2.50595163513344
35860,"North Vernon, IN",1992,111,2,113,24324,4.64561749712218
35860,"North Vernon, IN",1993,98,27,125,24936,5.01283285210138
35860,"North Vernon, IN",1994,124,12,136,25471,5.33940559852381
35860,"North Vernon, IN",1995,112,38,150,26055,5.75705238917674
35860,"North Vernon, IN",1996,117,84,201,26638,7.54561153239733
35860,"North Vernon, IN",1997,95,23,118,27144,4.34718538166814
35860,"North Vernon, IN",1998,108,18,126,27747,4.54103146286085
35860,"North Vernon, IN",1999,212,0,212,28106,7.54287340781328
35860,"North Vernon, IN",2000,208,0,208,27747,7.49630590694489
35860,"North Vernon, IN",2001,192,19,211,27932,7.55405985965917
35860,"North Vernon, IN",2002,132,0,132,28131,4.69233230244215
35860,"North Vernon, IN",2003,129,10,139,28012,4.96215907468228
35860,"North Vernon, IN",2004,130,4,134,28202,4.75143606836395
35860,"North Vernon, IN",2005,115,4,119,28352,4.19723476297968
35860,"North Vernon, IN",2006,107,6,113,28320,3.99011299435028
35860,"North Vernon, IN",2007,86,0,86,28502,3.01733211704442
35860,"North Vernon, IN",2008,57,0,57,28480,2.00140449438202
35860,"North Vernon, IN",2009,45,0,45,28546,1.57640299866882
35860,"North Vernon, IN",2010,37,0,37,28482,1.29906607682045
35860,"North Vernon, IN",2011,44,0,44,28152,1.56294401818698
35860,"North Vernon, IN",2012,37,0,37,28142,1.31476085566058
35860,"North Vernon, IN",2013,46,0,46,28225,1.62976085031001
35860,"North Vernon, IN",2014,47,0,47,27915,1.68368260791689
35860,"North Vernon, IN",2015,34,0,34,27829,1.22174709835064
35860,"North Vernon, IN",2016,37,0,37,27642,1.33854279719268
35860,"North Vernon, IN",2017,45,0,45,27638,1.6281930675157399
35860,"North Vernon, IN",2018,50,0,50,27611,1.81087247836007
35900,"North Wilkesboro, NC",1990,175,0,175,59463,2.94300657551755
35900,"North Wilkesboro, NC",1991,148,6,154,59647,2.58185658960216
35900,"North Wilkesboro, NC",1992,190,2,192,59992,3.20042672356314
35900,"North Wilkesboro, NC",1993,203,59,262,60155,4.35541517745823
35900,"North Wilkesboro, NC",1994,197,6,203,60651,3.34701818601507
35900,"North Wilkesboro, NC",1995,182,32,214,60971,3.50986534582014
35900,"North Wilkesboro, NC",1996,203,2,205,61851,3.31441690514301
35900,"North Wilkesboro, NC",1997,263,16,279,62300,4.47833065810594
35900,"North Wilkesboro, NC",1998,296,23,319,62749,5.08374635452358
35900,"North Wilkesboro, NC",1999,263,16,279,63521,4.39224823286787
35900,"North Wilkesboro, NC",2000,235,7,242,65839,3.67563298349003
35900,"North Wilkesboro, NC",2001,183,8,191,66694,2.86382583140912
35900,"North Wilkesboro, NC",2002,189,0,189,67202,2.81241629713401
35900,"North Wilkesboro, NC",2003,208,46,254,67617,3.75645177987784
35900,"North Wilkesboro, NC",2004,241,48,289,67668,4.27085180587575
35900,"North Wilkesboro, NC",2005,231,0,231,68104,3.39187125572654
35900,"North Wilkesboro, NC",2006,262,0,262,68489,3.82543182116836
35900,"North Wilkesboro, NC",2007,202,0,202,68966,2.92897949714352
35900,"North Wilkesboro, NC",2008,138,0,138,69317,1.99085361455343
35900,"North Wilkesboro, NC",2009,107,2,109,69258,1.57382540645124
35900,"North Wilkesboro, NC",2010,89,0,89,69270,1.28482748664646
35900,"North Wilkesboro, NC",2011,96,32,128,68944,1.85657925272685
35900,"North Wilkesboro, NC",2012,85,0,85,68916,1.23338557083986
35900,"North Wilkesboro, NC",2013,96,64,160,68622,2.3316137681793
35900,"North Wilkesboro, NC",2014,92,0,92,68432,1.34440028057049
35900,"North Wilkesboro, NC",2015,107,52,159,68291,2.32827166098022
35900,"North Wilkesboro, NC",2016,96,48,144,68554,2.10053388569595
35900,"North Wilkesboro, NC",2017,120,0,120,68464,1.75274596868427
35900,"North Wilkesboro, NC",2018,94,0,94,68557,1.37112184022055
35940,"Norwalk, OH",1990,137,35,172,56407,3.04926693495488
35940,"Norwalk, OH",1991,123,16,139,57084,2.43500805830005
35940,"Norwalk, OH",1992,116,60,176,57426,3.0648138473862
35940,"Norwalk, OH",1993,138,19,157,57610,2.72522131574379
35940,"Norwalk, OH",1994,178,12,190,58011,3.27524090258744
35940,"Norwalk, OH",1995,202,17,219,58684,3.73185195283212
35940,"Norwalk, OH",1996,185,25,210,59456,3.53202368137783
35940,"Norwalk, OH",1997,216,25,241,59974,4.01840797678994
35940,"Norwalk, OH",1998,195,10,205,60188,3.40599455040872
35940,"Norwalk, OH",1999,149,7,156,60454,2.58047441029543
35940,"Norwalk, OH",2000,147,13,160,59611,2.68406837664189
35940,"Norwalk, OH",2001,165,26,191,59620,3.20362294532036
35940,"Norwalk, OH",2002,146,35,181,59917,3.02084550294574
35940,"Norwalk, OH",2003,168,24,192,59947,3.20282916576309
35940,"Norwalk, OH",2004,158,39,197,60011,3.28273149922514
35940,"Norwalk, OH",2005,124,42,166,60116,2.76132809900858
35940,"Norwalk, OH",2006,101,102,203,60113,3.37697336682581
35940,"Norwalk, OH",2007,57,65,122,60086,2.03042306028027
35940,"Norwalk, OH",2008,37,73,110,60121,1.82964355216979
35940,"Norwalk, OH",2009,42,10,52,59754,0.87023462864410694
35940,"Norwalk, OH",2010,35,0,35,59561,0.587632846997196
35940,"Norwalk, OH",2011,29,2,31,59411,0.521788894312501
35940,"Norwalk, OH",2012,23,0,23,59199,0.388520076352641
35940,"Norwalk, OH",2013,35,76,111,58822,1.88704906327565
35940,"Norwalk, OH",2014,40,0,40,58610,0.682477392936359
35940,"Norwalk, OH",2015,41,15,56,58320,0.960219478737997
35940,"Norwalk, OH",2016,46,7,53,58391,0.907674127862171
35940,"Norwalk, OH",2017,33,6,39,58462,0.667099996578974
35940,"Norwalk, OH",2018,35,4,39,58504,0.666621085737727
35980,"Norwich-New London, CT",1990,558,193,751,255186,2.94295141583002
35980,"Norwich-New London, CT",1991,607,57,664,254323,2.61085312771554
35980,"Norwich-New London, CT",1992,741,8,749,249755,2.99893896018098
35980,"Norwich-New London, CT",1993,706,116,822,250189,3.28551614979076
35980,"Norwich-New London, CT",1994,804,322,1126,250764,4.49027771131422
35980,"Norwich-New London, CT",1995,752,53,805,251796,3.1970325183879
35980,"Norwich-New London, CT",1996,785,141,926,251553,3.68113280302759
35980,"Norwich-New London, CT",1997,740,75,815,250351,3.25542937715448
35980,"Norwich-New London, CT",1998,904,68,972,247270,3.93092570873943
35980,"Norwich-New London, CT",1999,863,16,879,247069,3.55771059906342
35980,"Norwich-New London, CT",2000,814,0,814,259848,3.13260059727225
35980,"Norwich-New London, CT",2001,766,16,782,261396,2.99162955821818
35980,"Norwich-New London, CT",2002,845,111,956,264698,3.61166310285684
35980,"Norwich-New London, CT",2003,947,275,1222,266584,4.58392101551481
35980,"Norwich-New London, CT",2004,987,361,1348,268595,5.01870846441669
35980,"Norwich-New London, CT",2005,945,263,1208,269664,4.47964874807167
35980,"Norwich-New London, CT",2006,801,205,1006,270814,3.71472671279919
35980,"Norwich-New London, CT",2007,572,146,718,270669,2.65268649161891
35980,"Norwich-New London, CT",2008,308,55,363,272634,1.33145535773234
35980,"Norwich-New London, CT",2009,259,168,427,273630,1.56050140700947
35980,"Norwich-New London, CT",2010,285,59,344,273998,1.25548361666873
35980,"Norwich-New London, CT",2011,195,14,209,273013,0.76553131169578
35980,"Norwich-New London, CT",2012,261,30,291,274085,1.06171443165441
35980,"Norwich-New London, CT",2013,326,46,372,272981,1.36273220480546
35980,"Norwich-New London, CT",2014,288,358,646,271465,2.37968062181128
35980,"Norwich-New London, CT",2015,238,293,531,269717,1.96873018756697
35980,"Norwich-New London, CT",2016,258,72,330,268612,1.2285378166277
35980,"Norwich-New London, CT",2017,226,69,295,267826,1.10146139657838
35980,"Norwich-New London, CT",2018,297,369,666,266784,2.49640158330335
36020,"Oak Harbor, WA",1990,838,230,1068,60968,17.517386169794
36020,"Oak Harbor, WA",1991,579,41,620,62262,9.95791975844014
36020,"Oak Harbor, WA",1992,564,77,641,65191,9.83264561059042
36020,"Oak Harbor, WA",1993,556,32,588,65422,8.9878022683501
36020,"Oak Harbor, WA",1994,735,21,756,66798,11.3177041228779
36020,"Oak Harbor, WA",1995,591,99,690,68061,10.1379644730462
36020,"Oak Harbor, WA",1996,585,144,729,68765,10.6013233476332
36020,"Oak Harbor, WA",1997,641,20,661,71004,9.30933468536984
36020,"Oak Harbor, WA",1998,637,0,637,71466,8.91332941538634
36020,"Oak Harbor, WA",1999,570,22,592,73088,8.09982486865149
36020,"Oak Harbor, WA",2000,540,29,569,71886,7.91531035250257
36020,"Oak Harbor, WA",2001,518,67,585,73884,7.91781711872665
36020,"Oak Harbor, WA",2002,532,38,570,74840,7.61624799572421
36020,"Oak Harbor, WA",2003,598,58,656,74670,8.78532208383554
36020,"Oak Harbor, WA",2004,698,192,890,77667,11.4591782867885
36020,"Oak Harbor, WA",2005,752,16,768,77589,9.89831032749488
36020,"Oak Harbor, WA",2006,634,5,639,79136,8.0747068338051
36020,"Oak Harbor, WA",2007,463,56,519,78726,6.59248532886213
36020,"Oak Harbor, WA",2008,329,0,329,78375,4.19776714513557
36020,"Oak Harbor, WA",2009,198,0,198,78248,2.53041611287189
36020,"Oak Harbor, WA",2010,219,0,219,78690,2.78307281738467
36020,"Oak Harbor, WA",2011,164,0,164,78936,2.07763251241512
36020,"Oak Harbor, WA",2012,176,2,178,79035,2.25216676156133
36020,"Oak Harbor, WA",2013,221,0,221,78196,2.8262315207939
36020,"Oak Harbor, WA",2014,252,0,252,78698,3.20211441205622
36020,"Oak Harbor, WA",2015,281,0,281,80031,3.51113943346953
36020,"Oak Harbor, WA",2016,369,4,373,81708,4.56503647133696
36020,"Oak Harbor, WA",2017,401,7,408,83285,4.89884132797022
36020,"Oak Harbor, WA",2018,375,16,391,84460,4.62941037177362
36100,"Ocala, FL",1990,1942,46,1988,196874,10.0978290683381
36100,"Ocala, FL",1991,1994,59,2053,202632,10.1316672588732
36100,"Ocala, FL",1992,2056,80,2136,207277,10.3050507292174
36100,"Ocala, FL",1993,2281,92,2373,211699,11.2093113335443
36100,"Ocala, FL",1994,2291,26,2317,219291,10.5658690963149
36100,"Ocala, FL",1995,1936,179,2115,225232,9.39031753924842
36100,"Ocala, FL",1996,2246,188,2434,230083,10.5787911318959
36100,"Ocala, FL",1997,2395,803,3198,235471,13.5812902650433
36100,"Ocala, FL",1998,2634,53,2687,240995,11.149608913048
36100,"Ocala, FL",1999,2593,166,2759,244601,11.2795941144967
36100,"Ocala, FL",2000,2333,21,2354,260221,9.04615692046376
36100,"Ocala, FL",2001,3097,74,3171,264553,11.9862560621123
36100,"Ocala, FL",2002,5384,777,6161,271716,22.6744100457831
36100,"Ocala, FL",2003,5841,634,6475,280091,23.1174868167845
36100,"Ocala, FL",2004,5268,158,5426,291164,18.6355456031652
36100,"Ocala, FL",2005,6542,911,7453,303558,24.5521448948801
36100,"Ocala, FL",2006,6753,310,7063,316310,22.3293604375454
36100,"Ocala, FL",2007,2536,499,3035,325634,9.32027982335997
36100,"Ocala, FL",2008,1119,20,1139,330052,3.4509713620884
36100,"Ocala, FL",2009,370,24,394,330880,1.19076402321083
36100,"Ocala, FL",2010,481,0,481,331340,1.45168105269512
36100,"Ocala, FL",2011,356,5,361,332275,1.08644947708976
36100,"Ocala, FL",2012,397,4,401,333900,1.20095837076969
36100,"Ocala, FL",2013,588,42,630,335117,1.87994043871245
36100,"Ocala, FL",2014,713,41,754,338057,2.23039309938856
36100,"Ocala, FL",2015,1055,0,1055,342335,3.0817766223144
36100,"Ocala, FL",2016,1412,16,1428,347767,4.10619754030716
36100,"Ocala, FL",2017,1942,304,2246,353717,6.34970894811389
36100,"Ocala, FL",2018,2726,91,2817,359977,7.8254999624976
36140,"Ocean City, NJ",1990,427,194,621,95255,6.51934281665005
36140,"Ocean City, NJ",1991,247,92,339,96430,3.51550347402261
36140,"Ocean City, NJ",1992,332,190,522,97074,5.37734099758947
36140,"Ocean City, NJ",1993,326,201,527,96990,5.43354985050005
36140,"Ocean City, NJ",1994,579,196,775,97566,7.94334091794273
36140,"Ocean City, NJ",1995,364,180,544,97926,5.55521516246962
36140,"Ocean City, NJ",1996,388,283,671,97905,6.85358255451713
36140,"Ocean City, NJ",1997,491,421,912,97944,9.31144327370742
36140,"Ocean City, NJ",1998,619,396,1015,97965,10.3608431582708
36140,"Ocean City, NJ",1999,732,494,1226,97744,12.5429693894254
36140,"Ocean City, NJ",2000,791,451,1242,102314,12.139101198272
36140,"Ocean City, NJ",2001,832,571,1403,102023,13.7518010644659
36140,"Ocean City, NJ",2002,814,608,1422,101694,13.9831258481326
36140,"Ocean City, NJ",2003,1099,594,1693,101710,16.6453642709665
36140,"Ocean City, NJ",2004,1101,1048,2149,100482,21.3869150693657
36140,"Ocean City, NJ",2005,1125,1308,2433,99269,24.5091619740302
36140,"Ocean City, NJ",2006,774,806,1580,98695,16.0089163584781
36140,"Ocean City, NJ",2007,625,456,1081,97686,11.0660688327908
36140,"Ocean City, NJ",2008,379,106,485,97550,4.97180932854946
36140,"Ocean City, NJ",2009,266,162,428,97238,4.40157140212674
36140,"Ocean City, NJ",2010,284,150,434,97221,4.46405611956265
36140,"Ocean City, NJ",2011,317,135,452,96490,4.68442325629599
36140,"Ocean City, NJ",2012,332,159,491,96230,5.10235893172607
36140,"Ocean City, NJ",2013,468,190,658,95506,6.88961950034553
36140,"Ocean City, NJ",2014,447,191,638,94923,6.72123721332027
36140,"Ocean City, NJ",2015,453,161,614,94180,6.51943087704396
36140,"Ocean City, NJ",2016,479,163,642,93679,6.8531901493397704
36140,"Ocean City, NJ",2017,542,267,809,93184,8.68174793956044
36140,"Ocean City, NJ",2018,449,194,643,92560,6.94684528954192
36220,"Odessa, TX",1990,45,0,45,118688,0.379145322189269
36220,"Odessa, TX",1991,61,0,61,120135,0.507762100969742
36220,"Odessa, TX",1992,113,0,113,121353,0.931167750282235
36220,"Odessa, TX",1993,103,2,105,121490,0.864268664087579
36220,"Odessa, TX",1994,102,4,106,121878,0.869722181197591
36220,"Odessa, TX",1995,101,2,103,121784,0.845759705708467
36220,"Odessa, TX",1996,71,0,71,122437,0.579890065911448
36220,"Odessa, TX",1997,124,2,126,122819,1.02589990148104
36220,"Odessa, TX",1998,147,0,147,124784,1.17803564559559
36220,"Odessa, TX",1999,101,0,101,123831,0.815627750724778
36220,"Odessa, TX",2000,104,134,238,120694,1.97192901055562
36220,"Odessa, TX",2001,99,2,101,120802,0.836078872866343
36220,"Odessa, TX",2002,128,72,200,122199,1.6366746045385001
36220,"Odessa, TX",2003,173,0,173,122739,1.40949494455715
36220,"Odessa, TX",2004,194,0,194,124163,1.5624622472073
36220,"Odessa, TX",2005,149,106,255,125378,2.03384963869259
36220,"Odessa, TX",2006,261,0,261,127476,2.04744422479526
36220,"Odessa, TX",2007,215,224,439,130459,3.36504189055565
36220,"Odessa, TX",2008,254,462,716,133064,5.38086935609932
36220,"Odessa, TX",2009,220,0,220,136930,1.60666033739867
36220,"Odessa, TX",2010,268,440,708,137083,5.16475420001021
36220,"Odessa, TX",2011,336,404,740,139645,5.29915141967131
36220,"Odessa, TX",2012,581,428,1009,144524,6.98153939830063
36220,"Odessa, TX",2013,718,572,1290,149714,8.6164286573066
36220,"Odessa, TX",2014,430,126,556,154674,3.59465714987651
36220,"Odessa, TX",2015,468,144,612,159933,3.82660238975071
36220,"Odessa, TX",2016,448,0,448,157805,2.83894680143215
36220,"Odessa, TX",2017,492,0,492,157173,3.13030864079708
36220,"Odessa, TX",2018,716,24,740,162124,4.56440749056278
36260,"Ogden-Clearfield, UT",1990,1416,68,1484,389715,3.8079109092542
36260,"Ogden-Clearfield, UT",1991,1598,42,1640,397928,4.12134858567379
36260,"Ogden-Clearfield, UT",1992,2282,148,2430,407818,5.95854032926453
36260,"Ogden-Clearfield, UT",1993,2705,198,2903,418506,6.93657916493431
36260,"Ogden-Clearfield, UT",1994,2927,400,3327,429135,7.75280506134433
36260,"Ogden-Clearfield, UT",1995,2949,709,3658,438392,8.34413036734247
36260,"Ogden-Clearfield, UT",1996,4041,603,4644,447909,10.368177464618901
36260,"Ogden-Clearfield, UT",1997,4104,1409,5513,457388,12.0532239586522
36260,"Ogden-Clearfield, UT",1998,3952,887,4839,466450,10.3741022617644
36260,"Ogden-Clearfield, UT",1999,4185,660,4845,474758,10.2051992804755
36260,"Ogden-Clearfield, UT",2000,3453,464,3917,487906,8.02818575709255
36260,"Ogden-Clearfield, UT",2001,3705,669,4374,495459,8.82817750812883
36260,"Ogden-Clearfield, UT",2002,3924,434,4358,504247,8.64258984188305
36260,"Ogden-Clearfield, UT",2003,4428,386,4814,513021,9.38363146927709
36260,"Ogden-Clearfield, UT",2004,4440,512,4952,522374,9.47979799913472
36260,"Ogden-Clearfield, UT",2005,5078,323,5401,532425,10.1441517584636
36260,"Ogden-Clearfield, UT",2006,4947,447,5394,545746,9.88371879958809
36260,"Ogden-Clearfield, UT",2007,3325,545,3870,561767,6.8889771026066
36260,"Ogden-Clearfield, UT",2008,1676,576,2252,577040,3.90267572438652
36260,"Ogden-Clearfield, UT",2009,1622,150,1772,588773,3.00964887995883
36260,"Ogden-Clearfield, UT",2010,1556,217,1773,599737,2.95629584301119
36260,"Ogden-Clearfield, UT",2011,1368,714,2082,605555,3.43816829189752
36260,"Ogden-Clearfield, UT",2012,2037,896,2933,612205,4.79087887227318
36260,"Ogden-Clearfield, UT",2013,2308,566,2874,621281,4.62592611072928
36260,"Ogden-Clearfield, UT",2014,1990,688,2678,630873,4.24491141640235
36260,"Ogden-Clearfield, UT",2015,2319,801,3120,640517,4.87106509272978
36260,"Ogden-Clearfield, UT",2016,2376,1234,3610,652672,5.53110904098843
36260,"Ogden-Clearfield, UT",2017,2514,1020,3534,664589,5.31757221380432
36260,"Ogden-Clearfield, UT",2018,2816,856,3672,675067,5.43946008322137
36300,"Ogdensburg-Massena, NY",1990,239,64,303,112186,2.70087176653058
36300,"Ogdensburg-Massena, NY",1991,316,45,361,113193,3.18924315107825
36300,"Ogdensburg-Massena, NY",1992,275,42,317,114309,2.77318496356367
36300,"Ogdensburg-Massena, NY",1993,298,55,353,115240,3.0631725095453
36300,"Ogdensburg-Massena, NY",1994,287,52,339,114982,2.94828755805256
36300,"Ogdensburg-Massena, NY",1995,294,37,331,114920,2.88026453184824
36300,"Ogdensburg-Massena, NY",1996,205,6,211,114604,1.84112247391016
36300,"Ogdensburg-Massena, NY",1997,168,8,176,113693,1.54802846261423
36300,"Ogdensburg-Massena, NY",1998,216,28,244,113199,2.15549607328687
36300,"Ogdensburg-Massena, NY",1999,235,20,255,113257,2.25151646255861
36300,"Ogdensburg-Massena, NY",2000,228,14,242,111864,2.16334120002861
36300,"Ogdensburg-Massena, NY",2001,247,13,260,111497,2.33190130676162
36300,"Ogdensburg-Massena, NY",2002,238,10,248,111292,2.22837221004205
36300,"Ogdensburg-Massena, NY",2003,249,6,255,111329,2.29050831319782
36300,"Ogdensburg-Massena, NY",2004,258,2,260,111468,2.33250798435425
36300,"Ogdensburg-Massena, NY",2005,233,2,235,111606,2.10562156156479
36300,"Ogdensburg-Massena, NY",2006,243,4,247,111556,2.21413460504141
36300,"Ogdensburg-Massena, NY",2007,205,6,211,111586,1.89091821554675
36300,"Ogdensburg-Massena, NY",2008,156,15,171,111684,1.53110561942624
36300,"Ogdensburg-Massena, NY",2009,126,32,158,112169,1.40858882578966
36300,"Ogdensburg-Massena, NY",2010,155,21,176,111811,1.57408483959539
36300,"Ogdensburg-Massena, NY",2011,154,6,160,112268,1.42516122136317
36300,"Ogdensburg-Massena, NY",2012,215,0,215,112357,1.91354343743603
36300,"Ogdensburg-Massena, NY",2013,133,9,142,111928,1.26867271817597
36300,"Ogdensburg-Massena, NY",2014,151,21,172,111437,1.54347299370945
36300,"Ogdensburg-Massena, NY",2015,147,141,288,110331,2.61032710661555
36300,"Ogdensburg-Massena, NY",2016,137,68,205,109411,1.87366900951458
36300,"Ogdensburg-Massena, NY",2017,119,9,128,108562,1.17904975958438
36300,"Ogdensburg-Massena, NY",2018,142,7,149,108047,1.37902949642285
36340,"Oil City, PA",1990,65,4,69,59307,1.1634377054985101
36340,"Oil City, PA",1991,79,8,87,59427,1.46398101872886
36340,"Oil City, PA",1992,82,0,82,59289,1.38305587883081
36340,"Oil City, PA",1993,65,0,65,59061,1.10055705118437
36340,"Oil City, PA",1994,74,0,74,59009,1.25404599298412
36340,"Oil City, PA",1995,65,50,115,58917,1.95189843338934
36340,"Oil City, PA",1996,62,0,62,58519,1.05948495360481
36340,"Oil City, PA",1997,92,0,92,58140,1.58238734090127
36340,"Oil City, PA",1998,131,4,135,57786,2.33620600145364
36340,"Oil City, PA",1999,97,4,101,57420,1.75896900034831
36340,"Oil City, PA",2000,101,28,129,57405,2.24719101123596
36340,"Oil City, PA",2001,125,0,125,57091,2.18948695941567
36340,"Oil City, PA",2002,125,0,125,56789,2.20113050062512
36340,"Oil City, PA",2003,130,0,130,56590,2.29722565824351
36340,"Oil City, PA",2004,143,8,151,56196,2.68702398747242
36340,"Oil City, PA",2005,103,18,121,56016,2.16009711510997
36340,"Oil City, PA",2006,96,0,96,55761,1.72163339968795
36340,"Oil City, PA",2007,71,0,71,55510,1.27904882003243
36340,"Oil City, PA",2008,61,0,61,55315,1.10277501581849
36340,"Oil City, PA",2009,52,10,62,55087,1.12549240292628
36340,"Oil City, PA",2010,66,2,68,54976,1.23690337601863
36340,"Oil City, PA",2011,33,0,33,54682,0.603489265206101
36340,"Oil City, PA",2012,25,0,25,54192,0.461322704458223
36340,"Oil City, PA",2013,27,0,27,53817,0.501700206254529
36340,"Oil City, PA",2014,41,0,41,53354,0.768452224762904
36340,"Oil City, PA",2015,47,0,47,52956,0.887529269582295
36340,"Oil City, PA",2016,32,0,32,52480,0.609756097560976
36340,"Oil City, PA",2017,34,0,34,51823,0.656079347008085
36340,"Oil City, PA",2018,34,0,34,51266,0.663207583973784
36380,"Okeechobee, FL",1990,111,0,111,29755,3.73046546798857
36380,"Okeechobee, FL",1991,54,6,60,30377,1.97517858906409
36380,"Okeechobee, FL",1992,163,0,163,30432,5.3562039957939
36380,"Okeechobee, FL",1993,124,2,126,30742,4.09862728514736
36380,"Okeechobee, FL",1994,108,3,111,30482,3.641493340332
36380,"Okeechobee, FL",1995,79,4,83,30181,2.75007455021371
36380,"Okeechobee, FL",1996,139,4,143,30640,4.66710182767624
36380,"Okeechobee, FL",1997,129,0,129,31511,4.09380851131351
36380,"Okeechobee, FL",1998,127,2,129,31928,4.04034076672513
36380,"Okeechobee, FL",1999,143,0,143,32230,4.43686006825939
36380,"Okeechobee, FL",2000,128,3,131,35917,3.6472979369101
36380,"Okeechobee, FL",2001,119,3,122,36298,3.36106672543942
36380,"Okeechobee, FL",2002,138,3,141,36776,3.83402218838373
36380,"Okeechobee, FL",2003,157,14,171,37224,4.59381044487427
36380,"Okeechobee, FL",2004,182,3,185,38556,4.79821558252931
36380,"Okeechobee, FL",2005,181,0,181,39247,4.61181746375519
36380,"Okeechobee, FL",2006,202,0,202,39668,5.09226580619139
36380,"Okeechobee, FL",2007,275,41,316,39840,7.93172690763052
36380,"Okeechobee, FL",2008,177,0,177,39968,4.42854283426741
36380,"Okeechobee, FL",2009,39,0,39,39899,0.977468106970099
36380,"Okeechobee, FL",2010,38,10,48,40028,1.19916058758869
36380,"Okeechobee, FL",2011,42,0,42,39871,1.05339720598932
36380,"Okeechobee, FL",2012,22,0,22,39718,0.553905030464777
36380,"Okeechobee, FL",2013,35,0,35,39491,0.886277886100631
36380,"Okeechobee, FL",2014,17,0,17,39581,0.429499002046436
36380,"Okeechobee, FL",2015,69,0,69,39836,1.73210161662818
36380,"Okeechobee, FL",2016,41,0,41,40716,1.00697514490618
36380,"Okeechobee, FL",2017,43,0,43,41188,1.0439933961348
36380,"Okeechobee, FL",2018,52,0,52,41537,1.25189590004093
36420,"Oklahoma City, OK",1990,2020,2,2022,971876,2.0805123287333
36420,"Oklahoma City, OK",1991,2643,30,2673,980722,2.72554301830692
36420,"Oklahoma City, OK",1992,3500,226,3726,992523,3.75406917522314
36420,"Oklahoma City, OK",1993,3931,28,3959,1006381,3.93389779815
36420,"Oklahoma City, OK",1994,3840,427,4267,1017958,4.19172500240678
36420,"Oklahoma City, OK",1995,3698,617,4315,1025219,4.20885683936798
36420,"Oklahoma City, OK",1996,4175,855,5030,1034965,4.86006773175905
36420,"Oklahoma City, OK",1997,3962,1565,5527,1045526,5.28633434271362
36420,"Oklahoma City, OK",1998,4645,2116,6761,1052563,6.42336848245663
36420,"Oklahoma City, OK",1999,5679,985,6664,1062684,6.27091402524175
36420,"Oklahoma City, OK",2000,4151,1239,5390,1098132,4.90833524567174
36420,"Oklahoma City, OK",2001,4719,1249,5968,1108860,5.38210414299371
36420,"Oklahoma City, OK",2002,5856,496,6352,1122241,5.66010331114262
36420,"Oklahoma City, OK",2003,6923,1159,8082,1134419,7.12435176068102
36420,"Oklahoma City, OK",2004,7767,1564,9331,1145524,8.14561720225853
36420,"Oklahoma City, OK",2005,8201,848,9049,1161308,7.79207583173456
36420,"Oklahoma City, OK",2006,6975,458,7433,1182668,6.28494218157589
36420,"Oklahoma City, OK",2007,5491,784,6275,1199665,5.23062688333827
36420,"Oklahoma City, OK",2008,3742,357,4099,1216645,3.36910109358112
36420,"Oklahoma City, OK",2009,3119,333,3452,1237780,2.78886393381699
36420,"Oklahoma City, OK",2010,3032,603,3635,1257797,2.88997350128836
36420,"Oklahoma City, OK",2011,3079,182,3261,1277284,2.55307355294516
36420,"Oklahoma City, OK",2012,5474,1103,6577,1298476,5.06516870546702
36420,"Oklahoma City, OK",2013,6359,1146,7505,1320817,5.6820891917654
36420,"Oklahoma City, OK",2014,5959,1911,7870,1336940,5.88657680972968
36420,"Oklahoma City, OK",2015,5518,486,6004,1358012,4.42116859055737
36420,"Oklahoma City, OK",2016,5039,1701,6740,1374153,4.90483956298898
36420,"Oklahoma City, OK",2017,5132,287,5419,1383249,3.91758822887275
36420,"Oklahoma City, OK",2018,5430,300,5730,1396445,4.10327653434256
36460,"Olean, NY",1990,247,29,276,84469,3.2674709064864
36460,"Olean, NY",1991,204,23,227,85032,2.66958321573055
36460,"Olean, NY",1992,171,11,182,85453,2.12982575216786
36460,"Olean, NY",1993,196,13,209,85708,2.43851215755822
36460,"Olean, NY",1994,224,94,318,85338,3.72635871475779
36460,"Olean, NY",1995,169,17,186,85339,2.17954276473828
36460,"Olean, NY",1996,134,48,182,85642,2.1251255225240002
36460,"Olean, NY",1997,158,67,225,85132,2.64295447070432
36460,"Olean, NY",1998,192,14,206,84991,2.42378604793449
36460,"Olean, NY",1999,165,41,206,84579,2.43559275943201
36460,"Olean, NY",2000,147,15,162,83927,1.93024890678804
36460,"Olean, NY",2001,152,0,152,83346,1.82372279413529
36460,"Olean, NY",2002,167,16,183,83301,2.19685237872294
36460,"Olean, NY",2003,144,0,144,83335,1.72796544069119
36460,"Olean, NY",2004,191,12,203,82864,2.44979725815795
36460,"Olean, NY",2005,198,6,204,82039,2.486622216263
36460,"Olean, NY",2006,180,41,221,81342,2.71692360650095
36460,"Olean, NY",2007,171,8,179,81056,2.20834978286617
36460,"Olean, NY",2008,106,36,142,80761,1.75827441463082
36460,"Olean, NY",2009,87,0,87,80491,1.08086618379695
36460,"Olean, NY",2010,108,8,116,80230,1.44584320079771
36460,"Olean, NY",2011,85,0,85,79819,1.06490935742117
36460,"Olean, NY",2012,65,0,65,79354,0.819114348363032
36460,"Olean, NY",2013,77,15,92,79000,1.16455696202532
36460,"Olean, NY",2014,80,0,80,78685,1.01671220690093
36460,"Olean, NY",2015,73,4,77,77951,0.987800028222858
36460,"Olean, NY",2016,62,0,62,77708,0.797858650332012
36460,"Olean, NY",2017,80,8,88,77245,1.13923231277105
36460,"Olean, NY",2018,83,2,85,76840,1.10619469026549
36500,"Olympia-Tumwater, WA",1990,1766,856,2622,163023,16.0836201026849
36500,"Olympia-Tumwater, WA",1991,1529,202,1731,169432,10.2164880305963
36500,"Olympia-Tumwater, WA",1992,1721,243,1964,176489,11.128172294024
36500,"Olympia-Tumwater, WA",1993,1761,271,2032,183178,11.0930351898154
36500,"Olympia-Tumwater, WA",1994,1675,417,2092,187164,11.1773631681306
36500,"Olympia-Tumwater, WA",1995,2010,218,2228,192228,11.5904030630293
36500,"Olympia-Tumwater, WA",1996,1711,285,1996,196510,10.1572439061625
36500,"Olympia-Tumwater, WA",1997,1298,92,1390,199826,6.95605176503558
36500,"Olympia-Tumwater, WA",1998,1424,237,1661,202417,8.20583251406749
36500,"Olympia-Tumwater, WA",1999,1471,492,1963,205295,9.56185002070192
36500,"Olympia-Tumwater, WA",2000,1139,160,1299,208287,6.23658701695257
36500,"Olympia-Tumwater, WA",2001,1433,46,1479,212421,6.9625884446453
36500,"Olympia-Tumwater, WA",2002,1623,212,1835,216313,8.48307776231664
36500,"Olympia-Tumwater, WA",2003,1670,344,2014,219499,9.17544043480836
36500,"Olympia-Tumwater, WA",2004,2099,154,2253,222985,10.1038186425096
36500,"Olympia-Tumwater, WA",2005,2530,40,2570,227023,11.3204388982614
36500,"Olympia-Tumwater, WA",2006,2493,711,3204,232688,13.769511104999
36500,"Olympia-Tumwater, WA",2007,2027,576,2603,237772,10.9474622747842
36500,"Olympia-Tumwater, WA",2008,1212,149,1361,244332,5.57028960594601
36500,"Olympia-Tumwater, WA",2009,1083,234,1317,249936,5.26934895333205
36500,"Olympia-Tumwater, WA",2010,1053,103,1156,252996,4.56924220145773
36500,"Olympia-Tumwater, WA",2011,858,170,1028,256321,4.01059608849841
36500,"Olympia-Tumwater, WA",2012,959,53,1012,258489,3.91506021532831
36500,"Olympia-Tumwater, WA",2013,929,360,1289,261791,4.92377507248148
36500,"Olympia-Tumwater, WA",2014,934,69,1003,264975,3.7852627606378
36500,"Olympia-Tumwater, WA",2015,881,139,1020,268014,3.80577134030312
36500,"Olympia-Tumwater, WA",2016,1084,997,2081,273721,7.60263187698423
36500,"Olympia-Tumwater, WA",2017,950,117,1067,280289,3.80678513962375
36500,"Olympia-Tumwater, WA",2018,912,838,1750,286419,6.10992985800523
36540,"Omaha-Council Bluffs, NE-IA",1990,2291,1230,3521,687582,5.12084376845234
36540,"Omaha-Council Bluffs, NE-IA",1991,2647,504,3151,694770,4.53531384486952
36540,"Omaha-Council Bluffs, NE-IA",1992,2809,876,3685,701310,5.25445238197088
36540,"Omaha-Council Bluffs, NE-IA",1993,3044,1045,4089,703643,5.81118550173881
36540,"Omaha-Council Bluffs, NE-IA",1994,2859,615,3474,709308,4.8977313099528
36540,"Omaha-Council Bluffs, NE-IA",1995,2888,1323,4211,717661,5.8676728984855
36540,"Omaha-Council Bluffs, NE-IA",1996,3457,2310,5767,728249,7.91899473943665
36540,"Omaha-Council Bluffs, NE-IA",1997,3319,2360,5679,736221,7.71371639765777
36540,"Omaha-Council Bluffs, NE-IA",1998,3579,2169,5748,742269,7.74382333089486
36540,"Omaha-Council Bluffs, NE-IA",1999,4202,1198,5400,748546,7.21398551324835
36540,"Omaha-Council Bluffs, NE-IA",2000,3926,1999,5925,769291,7.70189694146948
36540,"Omaha-Council Bluffs, NE-IA",2001,4068,1032,5100,776165,6.5707678135448
36540,"Omaha-Council Bluffs, NE-IA",2002,4590,1329,5919,783567,7.55391689542821
36540,"Omaha-Council Bluffs, NE-IA",2003,5385,985,6370,792086,8.04205603936946
36540,"Omaha-Council Bluffs, NE-IA",2004,5559,841,6400,803214,7.96798860577629
36540,"Omaha-Council Bluffs, NE-IA",2005,5877,754,6631,814309,8.1431004692322
36540,"Omaha-Council Bluffs, NE-IA",2006,4199,1267,5466,824961,6.625767763567
36540,"Omaha-Council Bluffs, NE-IA",2007,3857,1191,5048,834554,6.04873980593227
36540,"Omaha-Council Bluffs, NE-IA",2008,3151,1370,4521,845119,5.34954249046584
36540,"Omaha-Council Bluffs, NE-IA",2009,3081,383,3464,856233,4.04562776720823
36540,"Omaha-Council Bluffs, NE-IA",2010,2305,918,3223,867673,3.71453300955544
36540,"Omaha-Council Bluffs, NE-IA",2011,2156,977,3133,875954,3.57667183436573
36540,"Omaha-Council Bluffs, NE-IA",2012,2479,983,3462,884563,3.91379698223869
36540,"Omaha-Council Bluffs, NE-IA",2013,3039,1425,4464,893935,4.99365166371157
36540,"Omaha-Council Bluffs, NE-IA",2014,2639,1553,4192,903462,4.63992951557453
36540,"Omaha-Council Bluffs, NE-IA",2015,2973,1184,4157,913201,4.55211941292224
36540,"Omaha-Council Bluffs, NE-IA",2016,2906,1334,4240,923386,4.59179584702389
36540,"Omaha-Council Bluffs, NE-IA",2017,3158,1797,4955,932217,5.31528603318755
36540,"Omaha-Council Bluffs, NE-IA",2018,2791,1997,4788,942198,5.08173441251202
36580,"Oneonta, NY",1990,203,96,299,60494,4.94263893939895
36580,"Oneonta, NY",1991,145,40,185,60610,3.05230160039597
36580,"Oneonta, NY",1992,310,37,347,60979,5.69048360911133
36580,"Oneonta, NY",1993,113,19,132,61224,2.15601724813799
36580,"Oneonta, NY",1994,146,289,435,61505,7.07259572392488
36580,"Oneonta, NY",1995,136,223,359,61167,5.86917782464401
36580,"Oneonta, NY",1996,132,290,422,60986,6.91962089659922
36580,"Oneonta, NY",1997,109,283,392,60681,6.46001219492098
36580,"Oneonta, NY",1998,137,384,521,60596,8.59792725592448
36580,"Oneonta, NY",1999,149,407,556,60750,9.1522633744856
36580,"Oneonta, NY",2000,141,436,577,61860,9.32751374070482
36580,"Oneonta, NY",2001,139,468,607,61924,9.80233835023577
36580,"Oneonta, NY",2002,161,528,689,62093,11.0962588375501
36580,"Oneonta, NY",2003,142,10,152,62567,2.42939568782265
36580,"Oneonta, NY",2004,158,10,168,62934,2.66946324721136
36580,"Oneonta, NY",2005,163,4,167,63069,2.64789357687612
36580,"Oneonta, NY",2006,14,2,16,63032,0.253839319710623
36580,"Oneonta, NY",2007,159,0,159,62914,2.52725943351241
36580,"Oneonta, NY",2008,106,0,106,62561,1.69434631799364
36580,"Oneonta, NY",2009,86,24,110,62280,1.76621708413616
36580,"Oneonta, NY",2010,62,0,62,62258,0.995855954254875
36580,"Oneonta, NY",2011,37,0,37,61964,0.597120908914854
36580,"Oneonta, NY",2012,47,15,62,61746,1.00411362679364
36580,"Oneonta, NY",2013,56,9,65,61614,1.0549550426851
36580,"Oneonta, NY",2014,40,141,181,60951,2.96959852996669
36580,"Oneonta, NY",2015,45,123,168,60497,2.77699720647305
36580,"Oneonta, NY",2016,49,48,97,60119,1.61346662452802
36580,"Oneonta, NY",2017,35,2,37,59903,0.617665225447807
36580,"Oneonta, NY",2018,49,4,53,59749,0.887044134629868
36620,"Ontario, OR-ID",1990,43,14,57,42534,1.34010438707857
36620,"Ontario, OR-ID",1991,69,29,98,43488,2.25349521707138
36620,"Ontario, OR-ID",1992,76,34,110,44635,2.4644337403383
36620,"Ontario, OR-ID",1993,112,32,144,45506,3.16441787896102
36620,"Ontario, OR-ID",1994,175,98,273,46470,5.87475790832795
36620,"Ontario, OR-ID",1995,151,59,210,47412,4.42925841559099
36620,"Ontario, OR-ID",1996,158,73,231,48078,4.8046923748908
36620,"Ontario, OR-ID",1997,179,63,242,48551,4.98444934192911
36620,"Ontario, OR-ID",1998,179,4,183,49034,3.73210425419097
36620,"Ontario, OR-ID",1999,175,52,227,49415,4.59374683800465
36620,"Ontario, OR-ID",2000,161,7,168,52164,3.22061191626409
36620,"Ontario, OR-ID",2001,130,24,154,52328,2.94297508026296
36620,"Ontario, OR-ID",2002,165,37,202,52421,3.85341752351157
36620,"Ontario, OR-ID",2003,158,28,186,52468,3.54501791568194
36620,"Ontario, OR-ID",2004,166,3,169,52389,3.22586802573059
36620,"Ontario, OR-ID",2005,196,0,196,52757,3.7151468051633
36620,"Ontario, OR-ID",2006,270,6,276,53219,5.18611773990492
36620,"Ontario, OR-ID",2007,184,0,184,53871,3.41556681702586
36620,"Ontario, OR-ID",2008,66,2,68,53929,1.26091713178438
36620,"Ontario, OR-ID",2009,54,0,54,53930,1.00129797886149
36620,"Ontario, OR-ID",2010,53,0,53,53987,0.981717820956897
36620,"Ontario, OR-ID",2011,45,0,45,53514,0.840901446350488
36620,"Ontario, OR-ID",2012,69,4,73,53440,1.36601796407186
36620,"Ontario, OR-ID",2013,95,53,148,53197,2.78211177322029
36620,"Ontario, OR-ID",2014,89,50,139,53119,2.61676612888044
36620,"Ontario, OR-ID",2015,73,2,75,53030,1.41429379596455
36620,"Ontario, OR-ID",2016,111,4,115,53268,2.15889464594128
36620,"Ontario, OR-ID",2017,125,6,131,53668,2.44093314451815
36620,"Ontario, OR-ID",2018,99,2,101,54276,1.8608593116663
36660,"Opelousas, LA",1990,14,0,14,80128,0.174720447284345
36660,"Opelousas, LA",1991,117,0,117,80543,1.4526402046112
36660,"Opelousas, LA",1992,166,64,230,80970,2.84055823144374
36660,"Opelousas, LA",1993,172,42,214,81634,2.62145674596369
36660,"Opelousas, LA",1994,159,32,191,81716,2.3373635518136
36660,"Opelousas, LA",1995,179,0,179,82502,2.16964437225764
36660,"Opelousas, LA",1996,185,33,218,82793,2.63307284432259
36660,"Opelousas, LA",1997,217,0,217,83313,2.60463553106958
36660,"Opelousas, LA",1998,239,3,242,83799,2.88786262365899
36660,"Opelousas, LA",1999,239,0,239,84444,2.83027805409502
36660,"Opelousas, LA",2000,233,4,237,87420,2.71105010295127
36660,"Opelousas, LA",2001,208,4,212,86416,2.45324939825958
36660,"Opelousas, LA",2002,267,104,371,85713,4.32839825930722
36660,"Opelousas, LA",2003,288,43,331,85034,3.8925606228097
36660,"Opelousas, LA",2004,301,49,350,84487,4.14264916496029
36660,"Opelousas, LA",2005,304,59,363,83952,4.32389937106918
36660,"Opelousas, LA",2006,422,57,479,85128,5.62682078751997
36660,"Opelousas, LA",2007,258,51,309,84710,3.64773934600401
36660,"Opelousas, LA",2008,179,47,226,84427,2.6768687742073
36660,"Opelousas, LA",2009,145,0,145,83825,1.72979421413659
36660,"Opelousas, LA",2010,139,0,139,83489,1.66488998550707
36660,"Opelousas, LA",2011,143,0,143,83432,1.71397065874005
36660,"Opelousas, LA",2012,120,0,120,83459,1.43783174972142
36660,"Opelousas, LA",2013,138,0,138,83410,1.65447788035008
36660,"Opelousas, LA",2014,144,0,144,83674,1.72096469632144
36660,"Opelousas, LA",2015,146,0,146,83628,1.7458267565887
36660,"Opelousas, LA",2016,118,0,118,83731,1.40927493998639
36660,"Opelousas, LA",2017,121,0,121,83447,1.45002216976045
36660,"Opelousas, LA",2018,121,0,121,82764,1.46198830409357
36700,"Orangeburg, SC",1990,287,26,313,84953,3.68439019222394
36700,"Orangeburg, SC",1991,251,42,293,86197,3.39919022703806
36700,"Orangeburg, SC",1992,253,28,281,86929,3.23252309355911
36700,"Orangeburg, SC",1993,226,94,320,87540,3.65547178432716
36700,"Orangeburg, SC",1994,209,52,261,87825,2.97181895815542
36700,"Orangeburg, SC",1995,140,56,196,87383,2.24299921037273
36700,"Orangeburg, SC",1996,153,76,229,87323,2.62244769419282
36700,"Orangeburg, SC",1997,178,50,228,87584,2.60321519912313
36700,"Orangeburg, SC",1998,175,68,243,87684,2.77131517722732
36700,"Orangeburg, SC",1999,166,42,208,87531,2.37630096765717
36700,"Orangeburg, SC",2000,197,37,234,91524,2.5567064376557
36700,"Orangeburg, SC",2001,212,173,385,91536,4.20599545533998
36700,"Orangeburg, SC",2002,266,128,394,91676,4.29774422967843
36700,"Orangeburg, SC",2003,260,3,263,91788,2.86529829607356
36700,"Orangeburg, SC",2004,287,78,365,91691,3.98076147059144
36700,"Orangeburg, SC",2005,262,19,281,92197,3.04782151263056
36700,"Orangeburg, SC",2006,274,76,350,91761,3.81425660138839
36700,"Orangeburg, SC",2007,228,54,282,92626,3.04450154384298
36700,"Orangeburg, SC",2008,113,121,234,92886,2.51921710483819
36700,"Orangeburg, SC",2009,69,118,187,92755,2.01606382405261
36700,"Orangeburg, SC",2010,79,0,79,92320,0.855719237435009
36700,"Orangeburg, SC",2011,57,23,80,91685,0.872552762174838
36700,"Orangeburg, SC",2012,71,3,74,91455,0.80914110764857
36700,"Orangeburg, SC",2013,85,13,98,90667,1.08087837912361
36700,"Orangeburg, SC",2014,41,0,41,90041,0.455348119190147
36700,"Orangeburg, SC",2015,41,48,89,89170,0.998093529213861
36700,"Orangeburg, SC",2016,48,0,48,88451,0.542673344563657
36700,"Orangeburg, SC",2017,53,0,53,87673,0.604519065162593
36700,"Orangeburg, SC",2018,59,0,59,86934,0.67867577702625
36740,"Orlando-Kissimmee-Sanford, FL",1990,13417,7619,21036,1239104,16.976783224007
36740,"Orlando-Kissimmee-Sanford, FL",1991,10889,4415,15304,1274918,12.0039092710276
36740,"Orlando-Kissimmee-Sanford, FL",1992,11930,2412,14342,1303423,11.003335064672
36740,"Orlando-Kissimmee-Sanford, FL",1993,12516,4121,16637,1334152,12.4700933626753
36740,"Orlando-Kissimmee-Sanford, FL",1994,12354,4300,16654,1363623,12.2130530212529
36740,"Orlando-Kissimmee-Sanford, FL",1995,10982,5032,16014,1389741,11.5230104026578
36740,"Orlando-Kissimmee-Sanford, FL",1996,12395,3689,16084,1422352,11.3080306422039
36740,"Orlando-Kissimmee-Sanford, FL",1997,13696,7695,21391,1463552,14.615811395837
36740,"Orlando-Kissimmee-Sanford, FL",1998,15024,10734,25758,1501622,17.1534514012181
36740,"Orlando-Kissimmee-Sanford, FL",1999,16368,13225,29593,1532009,19.3164661565304
36740,"Orlando-Kissimmee-Sanford, FL",2000,15400,9524,24924,1656890,15.0426401269849
36740,"Orlando-Kissimmee-Sanford, FL",2001,16700,6619,23319,1710359,13.6339797668209
36740,"Orlando-Kissimmee-Sanford, FL",2002,17306,8902,26208,1760345,14.8879907063672
36740,"Orlando-Kissimmee-Sanford, FL",2003,22345,5888,28233,1811544,15.5850478928472
36740,"Orlando-Kissimmee-Sanford, FL",2004,27493,6499,33992,1878077,18.099364403057
36740,"Orlando-Kissimmee-Sanford, FL",2005,26753,9384,36137,1955794,18.4768948058947
36740,"Orlando-Kissimmee-Sanford, FL",2006,23646,7338,30984,2020057,15.3381810513268
36740,"Orlando-Kissimmee-Sanford, FL",2007,11805,6833,18638,2057865,9.0569595187245
36740,"Orlando-Kissimmee-Sanford, FL",2008,5280,4953,10233,2087489,4.90206175936735
36740,"Orlando-Kissimmee-Sanford, FL",2009,3707,780,4487,2111917,2.12461001071538
36740,"Orlando-Kissimmee-Sanford, FL",2010,4221,1033,5254,2139199,2.45605948768675
36740,"Orlando-Kissimmee-Sanford, FL",2011,4533,1972,6505,2175958,2.98948784857061
36740,"Orlando-Kissimmee-Sanford, FL",2012,7322,4684,12006,2225779,5.3940665268205
36740,"Orlando-Kissimmee-Sanford, FL",2013,9222,6341,15563,2270479,6.85450074631829
36740,"Orlando-Kissimmee-Sanford, FL",2014,9806,6309,16115,2324886,6.93152266390696
36740,"Orlando-Kissimmee-Sanford, FL",2015,12038,8436,20474,2387554,8.57530342769211
36740,"Orlando-Kissimmee-Sanford, FL",2016,14227,9027,23254,2452986,9.47987473226508
36740,"Orlando-Kissimmee-Sanford, FL",2017,14431,4634,19065,2512917,7.58680051907803
36740,"Orlando-Kissimmee-Sanford, FL",2018,16455,12427,28882,2572962,11.2251949309784
36780,"Oshkosh-Neenah, WI",1990,494,547,1041,140756,7.39577708943136
36780,"Oshkosh-Neenah, WI",1991,602,282,884,142677,6.19581292009224
36780,"Oshkosh-Neenah, WI",1992,812,526,1338,144378,9.26733989943066
36780,"Oshkosh-Neenah, WI",1993,749,447,1196,146460,8.16605216441349
36780,"Oshkosh-Neenah, WI",1994,692,524,1216,146806,8.28304020271651
36780,"Oshkosh-Neenah, WI",1995,588,329,917,148153,6.18954729232618
36780,"Oshkosh-Neenah, WI",1996,709,447,1156,149121,7.7520939371383
36780,"Oshkosh-Neenah, WI",1997,563,499,1062,149924,7.08358901843601
36780,"Oshkosh-Neenah, WI",1998,657,444,1101,150332,7.32379001144134
36780,"Oshkosh-Neenah, WI",1999,632,376,1008,151161,6.66838668704229
36780,"Oshkosh-Neenah, WI",2000,566,245,811,157103,5.16221841721673
36780,"Oshkosh-Neenah, WI",2001,711,590,1301,158163,8.22569121728849
36780,"Oshkosh-Neenah, WI",2002,720,655,1375,159134,8.64051679716465
36780,"Oshkosh-Neenah, WI",2003,976,484,1460,159440,9.15704967385851
36780,"Oshkosh-Neenah, WI",2004,896,218,1114,160130,6.9568475613564
36780,"Oshkosh-Neenah, WI",2005,603,174,777,161451,4.81260568221937
36780,"Oshkosh-Neenah, WI",2006,469,347,816,162727,5.01453354391097
36780,"Oshkosh-Neenah, WI",2007,441,118,559,164037,3.40776775971275
36780,"Oshkosh-Neenah, WI",2008,414,224,638,164910,3.86877690861682
36780,"Oshkosh-Neenah, WI",2009,263,138,401,166429,2.40943585552999
36780,"Oshkosh-Neenah, WI",2010,257,102,359,167069,2.14881276598292
36780,"Oshkosh-Neenah, WI",2011,200,185,385,167473,2.29887802810005
36780,"Oshkosh-Neenah, WI",2012,231,42,273,168507,1.6201107372394
36780,"Oshkosh-Neenah, WI",2013,305,82,387,169279,2.28616662433025
36780,"Oshkosh-Neenah, WI",2014,267,244,511,169330,3.01777594047127
36780,"Oshkosh-Neenah, WI",2015,303,407,710,169270,4.19448218822
36780,"Oshkosh-Neenah, WI",2016,322,89,411,169637,2.42282049317071
36780,"Oshkosh-Neenah, WI",2017,327,222,549,170375,3.22230374174615
36780,"Oshkosh-Neenah, WI",2018,275,103,378,171020,2.2102678049351
36820,"Oskaloosa, IA",1990,21,0,21,21553,0.974342318934719
36820,"Oskaloosa, IA",1991,29,0,29,21464,1.35109951546776
36820,"Oskaloosa, IA",1992,30,0,30,21518,1.39418161539176
36820,"Oskaloosa, IA",1993,33,28,61,21660,2.81625115420129
36820,"Oskaloosa, IA",1994,20,23,43,21727,1.97910434022184
36820,"Oskaloosa, IA",1995,22,26,48,21831,2.1987082588979
36820,"Oskaloosa, IA",1996,32,4,36,21765,1.65403170227429
36820,"Oskaloosa, IA",1997,26,26,52,21817,2.3834624375487
36820,"Oskaloosa, IA",1998,22,92,114,21913,5.20239127458586
36820,"Oskaloosa, IA",1999,29,62,91,22002,4.1359876374875
36820,"Oskaloosa, IA",2000,30,2,32,22299,1.4350419301314
36820,"Oskaloosa, IA",2001,35,8,43,22407,1.91904315615656
36820,"Oskaloosa, IA",2002,31,2,33,22394,1.47360900241136
36820,"Oskaloosa, IA",2003,11,36,47,22156,2.12132153818379
36820,"Oskaloosa, IA",2004,27,0,27,22240,1.21402877697842
36820,"Oskaloosa, IA",2005,32,4,36,22454,1.6032778124165
36820,"Oskaloosa, IA",2006,24,4,28,22298,1.25571800161449
36820,"Oskaloosa, IA",2007,19,0,19,22388,0.848668929783813
36820,"Oskaloosa, IA",2008,20,0,20,22483,0.889561001645688
36820,"Oskaloosa, IA",2009,20,0,20,22364,0.894294401717045
36820,"Oskaloosa, IA",2010,10,0,10,22408,0.446269189575152
36820,"Oskaloosa, IA",2011,9,6,15,22498,0.666725931193884
36820,"Oskaloosa, IA",2012,11,4,15,22399,0.669672753247913
36820,"Oskaloosa, IA",2013,10,2,12,22422,0.535188654000535
36820,"Oskaloosa, IA",2014,10,54,64,22365,2.86161412921976
36820,"Oskaloosa, IA",2015,15,6,21,22308,0.941366325981711
36820,"Oskaloosa, IA",2016,18,16,34,22172,1.53346563232906
36820,"Oskaloosa, IA",2017,14,0,14,22197,0.630715862503942
36820,"Oskaloosa, IA",2018,8,16,24,22000,1.09090909090909
36830,"Othello, WA",1990,11,0,11,13614,0.807991773174673
36830,"Othello, WA",1991,10,0,10,13985,0.715051841258491
36830,"Othello, WA",1992,27,0,27,14264,1.89287717330342
36830,"Othello, WA",1993,43,3,46,14618,3.14680530852374
36830,"Othello, WA",1994,41,21,62,15217,4.07439048432674
36830,"Othello, WA",1995,17,38,55,15181,3.62294973980634
36830,"Othello, WA",1996,18,8,26,15225,1.70771756978654
36830,"Othello, WA",1997,10,42,52,15300,3.39869281045752
36830,"Othello, WA",1998,21,3,24,15345,1.56402737047898
36830,"Othello, WA",1999,15,0,15,15287,0.981225878197161
36830,"Othello, WA",2000,27,0,27,16458,1.6405395552315
36830,"Othello, WA",2001,31,0,31,16259,1.9066363244972
36830,"Othello, WA",2002,30,24,54,16445,3.28367284889024
36830,"Othello, WA",2003,57,0,57,16612,3.43125451480857
36830,"Othello, WA",2004,27,0,27,16664,1.62025924147864
36830,"Othello, WA",2005,32,5,37,16918,2.18701974228632
36830,"Othello, WA",2006,29,0,29,16997,1.7061834441372
36830,"Othello, WA",2007,52,0,52,17413,2.98627462240855
36830,"Othello, WA",2008,34,2,36,17782,2.02451917669553
36830,"Othello, WA",2009,57,12,69,18405,3.74898125509372
36830,"Othello, WA",2010,33,0,33,18789,1.75634679865879
36830,"Othello, WA",2011,22,2,24,18879,1.27125377403464
36830,"Othello, WA",2012,26,3,29,18952,1.53018151118615
36830,"Othello, WA",2013,44,10,54,19115,2.82500653936699
36830,"Othello, WA",2014,46,4,50,19200,2.60416666666667
36830,"Othello, WA",2015,75,88,163,19244,8.47017252130534
36830,"Othello, WA",2016,28,3,31,19378,1.59975229641862
36830,"Othello, WA",2017,23,8,31,19681,1.57512321528378
36830,"Othello, WA",2018,47,0,47,19759,2.37866288779797
36840,"Ottawa, KS",1990,17,26,43,22058,1.94940611116148
36840,"Ottawa, KS",1991,33,55,88,22216,3.96110911055095
36840,"Ottawa, KS",1992,61,0,61,22515,2.70930490783922
36840,"Ottawa, KS",1993,76,0,76,23134,3.28520791908014
36840,"Ottawa, KS",1994,84,56,140,23449,5.97040385517506
36840,"Ottawa, KS",1995,82,66,148,23778,6.22424089494491
36840,"Ottawa, KS",1996,149,14,163,24267,6.71694070136399
36840,"Ottawa, KS",1997,74,0,74,24544,3.01499348109518
36840,"Ottawa, KS",1998,72,8,80,24864,3.21750321750322
36840,"Ottawa, KS",1999,120,32,152,25134,6.04758494469643
36840,"Ottawa, KS",2000,139,10,149,24869,5.99139490932486
36840,"Ottawa, KS",2001,105,30,135,25000,5.4
36840,"Ottawa, KS",2002,97,28,125,25218,4.95677690538504
36840,"Ottawa, KS",2003,153,48,201,25312,7.94089759797724
36840,"Ottawa, KS",2004,114,26,140,25525,5.48481880509305
36840,"Ottawa, KS",2005,155,66,221,25527,8.65749990206448
36840,"Ottawa, KS",2006,122,8,130,25716,5.05521854098616
36840,"Ottawa, KS",2007,103,2,105,25734,4.08020517603171
36840,"Ottawa, KS",2008,54,2,56,25851,2.16626049282426
36840,"Ottawa, KS",2009,34,7,41,25870,1.58484731349053
36840,"Ottawa, KS",2010,30,3,33,25984,1.27001231527094
36840,"Ottawa, KS",2011,25,0,25,25850,0.967117988394584
36840,"Ottawa, KS",2012,25,0,25,25821,0.968204174896402
36840,"Ottawa, KS",2013,28,0,28,25730,1.08822386319471
36840,"Ottawa, KS",2014,27,4,31,25528,1.21435286743967
36840,"Ottawa, KS",2015,21,0,21,25469,0.824531783737092
36840,"Ottawa, KS",2016,23,0,23,25530,0.900900900900901
36840,"Ottawa, KS",2017,34,4,38,25657,1.48107728884905
36840,"Ottawa, KS",2018,49,36,85,25631,3.31629667199875
36860,"Ottawa-Peru, IL",1990,57,0,57,41419,1.37618001400324
36860,"Ottawa-Peru, IL",1991,79,30,109,41444,2.63005501399479
36860,"Ottawa-Peru, IL",1992,90,6,96,41440,2.31660231660232
36860,"Ottawa-Peru, IL",1993,118,28,146,41687,3.50229088204956
36860,"Ottawa-Peru, IL",1994,106,10,116,41730,2.77977474239156
36860,"Ottawa-Peru, IL",1995,117,24,141,41635,3.38657379608502
36860,"Ottawa-Peru, IL",1996,112,14,126,41405,3.04311073541843
36860,"Ottawa-Peru, IL",1997,118,9,127,41523,3.05854586614647
36860,"Ottawa-Peru, IL",1998,101,37,138,41243,3.34602235530878
36860,"Ottawa-Peru, IL",1999,91,8,99,41192,2.40337929695086
36860,"Ottawa-Peru, IL",2000,97,42,139,41521,3.34770357168662
36860,"Ottawa-Peru, IL",2001,97,2,99,41233,2.4009894987025
36860,"Ottawa-Peru, IL",2002,92,0,92,41118,2.23746291162021
36860,"Ottawa-Peru, IL",2003,102,2,104,41154,2.52709335666035
36860,"Ottawa-Peru, IL",2004,104,0,104,40966,2.53869062149099
36860,"Ottawa-Peru, IL",2005,116,2,118,40954,2.8812814377106
36860,"Ottawa-Peru, IL",2006,98,2,100,41114,2.43226151675828
36860,"Ottawa-Peru, IL",2007,71,50,121,41140,2.94117647058824
36860,"Ottawa-Peru, IL",2008,71,7,78,41067,1.89933523266857
36860,"Ottawa-Peru, IL",2009,52,6,58,41055,1.41273900864694
36860,"Ottawa-Peru, IL",2010,39,3,42,40971,1.02511532547412
36860,"Ottawa-Peru, IL",2011,36,0,36,40598,0.886743189319671
36860,"Ottawa-Peru, IL",2012,31,0,31,40255,0.770090671966215
36860,"Ottawa-Peru, IL",2013,36,2,38,39967,0.95078439712763
36860,"Ottawa-Peru, IL",2014,28,0,28,39693,0.705414052855667
36860,"Ottawa-Peru, IL",2015,27,40,67,39218,1.70839920444694
36860,"Ottawa-Peru, IL",2016,36,0,36,39105,0.920598388952819
36860,"Ottawa-Peru, IL",2017,35,0,35,38886,0.900066862109757
36860,"Ottawa-Peru, IL",2018,36,0,36,38733,0.929440012392534
36900,"Ottumwa, IA",1990,29,2,31,44036,0.703969479516759
36900,"Ottumwa, IA",1991,54,8,62,44045,1.40765126575094
36900,"Ottumwa, IA",1992,51,4,55,44194,1.2445128297959
36900,"Ottumwa, IA",1993,49,2,51,44425,1.14800225098481
36900,"Ottumwa, IA",1994,67,30,97,44398,2.18478309833776
36900,"Ottumwa, IA",1995,70,61,131,44110,2.96984810700521
36900,"Ottumwa, IA",1996,49,55,104,44014,2.36288453673831
36900,"Ottumwa, IA",1997,43,8,51,43938,1.16072647821931
36900,"Ottumwa, IA",1998,44,6,50,43822,1.14097941673132
36900,"Ottumwa, IA",1999,65,0,65,43876,1.48144771629137
36900,"Ottumwa, IA",2000,61,0,61,44551,1.36921730151961
36900,"Ottumwa, IA",2001,55,14,69,44535,1.5493432132031
36900,"Ottumwa, IA",2002,53,49,102,44382,2.29822901176153
36900,"Ottumwa, IA",2003,80,23,103,44284,2.3258964863156
36900,"Ottumwa, IA",2004,67,16,83,44321,1.87270142821687
36900,"Ottumwa, IA",2005,56,80,136,44438,3.06044376434583
36900,"Ottumwa, IA",2006,59,64,123,44395,2.77058227277847
36900,"Ottumwa, IA",2007,51,2,53,44134,1.20088820410568
36900,"Ottumwa, IA",2008,31,24,55,44056,1.24841111312875
36900,"Ottumwa, IA",2009,25,0,25,44182,0.565841292834186
36900,"Ottumwa, IA",2010,29,0,29,44457,0.652315720808871
36900,"Ottumwa, IA",2011,15,0,15,44250,0.338983050847458
36900,"Ottumwa, IA",2012,17,6,23,44135,0.521128356179903
36900,"Ottumwa, IA",2013,23,14,37,44276,0.83566717860692
36900,"Ottumwa, IA",2014,24,2,26,44185,0.588434989249745
36900,"Ottumwa, IA",2015,28,0,28,44281,0.632325376572345
36900,"Ottumwa, IA",2016,23,0,23,44214,0.520197222599177
36900,"Ottumwa, IA",2017,26,56,82,44098,1.8594947616672
36900,"Ottumwa, IA",2018,24,0,24,44222,0.542716295056759
36940,"Owatonna, MN",1990,151,18,169,30826,5.4823849996756
36940,"Owatonna, MN",1991,149,0,149,30929,4.81748520805716
36940,"Owatonna, MN",1992,118,72,190,31164,6.0967783339751
36940,"Owatonna, MN",1993,125,2,127,31244,4.06478043784407
36940,"Owatonna, MN",1994,106,0,106,31295,3.38712254353731
36940,"Owatonna, MN",1995,130,0,130,31358,4.14567255564768
36940,"Owatonna, MN",1996,121,88,209,31339,6.66900666900667
36940,"Owatonna, MN",1997,142,40,182,31448,5.78733146781989
36940,"Owatonna, MN",1998,181,78,259,31730,8.16262212417271
36940,"Owatonna, MN",1999,183,4,187,32111,5.82354956245523
36940,"Owatonna, MN",2000,173,26,199,33793,5.88879353712307
36940,"Owatonna, MN",2001,188,0,188,34154,5.50447970955086
36940,"Owatonna, MN",2002,232,38,270,34318,7.86759135147736
36940,"Owatonna, MN",2003,254,100,354,34669,10.2108511927082
36940,"Owatonna, MN",2004,241,39,280,35090,7.97948133371331
36940,"Owatonna, MN",2005,195,59,254,35568,7.14125056230319
36940,"Owatonna, MN",2006,204,68,272,36040,7.54716981132075
36940,"Owatonna, MN",2007,111,11,122,36342,3.35699741346101
36940,"Owatonna, MN",2008,81,0,81,36558,2.21565731166913
36940,"Owatonna, MN",2009,38,0,38,36684,1.03587395049613
36940,"Owatonna, MN",2010,41,0,41,36496,1.12341078474353
36940,"Owatonna, MN",2011,25,40,65,36562,1.77780208960123
36940,"Owatonna, MN",2012,33,23,56,36307,1.54240229156912
36940,"Owatonna, MN",2013,32,12,44,36361,1.21008773136052
36940,"Owatonna, MN",2014,45,4,49,36481,1.34316493517173
36940,"Owatonna, MN",2015,33,36,69,36610,1.88473094782846
36940,"Owatonna, MN",2016,65,0,65,36662,1.77295292128089
36940,"Owatonna, MN",2017,65,70,135,36824,3.66608733434717
36940,"Owatonna, MN",2018,68,93,161,36803,4.37464337146428
36980,"Owensboro, KY",1990,262,60,322,104736,3.07439657806294
36980,"Owensboro, KY",1991,266,55,321,105291,3.04869362053737
36980,"Owensboro, KY",1992,331,30,361,106190,3.39956681420096
36980,"Owensboro, KY",1993,362,30,392,106899,3.66701278777163
36980,"Owensboro, KY",1994,371,94,465,107876,4.31050465349105
36980,"Owensboro, KY",1995,382,164,546,108665,5.02461694197764
36980,"Owensboro, KY",1996,400,38,438,109095,4.01484944314588
36980,"Owensboro, KY",1997,391,122,513,109466,4.68638664060073
36980,"Owensboro, KY",1998,427,137,564,109781,5.13750102476749
36980,"Owensboro, KY",1999,500,208,708,110329,6.41717046288827
36980,"Owensboro, KY",2000,711,128,839,110064,7.62283762174735
36980,"Owensboro, KY",2001,720,40,760,109991,6.90965624460183
36980,"Owensboro, KY",2002,1056,38,1094,110190,9.92830565387059
36980,"Owensboro, KY",2003,528,75,603,110735,5.44543278999413
36980,"Owensboro, KY",2004,393,22,415,110999,3.73877242137317
36980,"Owensboro, KY",2005,409,48,457,111469,4.09979456171671
36980,"Owensboro, KY",2006,325,26,351,112152,3.12968114701477
36980,"Owensboro, KY",2007,300,132,432,112900,3.82639503985828
36980,"Owensboro, KY",2008,214,94,308,113651,2.71005094543823
36980,"Owensboro, KY",2009,245,4,249,114385,2.1768588538707
36980,"Owensboro, KY",2010,276,62,338,114772,2.9449691562402
36980,"Owensboro, KY",2011,220,58,278,115280,2.41151977793199
36980,"Owensboro, KY",2012,256,8,264,116026,2.27535207625877
36980,"Owensboro, KY",2013,243,278,521,116433,4.47467642335077
36980,"Owensboro, KY",2014,257,66,323,116591,2.77036821023921
36980,"Owensboro, KY",2015,233,10,243,117565,2.06694169183005
36980,"Owensboro, KY",2016,239,138,377,118122,3.19161544843467
36980,"Owensboro, KY",2017,250,14,264,118543,2.22703997705474
36980,"Owensboro, KY",2018,231,27,258,119114,2.16599224272546
37020,"Owosso, MI",1990,184,2,186,69895,2.66113455898133
37020,"Owosso, MI",1991,217,6,223,70337,3.1704508295776
37020,"Owosso, MI",1992,222,12,234,70749,3.30746724335326
37020,"Owosso, MI",1993,236,13,249,71283,3.49311897647405
37020,"Owosso, MI",1994,280,2,282,71639,3.93640335571407
37020,"Owosso, MI",1995,263,2,265,71956,3.68280615931958
37020,"Owosso, MI",1996,276,2,278,72254,3.84753785257564
37020,"Owosso, MI",1997,231,50,281,72326,3.88518651660537
37020,"Owosso, MI",1998,255,66,321,72510,4.42697558957385
37020,"Owosso, MI",1999,239,32,271,72386,3.74381786533308
37020,"Owosso, MI",2000,281,61,342,71714,4.76894330256296
37020,"Owosso, MI",2001,266,18,284,72016,3.94356809597867
37020,"Owosso, MI",2002,163,24,187,72162,2.59139159114215
37020,"Owosso, MI",2003,209,48,257,72458,3.54688233183361
37020,"Owosso, MI",2004,218,2,220,73034,3.01229564312512
37020,"Owosso, MI",2005,207,0,207,72757,2.84508707065987
37020,"Owosso, MI",2006,123,2,125,72839,1.71611362045058
37020,"Owosso, MI",2007,81,0,81,72426,1.11838290116809
37020,"Owosso, MI",2008,44,11,55,71523,0.768983403939991
37020,"Owosso, MI",2009,31,0,31,70710,0.438410408711639
37020,"Owosso, MI",2010,29,0,29,70628,0.410602027524495
37020,"Owosso, MI",2011,26,0,26,69984,0.371513488797439
37020,"Owosso, MI",2012,19,0,19,69319,0.274095125434585
37020,"Owosso, MI",2013,23,0,23,68895,0.333841352783221
37020,"Owosso, MI",2014,18,0,18,68799,0.261631709763223
37020,"Owosso, MI",2015,27,0,27,68485,0.394246915382931
37020,"Owosso, MI",2016,40,0,40,68531,0.583677459835695
37020,"Owosso, MI",2017,46,0,46,68459,0.671935026804365
37020,"Owosso, MI",2018,65,4,69,68192,1.01184889723135
37060,"Oxford, MS",1990,86,120,206,31894,6.45889508998558
37060,"Oxford, MS",1991,109,74,183,32169,5.68870651869813
37060,"Oxford, MS",1992,152,18,170,32150,5.28771384136858
37060,"Oxford, MS",1993,45,144,189,32434,5.82721835111303
37060,"Oxford, MS",1994,41,0,41,32668,1.25505081425248
37060,"Oxford, MS",1995,35,76,111,33099,3.35357563672619
37060,"Oxford, MS",1996,72,6,78,33874,2.30265100076755
37060,"Oxford, MS",1997,107,25,132,34464,3.83008356545961
37060,"Oxford, MS",1998,160,327,487,34764,14.0087446784029
37060,"Oxford, MS",1999,107,4,111,34860,3.184165232358
37060,"Oxford, MS",2000,81,178,259,38759,6.68231894527723
37060,"Oxford, MS",2001,68,144,212,39292,5.39550035630663
37060,"Oxford, MS",2002,60,66,126,39914,3.15678709224833
37060,"Oxford, MS",2003,91,316,407,41241,9.86881986372784
37060,"Oxford, MS",2004,143,6,149,41840,3.56118546845124
37060,"Oxford, MS",2005,310,0,310,42526,7.28965809152048
37060,"Oxford, MS",2006,193,44,237,44281,5.35218265170163
37060,"Oxford, MS",2007,239,24,263,45027,5.84093988051613
37060,"Oxford, MS",2008,235,117,352,45781,7.6887791878727
37060,"Oxford, MS",2009,49,4,53,46712,1.13461209111149
37060,"Oxford, MS",2010,82,0,82,47567,1.72388420543654
37060,"Oxford, MS",2011,85,98,183,48395,3.78138237421221
37060,"Oxford, MS",2012,358,45,403,50222,8.0243717892557
37060,"Oxford, MS",2013,139,466,605,51563,11.7332195566588
37060,"Oxford, MS",2014,195,276,471,52030,9.0524697290025
37060,"Oxford, MS",2015,238,434,672,52743,12.7410272453217
37060,"Oxford, MS",2016,256,154,410,53492,7.66469752486353
37060,"Oxford, MS",2017,360,309,669,54237,12.3347530283755
37060,"Oxford, MS",2018,159,101,260,54793,4.74513167740405
37080,"Oxford, NC",1990,96,6,102,38398,2.65638835356008
37080,"Oxford, NC",1991,109,62,171,38565,4.4340723453909
37080,"Oxford, NC",1992,119,11,130,39154,3.32022271032334
37080,"Oxford, NC",1993,184,16,200,39779,5.02777847608034
37080,"Oxford, NC",1994,189,14,203,39993,5.07588828044908
37080,"Oxford, NC",1995,190,20,210,40767,5.15122525572154
37080,"Oxford, NC",1996,225,10,235,41443,5.67043891610163
37080,"Oxford, NC",1997,268,92,360,42104,8.55025650769523
37080,"Oxford, NC",1998,306,52,358,43806,8.17239647536867
37080,"Oxford, NC",1999,342,124,466,44547,10.4608615619458
37080,"Oxford, NC",2000,392,22,414,48824,8.47943634278224
37080,"Oxford, NC",2001,406,154,560,50137,11.1693958553563
37080,"Oxford, NC",2002,358,10,368,51977,7.08005463955211
37080,"Oxford, NC",2003,433,14,447,52836,8.46014081308199
37080,"Oxford, NC",2004,398,254,652,53296,12.2335634944461
37080,"Oxford, NC",2005,626,39,665,54115,12.2886445532662
37080,"Oxford, NC",2006,520,42,562,55167,10.1872496238693
37080,"Oxford, NC",2007,522,12,534,57356,9.31027268289281
37080,"Oxford, NC",2008,292,50,342,58356,5.86057988895743
37080,"Oxford, NC",2009,202,8,210,59411,3.53469896147178
37080,"Oxford, NC",2010,194,8,202,57665,3.50299141593688
37080,"Oxford, NC",2011,142,0,142,57489,2.47003774635148
37080,"Oxford, NC",2012,167,0,167,57550,2.9018245004344
37080,"Oxford, NC",2013,214,0,214,57759,3.70505029519209
37080,"Oxford, NC",2014,224,0,224,57999,3.86213555406128
37080,"Oxford, NC",2015,259,0,259,58182,4.45154858891066
37080,"Oxford, NC",2016,350,0,350,58699,5.96262287262134
37080,"Oxford, NC",2017,270,12,282,59374,4.7495536766935
37080,"Oxford, NC",2018,251,2,253,60115,4.20860018298262
37100,"Oxnard-Thousand Oaks-Ventura, CA",1990,1368,1252,2620,670157,3.9095316470618098
37100,"Oxnard-Thousand Oaks-Ventura, CA",1991,1047,1147,2194,675904,3.24602310387274
37100,"Oxnard-Thousand Oaks-Ventura, CA",1992,1166,554,1720,684497,2.51279406629978
37100,"Oxnard-Thousand Oaks-Ventura, CA",1993,1166,206,1372,690464,1.98706956481439
37100,"Oxnard-Thousand Oaks-Ventura, CA",1994,1647,809,2456,699207,3.51255064666115
37100,"Oxnard-Thousand Oaks-Ventura, CA",1995,1935,207,2142,704362,3.04104991467456
37100,"Oxnard-Thousand Oaks-Ventura, CA",1996,2075,246,2321,711274,3.26315878269134
37100,"Oxnard-Thousand Oaks-Ventura, CA",1997,2097,232,2329,722371,3.22410506512581
37100,"Oxnard-Thousand Oaks-Ventura, CA",1998,2930,368,3298,732254,4.50390165161269
37100,"Oxnard-Thousand Oaks-Ventura, CA",1999,3636,782,4418,745056,5.92975561568526
37100,"Oxnard-Thousand Oaks-Ventura, CA",2000,2984,976,3960,756506,5.23459166219435
37100,"Oxnard-Thousand Oaks-Ventura, CA",2001,3168,285,3453,766689,4.50378184635491
37100,"Oxnard-Thousand Oaks-Ventura, CA",2002,2249,276,2525,779489,3.23930164505208
37100,"Oxnard-Thousand Oaks-Ventura, CA",2003,2278,1289,3567,788070,4.52624766835433
37100,"Oxnard-Thousand Oaks-Ventura, CA",2004,1719,898,2617,793994,3.29599468006055
37100,"Oxnard-Thousand Oaks-Ventura, CA",2005,2673,1838,4511,794197,5.67995094416121
37100,"Oxnard-Thousand Oaks-Ventura, CA",2006,1426,818,2244,798183,2.81138535899662
37100,"Oxnard-Thousand Oaks-Ventura, CA",2007,862,733,1595,800027,1.99368271320843
37100,"Oxnard-Thousand Oaks-Ventura, CA",2008,374,519,893,806353,1.10745541964871
37100,"Oxnard-Thousand Oaks-Ventura, CA",2009,204,148,352,815130,0.431832959159889
37100,"Oxnard-Thousand Oaks-Ventura, CA",2010,209,381,590,825130,0.715038842364234
37100,"Oxnard-Thousand Oaks-Ventura, CA",2011,281,287,568,830196,0.68417578499535
37100,"Oxnard-Thousand Oaks-Ventura, CA",2012,278,288,566,833801,0.678819046750963
37100,"Oxnard-Thousand Oaks-Ventura, CA",2013,430,571,1001,838601,1.19365467009937
37100,"Oxnard-Thousand Oaks-Ventura, CA",2014,536,778,1314,842946,1.55881871436604
37100,"Oxnard-Thousand Oaks-Ventura, CA",2015,678,755,1433,846922,1.69200941763232
37100,"Oxnard-Thousand Oaks-Ventura, CA",2016,669,940,1609,848921,1.8953471524441
37100,"Oxnard-Thousand Oaks-Ventura, CA",2017,1070,1495,2565,850802,3.01480250399035
37100,"Oxnard-Thousand Oaks-Ventura, CA",2018,625,579,1204,850967,1.41486097580752
37120,"Ozark, AL",1990,31,38,69,49598,1.3911851284326
37120,"Ozark, AL",1991,36,8,44,49822,0.883143992613705
37120,"Ozark, AL",1992,31,17,48,49810,0.963661915278057
37120,"Ozark, AL",1993,77,7,84,49677,1.6909233649375
37120,"Ozark, AL",1994,80,0,80,50381,1.5879002004724
37120,"Ozark, AL",1995,52,0,52,50251,1.03480527750692
37120,"Ozark, AL",1996,44,28,72,49475,1.45528044466902
37120,"Ozark, AL",1997,44,4,48,49115,0.977298177746106
37120,"Ozark, AL",1998,31,0,31,48914,0.633765384143599
37120,"Ozark, AL",1999,38,44,82,49032,1.67237722303802
37120,"Ozark, AL",2000,44,2,46,49124,0.936405830144125
37120,"Ozark, AL",2001,47,0,47,49254,0.954237219312137
37120,"Ozark, AL",2002,42,0,42,49373,0.850667368804812
37120,"Ozark, AL",2003,64,10,74,49215,1.50360662399675
37120,"Ozark, AL",2004,69,6,75,49245,1.52299725860493
37120,"Ozark, AL",2005,76,4,80,49050,1.63098878695209
37120,"Ozark, AL",2006,95,0,95,49077,1.93573364305072
37120,"Ozark, AL",2007,76,4,80,49488,1.61655350792111
37120,"Ozark, AL",2008,55,8,63,49871,1.2632592087586
37120,"Ozark, AL",2009,50,55,105,49854,2.106149957877
37120,"Ozark, AL",2010,54,82,136,50390,2.69894820400873
37120,"Ozark, AL",2011,26,0,26,50112,0.518837803320562
37120,"Ozark, AL",2012,71,0,71,50284,1.41197995386206
37120,"Ozark, AL",2013,18,0,18,49772,0.361649119987141
37120,"Ozark, AL",2014,17,0,17,49417,0.344011170245057
37120,"Ozark, AL",2015,11,0,11,49349,0.222902186467811
37120,"Ozark, AL",2016,23,0,23,49301,0.466521977241841
37120,"Ozark, AL",2017,20,0,20,49254,0.406058391196654
37120,"Ozark, AL",2018,24,0,24,48956,0.490236130402811
37140,"Paducah, KY-IL",1990,32,20,52,77808,0.668311741723216
37140,"Paducah, KY-IL",1991,110,16,126,78049,1.61437045958308
37140,"Paducah, KY-IL",1992,329,16,345,78664,4.38574188955558
37140,"Paducah, KY-IL",1993,359,57,416,79297,5.24610010466979
37140,"Paducah, KY-IL",1994,382,90,472,79854,5.91078718661557
37140,"Paducah, KY-IL",1995,338,107,445,79833,5.57413600891862
37140,"Paducah, KY-IL",1996,314,137,451,80038,5.63482345885704
37140,"Paducah, KY-IL",1997,248,42,290,80217,3.61519378685316
37140,"Paducah, KY-IL",1998,280,115,395,79958,4.94009354911328
37140,"Paducah, KY-IL",1999,221,55,276,79849,3.45652418940751
37140,"Paducah, KY-IL",2000,168,8,176,80559,2.18473416998721
37140,"Paducah, KY-IL",2001,146,26,172,79902,2.15263698030087
37140,"Paducah, KY-IL",2002,197,22,219,79794,2.74456726069629
37140,"Paducah, KY-IL",2003,194,26,220,79635,2.76260438249513
37140,"Paducah, KY-IL",2004,385,74,459,79714,5.75808515442708
37140,"Paducah, KY-IL",2005,332,36,368,79907,4.60535372370381
37140,"Paducah, KY-IL",2006,218,46,264,80075,3.29690914767406
37140,"Paducah, KY-IL",2007,202,125,327,80396,4.06736653564854
37140,"Paducah, KY-IL",2008,99,32,131,80695,1.62339674081418
37140,"Paducah, KY-IL",2009,87,4,91,81089,1.12222372948242
37140,"Paducah, KY-IL",2010,108,38,146,80920,1.80425111220959
37140,"Paducah, KY-IL",2011,108,50,158,81104,1.94811599921089
37140,"Paducah, KY-IL",2012,115,68,183,80690,2.2679390259016
37140,"Paducah, KY-IL",2013,79,34,113,80221,1.40860871841538
37140,"Paducah, KY-IL",2014,146,79,225,80106,2.80877836866152
37140,"Paducah, KY-IL",2015,191,300,491,79549,6.17229632050686
37140,"Paducah, KY-IL",2016,210,30,240,79779,3.00831045763923
37140,"Paducah, KY-IL",2017,113,37,150,79709,1.8818452119585
37140,"Paducah, KY-IL",2018,101,12,113,79426,1.4227079293934
37220,"Pahrump, NV",1990,0,0,0,18041,0
37220,"Pahrump, NV",1991,0,0,0,18740,0
37220,"Pahrump, NV",1992,0,0,0,19453,0
37220,"Pahrump, NV",1993,0,0,0,20275,0
37220,"Pahrump, NV",1994,0,0,0,21658,0
37220,"Pahrump, NV",1995,0,0,0,23224,0
37220,"Pahrump, NV",1996,0,0,0,24890,0
37220,"Pahrump, NV",1997,0,8,8,26990,0.296406076324565
37220,"Pahrump, NV",1998,0,0,0,28692,0
37220,"Pahrump, NV",1999,0,0,0,29405,0
37220,"Pahrump, NV",2000,0,0,0,32914,0
37220,"Pahrump, NV",2001,0,0,0,33684,0
37220,"Pahrump, NV",2002,0,0,0,34433,0
37220,"Pahrump, NV",2003,0,0,0,35525,0
37260,"Palatka, FL",1990,229,0,229,65333,3.50511992408125
37260,"Palatka, FL",1991,169,0,169,66269,2.55021201466749
37260,"Palatka, FL",1992,213,0,213,66872,3.18518961598277
37260,"Palatka, FL",1993,195,2,197,67705,2.90968170740713
37260,"Palatka, FL",1994,159,86,245,68523,3.57544182245377
37260,"Palatka, FL",1995,141,0,141,69047,2.0420872738859
37260,"Palatka, FL",1996,127,0,127,69720,1.82157200229489
37260,"Palatka, FL",1997,132,2,134,70016,1.91384826325411
37260,"Palatka, FL",1998,153,0,153,70250,2.1779359430605
37260,"Palatka, FL",1999,151,60,211,70027,3.01312350950348
37260,"Palatka, FL",2000,178,2,180,70433,2.5556202348331
37260,"Palatka, FL",2001,187,125,312,70585,4.42020259261883
37260,"Palatka, FL",2002,176,32,208,71386,2.91373658700586
37260,"Palatka, FL",2003,217,120,337,71853,4.6901312401709
37260,"Palatka, FL",2004,222,10,232,72831,3.18545674232126
37260,"Palatka, FL",2005,292,2,294,73792,3.98417172593235
37260,"Palatka, FL",2006,282,57,339,74663,4.54040153757551
37260,"Palatka, FL",2007,54,0,54,75107,0.718974263384239
37260,"Palatka, FL",2008,58,0,58,74999,0.773343644581928
37260,"Palatka, FL",2009,36,0,36,74546,0.482923295683202
37260,"Palatka, FL",2010,36,0,36,74207,0.485129435228483
37260,"Palatka, FL",2011,36,0,36,73639,0.488871386086177
37260,"Palatka, FL",2012,36,0,36,72912,0.493745885450955
37260,"Palatka, FL",2013,50,0,50,72362,0.690970398828114
37260,"Palatka, FL",2014,29,0,29,71968,0.402956869719875
37260,"Palatka, FL",2015,15,0,15,71935,0.208521581983735
37260,"Palatka, FL",2016,80,0,80,72378,1.10530824283622
37260,"Palatka, FL",2017,80,0,80,73385,1.09014103699666
37260,"Palatka, FL",2018,86,0,86,74163,1.15960789072718
37300,"Palestine, TX",1990,10,0,10,47918,0.208689845152135
37300,"Palestine, TX",1991,10,2,12,47973,0.250140704146082
37300,"Palestine, TX",1992,14,0,14,48055,0.291332847778587
37300,"Palestine, TX",1993,25,0,25,48933,0.510902662824679
37300,"Palestine, TX",1994,27,42,69,49626,1.39040019344698
37300,"Palestine, TX",1995,32,2,34,51672,0.657996593899985
37300,"Palestine, TX",1996,26,2,28,51809,0.540446640545079
37300,"Palestine, TX",1997,20,0,20,52064,0.384142593730793
37300,"Palestine, TX",1998,26,0,26,52026,0.499750124937531
37300,"Palestine, TX",1999,21,0,21,52318,0.401391490500401
37300,"Palestine, TX",2000,34,34,68,55062,1.23497148668773
37300,"Palestine, TX",2001,24,76,100,54263,1.84287636142491
37300,"Palestine, TX",2002,12,0,12,54740,0.219218122031421
37300,"Palestine, TX",2003,24,0,24,56068,0.428051651565956
37300,"Palestine, TX",2004,17,4,21,56245,0.373366521468575
37300,"Palestine, TX",2005,23,0,23,56873,0.404409825400454
37300,"Palestine, TX",2006,18,76,94,57386,1.63803018157739
37300,"Palestine, TX",2007,214,0,214,57870,3.69794366683947
37300,"Palestine, TX",2008,23,0,23,57963,0.396804858271656
37300,"Palestine, TX",2009,13,0,13,58410,0.22256462934429
37300,"Palestine, TX",2010,16,0,16,58497,0.273518300083765
37300,"Palestine, TX",2011,13,0,13,58394,0.222625612220434
37300,"Palestine, TX",2012,3,0,3,58065,0.051666236114699
37300,"Palestine, TX",2013,4,2,6,57977,0.103489314728254
37300,"Palestine, TX",2014,2,0,2,57849,0.0345727670314094
37300,"Palestine, TX",2015,7,0,7,57646,0.121430801790237
37300,"Palestine, TX",2016,13,0,13,57550,0.225890529973936
37300,"Palestine, TX",2017,14,0,14,58212,0.24050024050024
37300,"Palestine, TX",2018,24,9,33,58057,0.568406910450075
37340,"Palm Bay-Melbourne-Titusville, FL",1990,3880,879,4759,403132,11.8050663306312
37340,"Palm Bay-Melbourne-Titusville, FL",1991,2891,303,3194,415114,7.69427193493835
37340,"Palm Bay-Melbourne-Titusville, FL",1992,3548,162,3710,424847,8.73255548468037
37340,"Palm Bay-Melbourne-Titusville, FL",1993,3716,233,3949,435194,9.07411407326388
37340,"Palm Bay-Melbourne-Titusville, FL",1994,3622,385,4007,442755,9.05015188987137
37340,"Palm Bay-Melbourne-Titusville, FL",1995,2521,243,2764,449505,6.14898610693986
37340,"Palm Bay-Melbourne-Titusville, FL",1996,2910,391,3301,453723,7.27536404370067
37340,"Palm Bay-Melbourne-Titusville, FL",1997,2984,380,3364,459152,7.32654981356936
37340,"Palm Bay-Melbourne-Titusville, FL",1998,3242,580,3822,464716,8.22437789962041
37340,"Palm Bay-Melbourne-Titusville, FL",1999,3381,1278,4659,468858,9.93691053581255
37340,"Palm Bay-Melbourne-Titusville, FL",2000,3438,846,4284,477819,8.96573807236631
37340,"Palm Bay-Melbourne-Titusville, FL",2001,4379,665,5044,486429,10.3694475452738
37340,"Palm Bay-Melbourne-Titusville, FL",2002,4956,1666,6622,495425,13.3663016601907
37340,"Palm Bay-Melbourne-Titusville, FL",2003,5607,562,6169,504847,12.2195437429558
37340,"Palm Bay-Melbourne-Titusville, FL",2004,6487,2438,8925,518722,17.2057479729026
37340,"Palm Bay-Melbourne-Titusville, FL",2005,7321,1466,8787,529907,16.5821549819119
37340,"Palm Bay-Melbourne-Titusville, FL",2006,3967,1077,5044,535138,9.42560610534105
37340,"Palm Bay-Melbourne-Titusville, FL",2007,2039,888,2927,539719,5.42319243902846
37340,"Palm Bay-Melbourne-Titusville, FL",2008,1253,372,1625,542378,2.99606547463208
37340,"Palm Bay-Melbourne-Titusville, FL",2009,883,112,995,542109,1.83542424125038
37340,"Palm Bay-Melbourne-Titusville, FL",2010,926,218,1144,543972,2.10304942166141
37340,"Palm Bay-Melbourne-Titusville, FL",2011,855,27,882,544319,1.62037334724674
37340,"Palm Bay-Melbourne-Titusville, FL",2012,1117,11,1128,546978,2.06224016322412
37340,"Palm Bay-Melbourne-Titusville, FL",2013,1349,24,1373,550290,2.49504806556543
37340,"Palm Bay-Melbourne-Titusville, FL",2014,1241,45,1286,555598,2.31462316279036
37340,"Palm Bay-Melbourne-Titusville, FL",2015,1609,309,1918,565992,3.3887404768972
37340,"Palm Bay-Melbourne-Titusville, FL",2016,2166,749,2915,577338,5.04903540040669
37340,"Palm Bay-Melbourne-Titusville, FL",2017,2149,604,2753,588265,4.67986366688482
37340,"Palm Bay-Melbourne-Titusville, FL",2018,2362,596,2958,596849,4.95602740391623
37420,"Pampa, TX",1990,4,2,6,23782,0.252291649146413
37420,"Pampa, TX",1991,7,0,7,23563,0.297075924118321
37420,"Pampa, TX",1992,20,0,20,23500,0.851063829787234
37420,"Pampa, TX",1993,16,32,48,23509,2.04177123654771
37420,"Pampa, TX",1994,6,0,6,23297,0.257543889771215
37420,"Pampa, TX",1995,1,0,1,23330,0.042863266180883
37420,"Pampa, TX",1996,1,0,1,23853,0.0419234477843458
37420,"Pampa, TX",1997,0,20,20,23629,0.846417537771383
37420,"Pampa, TX",1998,1,20,21,23572,0.890887493636518
37420,"Pampa, TX",1999,1,0,1,23264,0.0429848693259973
37420,"Pampa, TX",2000,0,0,0,22578,0
37420,"Pampa, TX",2001,1,20,21,22171,0.947183257408326
37420,"Pampa, TX",2002,2,0,2,21940,0.0911577028258888
37420,"Pampa, TX",2003,0,0,0,21762,0
37420,"Pampa, TX",2004,1,0,1,21551,0.0464015590923855
37420,"Pampa, TX",2005,3,0,3,21776,0.137766348273328
37420,"Pampa, TX",2006,3,0,3,22100,0.135746606334842
37420,"Pampa, TX",2007,3,0,3,22438,0.133701755949728
37420,"Pampa, TX",2008,2,0,2,22772,0.0878271561566837
37420,"Pampa, TX",2009,3,0,3,22719,0.13204806549584
37420,"Pampa, TX",2010,3,0,3,22469,0.133517290489118
37420,"Pampa, TX",2011,3,0,3,22657,0.132409409895397
37420,"Pampa, TX",2012,2,0,2,22919,0.0872638422269733
37420,"Pampa, TX",2013,3,0,3,22995,0.130463144161774
37420,"Pampa, TX",2014,3,0,3,23435,0.128013654789844
37420,"Pampa, TX",2015,2,0,2,23251,0.086017805685777
37420,"Pampa, TX",2016,0,0,0,22721,0
37420,"Pampa, TX",2017,0,0,0,22121,0
37420,"Pampa, TX",2018,2,0,2,21895,0.0913450559488468
37460,"Panama City, FL",1990,760,50,810,138821,5.8348520756946
37460,"Panama City, FL",1991,960,24,984,141482,6.95494833265009
37460,"Panama City, FL",1992,1220,82,1302,144936,8.983275376718
37460,"Panama City, FL",1993,1149,294,1443,149401,9.65856988909043
37460,"Panama City, FL",1994,1064,35,1099,152532,7.20504549864946
37460,"Panama City, FL",1995,902,234,1136,155204,7.31939898456225
37460,"Panama City, FL",1996,1021,50,1071,158039,6.77680825618993
37460,"Panama City, FL",1997,1027,630,1657,159834,10.3670057684848
37460,"Panama City, FL",1998,1216,477,1693,160162,10.5705473208377
37460,"Panama City, FL",1999,972,186,1158,161390,7.175165747568
37460,"Panama City, FL",2000,947,693,1640,162959,10.0638810989267
37460,"Panama City, FL",2001,993,219,1212,165075,7.34211721944571
37460,"Panama City, FL",2002,1355,505,1860,167638,11.0953363795798
37460,"Panama City, FL",2003,1494,2363,3857,170310,22.6469379367037
37460,"Panama City, FL",2004,1645,2382,4027,174259,23.1092798650285
37460,"Panama City, FL",2005,1580,3996,5576,178698,31.20348297127
37460,"Panama City, FL",2006,1155,2156,3311,181500,18.2424242424242
37460,"Panama City, FL",2007,707,400,1107,181253,6.10748511748771
37460,"Panama City, FL",2008,472,508,980,182118,5.38112652236462
37460,"Panama City, FL",2009,298,90,388,183397,2.1156289361330902
37460,"Panama City, FL",2010,248,106,354,185028,1.91322394448408
37460,"Panama City, FL",2011,313,75,388,185299,2.0939130810204
37460,"Panama City, FL",2012,447,40,487,187516,2.59711171313381
37460,"Panama City, FL",2013,561,104,665,190487,3.49105188280565
37460,"Panama City, FL",2014,687,6,693,194305,3.56655773140166
37460,"Panama City, FL",2015,808,180,988,197315,5.00722195474242
37460,"Panama City, FL",2016,883,172,1055,199445,5.28967885883326
37460,"Panama City, FL",2017,984,802,1786,200168,8.9225050957196
37460,"Panama City, FL",2018,1104,564,1668,201451,8.27992911427593
37500,"Paragould, AR",1990,96,32,128,31880,4.01505646173149
37500,"Paragould, AR",1991,115,33,148,32275,4.58559256390395
37500,"Paragould, AR",1992,130,37,167,32773,5.09565801116773
37500,"Paragould, AR",1993,147,19,166,33222,4.99668894106315
37500,"Paragould, AR",1994,181,29,210,33925,6.19012527634488
37500,"Paragould, AR",1995,166,55,221,34596,6.38802173661695
37500,"Paragould, AR",1996,165,46,211,35052,6.01962798128495
37500,"Paragould, AR",1997,141,44,185,35534,5.206281308043
37500,"Paragould, AR",1998,170,102,272,36077,7.53942955345511
37500,"Paragould, AR",1999,235,249,484,36409,13.2934164629625
37500,"Paragould, AR",2000,200,4,204,37563,5.43087612810478
37500,"Paragould, AR",2001,164,4,168,37934,4.42874466178099
37500,"Paragould, AR",2002,167,14,181,38229,4.73462554605143
37500,"Paragould, AR",2003,184,11,195,38604,5.0512900217594
37500,"Paragould, AR",2004,194,15,209,39046,5.35266096399119
37500,"Paragould, AR",2005,202,25,227,39599,5.73246799161595
37500,"Paragould, AR",2006,137,28,165,40469,4.07719488991574
37500,"Paragould, AR",2007,158,43,201,40918,4.91226355149323
37500,"Paragould, AR",2008,133,56,189,41286,4.57782299084435
37500,"Paragould, AR",2009,96,52,148,41723,3.54720417994871
37500,"Paragould, AR",2010,114,54,168,42200,3.98104265402844
37500,"Paragould, AR",2011,85,59,144,42757,3.36786958860537
37500,"Paragould, AR",2012,122,44,166,43226,3.84028131217323
37500,"Paragould, AR",2013,88,49,137,43160,3.17423540315107
37500,"Paragould, AR",2014,118,75,193,43787,4.40770091579693
37500,"Paragould, AR",2015,110,38,148,44298,3.34100862341415
37500,"Paragould, AR",2016,105,44,149,44730,3.33109769729488
37500,"Paragould, AR",2017,131,64,195,44977,4.33554928074349
37500,"Paragould, AR",2018,112,50,162,45325,3.57418643132929
37540,"Paris, TN",1990,8,0,8,27927,0.286461130805314
37540,"Paris, TN",1991,12,0,12,28066,0.427563600085513
37540,"Paris, TN",1992,35,0,35,28383,1.23313250889617
37540,"Paris, TN",1993,26,6,32,28725,1.11401218450827
37540,"Paris, TN",1994,21,4,25,29003,0.861979795193601
37540,"Paris, TN",1995,21,2,23,29372,0.783058695356121
37540,"Paris, TN",1996,31,23,54,29548,1.82753485853526
37540,"Paris, TN",1997,46,80,126,29807,4.22719495420539
37540,"Paris, TN",1998,40,0,40,29988,1.33386688008537
37540,"Paris, TN",1999,25,2,27,30169,0.894958401007657
37540,"Paris, TN",2000,15,2,17,31131,0.546079470624137
37540,"Paris, TN",2001,38,0,38,31214,1.21740244761966
37540,"Paris, TN",2002,23,0,23,31343,0.733816163098619
37540,"Paris, TN",2003,24,99,123,31195,3.9429395736496202
37540,"Paris, TN",2004,29,10,39,31265,1.24740124740125
37540,"Paris, TN",2005,33,12,45,31538,1.42685014902657
37540,"Paris, TN",2006,29,4,33,31686,1.04146941867071
37540,"Paris, TN",2007,24,4,28,31833,0.879590362202746
37540,"Paris, TN",2008,14,4,18,32106,0.560642870491497
37540,"Paris, TN",2009,11,2,13,32234,0.403300862443383
37540,"Paris, TN",2010,10,2,12,32396,0.370416100753179
37540,"Paris, TN",2011,9,2,11,32405,0.33945378799568
37540,"Paris, TN",2012,12,2,14,32370,0.432499227679951
37540,"Paris, TN",2013,14,4,18,32230,0.558485882717965
37540,"Paris, TN",2014,11,2,13,32239,0.403238313843482
37540,"Paris, TN",2015,11,4,15,32134,0.466795294703429
37540,"Paris, TN",2016,13,4,17,32245,0.527213521476198
37540,"Paris, TN",2017,14,4,18,32420,0.555212831585441
37540,"Paris, TN",2018,15,6,21,32358,0.648989430743557
37580,"Paris, TX",1990,53,17,70,43982,1.59156018371152
37580,"Paris, TX",1991,68,8,76,44049,1.72535131331018
37580,"Paris, TX",1992,78,32,110,44261,2.48525790199047
37580,"Paris, TX",1993,106,28,134,44912,2.98361239757749
37580,"Paris, TX",1994,140,116,256,44697,5.72745374409916
37580,"Paris, TX",1995,134,33,167,44946,3.71556979486495
37580,"Paris, TX",1996,95,32,127,45335,2.80136759677953
37580,"Paris, TX",1997,81,52,133,45593,2.91711446932643
37580,"Paris, TX",1998,78,93,171,45770,3.73607166266113
37580,"Paris, TX",1999,106,42,148,45948,3.22103247148951
37580,"Paris, TX",2000,96,21,117,48596,2.40760556424397
37580,"Paris, TX",2001,96,10,106,48522,2.18457606858744
37580,"Paris, TX",2002,105,63,168,48826,3.44078974316962
37580,"Paris, TX",2003,84,87,171,49159,3.47850851319189
37580,"Paris, TX",2004,77,52,129,49233,2.62019377246969
37580,"Paris, TX",2005,58,2,60,49344,1.215953307393
37580,"Paris, TX",2006,62,19,81,49386,1.64014093062811
37580,"Paris, TX",2007,47,0,47,49387,0.951667442849333
37580,"Paris, TX",2008,26,0,26,49467,0.525602927203995
37580,"Paris, TX",2009,27,0,27,49600,0.544354838709677
37580,"Paris, TX",2010,46,0,46,49819,0.923342499849455
37580,"Paris, TX",2011,28,13,41,49854,0.8224014121234
37580,"Paris, TX",2012,11,24,35,49657,0.704835169261131
37580,"Paris, TX",2013,35,0,35,49095,0.712903554333435
37580,"Paris, TX",2014,27,16,43,49417,0.870145901208086
37580,"Paris, TX",2015,20,20,40,49380,0.810044552450385
37580,"Paris, TX",2016,26,20,46,49536,0.928617571059432
37580,"Paris, TX",2017,26,20,46,49597,0.927475452144283
37580,"Paris, TX",2018,34,14,48,49728,0.965250965250965
37620,"Parkersburg-Vienna, WV",1990,66,2,68,92107,0.738271792589054
37620,"Parkersburg-Vienna, WV",1991,173,37,210,92298,2.27523890008451
37620,"Parkersburg-Vienna, WV",1992,236,56,292,92697,3.15004800586858
37620,"Parkersburg-Vienna, WV",1993,272,30,302,93111,3.24344062463082
37620,"Parkersburg-Vienna, WV",1994,200,52,252,93332,2.7000385719796
37620,"Parkersburg-Vienna, WV",1995,186,91,277,93368,2.96675520520949
37620,"Parkersburg-Vienna, WV",1996,197,162,359,93051,3.85809932187725
37620,"Parkersburg-Vienna, WV",1997,180,210,390,92777,4.20362805436692
37620,"Parkersburg-Vienna, WV",1998,171,96,267,92391,2.88989187258499
37620,"Parkersburg-Vienna, WV",1999,201,22,223,92121,2.42072925825816
37620,"Parkersburg-Vienna, WV",2000,165,72,237,93711,2.52905208566764
37620,"Parkersburg-Vienna, WV",2001,178,99,277,93536,2.96142661648991
37620,"Parkersburg-Vienna, WV",2002,177,26,203,93424,2.17288919335503
37620,"Parkersburg-Vienna, WV",2003,159,9,168,92974,1.80695678361693
37620,"Parkersburg-Vienna, WV",2004,179,7,186,92705,2.00636427377164
37620,"Parkersburg-Vienna, WV",2005,240,20,260,92655,2.80610868274783
37620,"Parkersburg-Vienna, WV",2006,245,12,257,92343,2.7831021301019
37620,"Parkersburg-Vienna, WV",2007,171,16,187,92295,2.02611192372285
37620,"Parkersburg-Vienna, WV",2008,134,56,190,92528,2.05343247449421
37620,"Parkersburg-Vienna, WV",2009,122,8,130,92544,1.40473720608575
37620,"Parkersburg-Vienna, WV",2010,90,47,137,92696,1.47794942608095
37620,"Parkersburg-Vienna, WV",2011,77,4,81,92630,0.874446723523696
37620,"Parkersburg-Vienna, WV",2012,98,20,118,92379,1.27734658309789
37620,"Parkersburg-Vienna, WV",2013,82,0,82,92353,0.887897523632151
37620,"Parkersburg-Vienna, WV",2014,122,2,124,92256,1.34408602150538
37620,"Parkersburg-Vienna, WV",2015,137,40,177,92131,1.9211774538429
37620,"Parkersburg-Vienna, WV",2016,130,2,132,91466,1.44315920669976
37620,"Parkersburg-Vienna, WV",2017,103,30,133,90873,1.46358104167354
37620,"Parkersburg-Vienna, WV",2018,87,38,125,90033,1.38837981628958
37660,"Parsons, KS",1990,15,0,15,23616,0.635162601626016
37660,"Parsons, KS",1991,8,0,8,23627,0.338595674440259
37660,"Parsons, KS",1992,16,48,64,23617,2.70991235127239
37660,"Parsons, KS",1993,16,0,16,23398,0.683819129840157
37660,"Parsons, KS",1994,18,0,18,23329,0.77157186334605
37660,"Parsons, KS",1995,8,2,10,23260,0.429922613929493
37660,"Parsons, KS",1996,19,0,19,23182,0.819601414890864
37660,"Parsons, KS",1997,20,35,55,23135,2.37735033499027
37660,"Parsons, KS",1998,20,0,20,23039,0.868093233213247
37660,"Parsons, KS",1999,18,0,18,22956,0.784108729743858
37660,"Parsons, KS",2000,66,0,66,22733,2.90326837636915
37660,"Parsons, KS",2001,22,0,22,22436,0.980566945979676
37660,"Parsons, KS",2002,17,22,39,22214,1.75564959034843
37660,"Parsons, KS",2003,18,8,26,22100,1.17647058823529
37660,"Parsons, KS",2004,9,0,9,21911,0.410752590023276
37660,"Parsons, KS",2005,22,0,22,21913,1.00397024597271
37660,"Parsons, KS",2006,18,0,18,21929,0.820830863240458
37660,"Parsons, KS",2007,17,0,17,21928,0.775264502006567
37660,"Parsons, KS",2008,10,0,10,21786,0.459010373634444
37660,"Parsons, KS",2009,14,0,14,21759,0.643411921503746
37660,"Parsons, KS",2010,15,0,15,21534,0.696572861521315
37660,"Parsons, KS",2011,4,0,4,21374,0.187143258164125
37660,"Parsons, KS",2012,18,0,18,21163,0.850541038605113
37660,"Parsons, KS",2013,5,0,5,20872,0.239555385205059
37660,"Parsons, KS",2014,3,2,5,20774,0.240685472224897
37660,"Parsons, KS",2015,4,0,4,20630,0.193892389723703
37660,"Parsons, KS",2016,3,0,3,20313,0.147688672278836
37660,"Parsons, KS",2017,5,0,5,20152,0.248114331083763
37660,"Parsons, KS",2018,7,0,7,19964,0.350631136044881
37740,"Payson, AZ",1990,162,2,164,40382,4.06121539299688
37740,"Payson, AZ",1991,157,34,191,41115,4.64550650614131
37740,"Payson, AZ",1992,202,40,242,42221,5.73174486629876
37740,"Payson, AZ",1993,231,16,247,43436,5.68652730454001
37740,"Payson, AZ",1994,334,52,386,44621,8.65063535106788
37740,"Payson, AZ",1995,309,64,373,46070,8.09637508139787
37740,"Payson, AZ",1996,395,16,411,47210,8.70578267316247
37740,"Payson, AZ",1997,388,98,486,48185,10.08612638788
37740,"Payson, AZ",1998,346,22,368,48817,7.53835753938177
37740,"Payson, AZ",1999,368,12,380,49094,7.74025339145313
37740,"Payson, AZ",2000,335,4,339,51332,6.60406763812047
37740,"Payson, AZ",2001,260,0,260,51274,5.07079611499005
37740,"Payson, AZ",2002,300,2,302,51478,5.86658378336377
37740,"Payson, AZ",2003,248,42,290,51337,5.64894715312543
37740,"Payson, AZ",2004,281,2,283,51423,5.50337397662525
37740,"Payson, AZ",2005,380,113,493,51655,9.54409060110348
37740,"Payson, AZ",2006,313,40,353,52541,6.71856264631431
37740,"Payson, AZ",2007,209,84,293,53252,5.50214076466612
37740,"Payson, AZ",2008,135,67,202,53437,3.78015232891068
37740,"Payson, AZ",2009,63,119,182,53561,3.39799480965628
37740,"Payson, AZ",2010,70,3,73,53571,1.36267756808721
37740,"Payson, AZ",2011,47,25,72,53444,1.34720455055759
37740,"Payson, AZ",2012,51,0,51,53003,0.962209686244175
37740,"Payson, AZ",2013,72,2,74,53022,1.39564708988722
37740,"Payson, AZ",2014,101,0,101,53070,1.90314678726211
37740,"Payson, AZ",2015,105,3,108,53006,2.03750518809191
37740,"Payson, AZ",2016,116,0,116,53404,2.17212193843158
37740,"Payson, AZ",2017,152,4,156,53629,2.90887393014973
37740,"Payson, AZ",2018,163,6,169,53889,3.1360760080907
37780,"Pecos, TX",1990,2,0,2,15758,0.126919659855312
37780,"Pecos, TX",1991,0,0,0,15629,0
37780,"Pecos, TX",1992,0,0,0,15440,0
37780,"Pecos, TX",1993,1,0,1,15495,0.0645369474023879
37780,"Pecos, TX",1994,1,0,1,15159,0.0659674120984234
37780,"Pecos, TX",1995,1,0,1,14959,0.0668493883280968
37780,"Pecos, TX",1996,1,0,1,14866,0.0672675904749092
37780,"Pecos, TX",1997,1,0,1,14579,0.0685918101378695
37780,"Pecos, TX",1998,1,0,1,14310,0.0698812019566736
37780,"Pecos, TX",1999,1,0,1,14052,0.0711642470822659
37780,"Pecos, TX",2000,1,0,1,13115,0.0762485703393061
37780,"Pecos, TX",2001,1,0,1,13022,0.0767931193365075
37780,"Pecos, TX",2002,1,0,1,13017,0.0768226165783207
37780,"Pecos, TX",2003,1,0,1,12910,0.0774593338497289
37780,"Pecos, TX",2004,1,0,1,12721,0.078610172156277
37780,"Pecos, TX",2005,2,0,2,12675,0.157790927021696
37780,"Pecos, TX",2006,2,0,2,12747,0.156899662665725
37780,"Pecos, TX",2007,1,0,1,13039,0.0766929979292891
37780,"Pecos, TX",2008,1,0,1,13211,0.0756944970100674
37780,"Pecos, TX",2009,1,0,1,13550,0.0738007380073801
37780,"Pecos, TX",2010,1,0,1,13836,0.0722752240531946
37780,"Pecos, TX",2011,1,0,1,13812,0.072400810889082
37780,"Pecos, TX",2012,2,0,2,13987,0.142989919210696
37780,"Pecos, TX",2013,3,0,3,14218,0.21100014066676
37780,"Pecos, TX",2014,3,0,3,14557,0.206086418904994
37780,"Pecos, TX",2015,3,0,3,14955,0.200601805416249
37780,"Pecos, TX",2016,3,0,3,15122,0.198386456817881
37780,"Pecos, TX",2017,4,0,4,15295,0.26152337365152
37780,"Pecos, TX",2018,30,15,45,15695,2.86715514495062
37860,"Pensacola-Ferry Pass-Brent, FL",1990,1939,58,1997,345489,5.78021297349554
37860,"Pensacola-Ferry Pass-Brent, FL",1991,1927,123,2050,351890,5.82568416266447
37860,"Pensacola-Ferry Pass-Brent, FL",1992,3028,117,3145,360004,8.7360140442884
37860,"Pensacola-Ferry Pass-Brent, FL",1993,2908,66,2974,364889,8.15042382752015
37860,"Pensacola-Ferry Pass-Brent, FL",1994,3122,151,3273,370177,8.84171626005938
37860,"Pensacola-Ferry Pass-Brent, FL",1995,2374,470,2844,375807,7.56771427887187
37860,"Pensacola-Ferry Pass-Brent, FL",1996,3307,1258,4565,383250,11.91128506197
37860,"Pensacola-Ferry Pass-Brent, FL",1997,3126,569,3695,393809,9.38272106528799
37860,"Pensacola-Ferry Pass-Brent, FL",1998,2858,366,3224,401913,8.02163652332719
37860,"Pensacola-Ferry Pass-Brent, FL",1999,2625,289,2914,402350,7.24245060270908
37860,"Pensacola-Ferry Pass-Brent, FL",2000,2413,98,2511,413085,6.07865209339482
37860,"Pensacola-Ferry Pass-Brent, FL",2001,2906,276,3182,419037,7.59360151967487
37860,"Pensacola-Ferry Pass-Brent, FL",2002,2832,381,3213,425006,7.55989327209498
37860,"Pensacola-Ferry Pass-Brent, FL",2003,3578,1223,4801,428066,11.2155602173497
37860,"Pensacola-Ferry Pass-Brent, FL",2004,3735,900,4635,435466,10.643770122122
37860,"Pensacola-Ferry Pass-Brent, FL",2005,3342,614,3956,439471,9.00173162734287
37860,"Pensacola-Ferry Pass-Brent, FL",2006,2141,670,2811,443378,6.33996274059606
37860,"Pensacola-Ferry Pass-Brent, FL",2007,1757,865,2622,443551,5.91138335839622
37860,"Pensacola-Ferry Pass-Brent, FL",2008,1090,200,1290,445392,2.89632503502533
37860,"Pensacola-Ferry Pass-Brent, FL",2009,962,80,1042,446559,2.33339827436016
37860,"Pensacola-Ferry Pass-Brent, FL",2010,1336,418,1754,450947,3.88959234677246
37860,"Pensacola-Ferry Pass-Brent, FL",2011,1203,2,1205,455079,2.64789190448252
37860,"Pensacola-Ferry Pass-Brent, FL",2012,1460,34,1494,461586,3.2366666233378
37860,"Pensacola-Ferry Pass-Brent, FL",2013,1865,266,2131,467066,4.5625243541598
37860,"Pensacola-Ferry Pass-Brent, FL",2014,1637,188,1825,470620,3.87786324423101
37860,"Pensacola-Ferry Pass-Brent, FL",2015,2017,617,2634,475563,5.53869834280632
37860,"Pensacola-Ferry Pass-Brent, FL",2016,2369,504,2873,481429,5.96765047390166
37860,"Pensacola-Ferry Pass-Brent, FL",2017,2584,25,2609,487327,5.35369474705896
37860,"Pensacola-Ferry Pass-Brent, FL",2018,2528,40,2568,494883,5.18910530367784
37900,"Peoria, IL",1990,768,89,857,359216,2.38575119148368
37900,"Peoria, IL",1991,727,54,781,361227,2.16207537088867
37900,"Peoria, IL",1992,846,90,936,361730,2.58756531114367
37900,"Peoria, IL",1993,906,379,1285,361784,3.55184308869381
37900,"Peoria, IL",1994,918,143,1061,361927,2.93153039148779
37900,"Peoria, IL",1995,931,408,1339,365263,3.66585172875435
37900,"Peoria, IL",1996,1209,280,1489,365191,4.07731844432092
37900,"Peoria, IL",1997,977,318,1295,365096,3.54701229265727
37900,"Peoria, IL",1998,1090,274,1364,365277,3.73415243773903
37900,"Peoria, IL",1999,1200,331,1531,365663,4.18691527444669
37900,"Peoria, IL",2000,1187,411,1598,366659,4.35827294570705
37900,"Peoria, IL",2001,1042,127,1169,365600,3.19748358862144
37900,"Peoria, IL",2002,1214,197,1411,366312,3.85190766341261
37900,"Peoria, IL",2003,1382,375,1757,366256,4.79719103577825
37900,"Peoria, IL",2004,1431,389,1820,367962,4.94616291899707
37900,"Peoria, IL",2005,1397,540,1937,369772,5.23836309942343
37900,"Peoria, IL",2006,1223,399,1622,371687,4.36388681874803
37900,"Peoria, IL",2007,1093,259,1352,374179,3.61324392870792
37900,"Peoria, IL",2008,790,204,994,375982,2.64374358346942
37900,"Peoria, IL",2009,537,41,578,379373,1.52356651633089
37900,"Peoria, IL",2010,570,223,793,378976,2.09248079034029
37900,"Peoria, IL",2011,446,24,470,379748,1.2376628711672
37900,"Peoria, IL",2012,638,89,727,380277,1.91176431916734
37900,"Peoria, IL",2013,538,80,618,381776,1.6187502619337
37900,"Peoria, IL",2014,835,55,890,379516,2.34509217002709
37900,"Peoria, IL",2015,424,78,502,377165,1.33098246125701
37900,"Peoria, IL",2016,326,24,350,375269,0.932664302140598
37900,"Peoria, IL",2017,247,10,257,371810,0.691213254081386
37900,"Peoria, IL",2018,228,106,334,368373,0.906689686812008
37940,"Peru, IN",1990,48,2,50,36870,1.35611608353675
37940,"Peru, IN",1991,45,6,51,37104,1.3745148771022
37940,"Peru, IN",1992,35,0,35,36939,0.947508053818457
37940,"Peru, IN",1993,46,0,46,36233,1.26956089752436
37940,"Peru, IN",1994,70,2,72,34285,2.10004375091148
37940,"Peru, IN",1995,72,0,72,32398,2.22235940490154
37940,"Peru, IN",1996,97,2,99,32481,3.04793571626489
37940,"Peru, IN",1997,92,0,92,33205,2.77066706821262
37940,"Peru, IN",1998,90,6,96,33475,2.86781179985063
37940,"Peru, IN",1999,96,48,144,33701,4.27287024123913
37940,"Peru, IN",2000,115,0,115,36184,3.17820030952907
37940,"Peru, IN",2001,102,0,102,36475,2.79643591501028
37940,"Peru, IN",2002,98,48,146,37019,3.94392068937573
37940,"Peru, IN",2003,105,56,161,37251,4.32203162331213
37940,"Peru, IN",2004,48,0,48,37120,1.29310344827586
37940,"Peru, IN",2005,61,0,61,37445,1.6290559487248
37940,"Peru, IN",2006,50,0,50,37745,1.32467876539939
37940,"Peru, IN",2007,24,0,24,37580,0.638637573177222
37940,"Peru, IN",2008,23,0,23,37281,0.61693624098066
37940,"Peru, IN",2009,10,0,10,37127,0.269345759151022
37940,"Peru, IN",2010,10,0,10,36810,0.271665308340125
37940,"Peru, IN",2011,10,0,10,36645,0.272888525037522
37940,"Peru, IN",2012,13,0,13,36534,0.355832922756884
37940,"Peru, IN",2013,12,0,12,36165,0.331812525922854
37940,"Peru, IN",2014,10,0,10,36071,0.277231016606138
37940,"Peru, IN",2015,20,0,20,36001,0.555540123885448
37940,"Peru, IN",2016,17,0,17,36041,0.471685025387753
37940,"Peru, IN",2017,20,0,20,35827,0.558238200240042
37940,"Peru, IN",2018,26,0,26,35567,0.731014704641943
37980,"Philadelphia-Camden-Wilmington, PA-NJ-DE-MD",1990,13249,2568,15817,5441129,2.90693346913848
37980,"Philadelphia-Camden-Wilmington, PA-NJ-DE-MD",1991,12658,1479,14137,5459638,2.58936581509617
37980,"Philadelphia-Camden-Wilmington, PA-NJ-DE-MD",1992,15399,1199,16598,5467191,3.0359283222408
37980,"Philadelphia-Camden-Wilmington, PA-NJ-DE-MD",1993,17207,1505,18712,5480569,3.41424403196091
37980,"Philadelphia-Camden-Wilmington, PA-NJ-DE-MD",1994,16921,1121,18042,5493932,3.28398676940304
37980,"Philadelphia-Camden-Wilmington, PA-NJ-DE-MD",1995,14709,1398,16107,5502300,2.92732130200098
37980,"Philadelphia-Camden-Wilmington, PA-NJ-DE-MD",1996,15259,2250,17509,5503104,3.18165893284953
37980,"Philadelphia-Camden-Wilmington, PA-NJ-DE-MD",1997,15937,3722,19659,5501525,3.57337283753141
37980,"Philadelphia-Camden-Wilmington, PA-NJ-DE-MD",1998,17536,3369,20905,5510777,3.79347594722124
37980,"Philadelphia-Camden-Wilmington, PA-NJ-DE-MD",1999,17122,2861,19983,5520990,3.61945955344965
37980,"Philadelphia-Camden-Wilmington, PA-NJ-DE-MD",2000,15787,3733,19520,5691968,3.42939384058378
37980,"Philadelphia-Camden-Wilmington, PA-NJ-DE-MD",2001,14853,2993,17846,5713954,3.12323130357717
37980,"Philadelphia-Camden-Wilmington, PA-NJ-DE-MD",2002,16330,2645,18975,5743383,3.30380195783565
37980,"Philadelphia-Camden-Wilmington, PA-NJ-DE-MD",2003,15367,5713,21080,5773864,3.65093462540857
37980,"Philadelphia-Camden-Wilmington, PA-NJ-DE-MD",2004,15504,5506,21010,5804535,3.61958365312639
37980,"Philadelphia-Camden-Wilmington, PA-NJ-DE-MD",2005,15041,5201,20242,5829139,3.47255400840501
37980,"Philadelphia-Camden-Wilmington, PA-NJ-DE-MD",2006,11717,5495,17212,5856125,2.93914491237807
37980,"Philadelphia-Camden-Wilmington, PA-NJ-DE-MD",2007,9542,3935,13477,5882126,2.29117839366243
37980,"Philadelphia-Camden-Wilmington, PA-NJ-DE-MD",2008,7269,3301,10570,5906917,1.78942754739909
37980,"Philadelphia-Camden-Wilmington, PA-NJ-DE-MD",2009,4963,2130,7093,5941539,1.19379844178419
37980,"Philadelphia-Camden-Wilmington, PA-NJ-DE-MD",2010,5186,1867,7053,5970948,1.18121946464782
37980,"Philadelphia-Camden-Wilmington, PA-NJ-DE-MD",2011,4456,2523,6979,5995769,1.16398747183222
37980,"Philadelphia-Camden-Wilmington, PA-NJ-DE-MD",2012,5175,4095,9270,6016657,1.540722697006
37980,"Philadelphia-Camden-Wilmington, PA-NJ-DE-MD",2013,6252,4965,11217,6030541,1.86003212647091
37980,"Philadelphia-Camden-Wilmington, PA-NJ-DE-MD",2014,6379,7252,13631,6047106,2.25413611072801
37980,"Philadelphia-Camden-Wilmington, PA-NJ-DE-MD",2015,6548,5769,12317,6057621,2.03330647460447
37980,"Philadelphia-Camden-Wilmington, PA-NJ-DE-MD",2016,7016,5229,12245,6067691,2.01806585074949
37980,"Philadelphia-Camden-Wilmington, PA-NJ-DE-MD",2017,7233,6311,13544,6078451,2.22819925668563
37980,"Philadelphia-Camden-Wilmington, PA-NJ-DE-MD",2018,6875,6281,13156,6096372,2.15800479367073
38060,"Phoenix-Mesa-Scottsdale, AZ",1990,11304,2074,13378,2245841,5.95678857051768
38060,"Phoenix-Mesa-Scottsdale, AZ",1991,14330,1098,15428,2302357,6.70095906064959
38060,"Phoenix-Mesa-Scottsdale, AZ",1992,19449,1567,21016,2367448,8.87706931683399
38060,"Phoenix-Mesa-Scottsdale, AZ",1993,23215,2257,25472,2444986,10.4180555635083
38060,"Phoenix-Mesa-Scottsdale, AZ",1994,28224,6551,34775,2549506,13.639897297751
38060,"Phoenix-Mesa-Scottsdale, AZ",1995,28583,8953,37536,2661314,14.1043108780099
38060,"Phoenix-Mesa-Scottsdale, AZ",1996,29513,10133,39646,2753523,14.3982817648518
38060,"Phoenix-Mesa-Scottsdale, AZ",1997,32210,11014,43224,2841136,15.2136328567165
38060,"Phoenix-Mesa-Scottsdale, AZ",1998,36562,11240,47802,2930307,16.3129665253504
38060,"Phoenix-Mesa-Scottsdale, AZ",1999,38448,9265,47713,3011612,15.8430103213827
38060,"Phoenix-Mesa-Scottsdale, AZ",2000,34232,11078,45310,3273477,13.8415513534997
38060,"Phoenix-Mesa-Scottsdale, AZ",2001,37170,8930,46100,3363736,13.7049994410976
38060,"Phoenix-Mesa-Scottsdale, AZ",2002,40002,7897,47899,3452470,13.8738352541803
38060,"Phoenix-Mesa-Scottsdale, AZ",2003,47285,7575,54860,3536388,15.5130036636251
38060,"Phoenix-Mesa-Scottsdale, AZ",2004,57360,7899,65259,3637332,17.9414471926126
38060,"Phoenix-Mesa-Scottsdale, AZ",2005,54313,8304,62617,3774696,16.5886206465368
38060,"Phoenix-Mesa-Scottsdale, AZ",2006,36282,7998,44280,3914212,11.312621799739
38060,"Phoenix-Mesa-Scottsdale, AZ",2007,26404,10868,37272,4018128,9.27596134319265
38060,"Phoenix-Mesa-Scottsdale, AZ",2008,12657,5876,18533,4106372,4.51322968303895
38060,"Phoenix-Mesa-Scottsdale, AZ",2009,8598,674,9272,4153609,2.23227559454922
38060,"Phoenix-Mesa-Scottsdale, AZ",2010,7212,1088,8300,4204738,1.97396365718863
38060,"Phoenix-Mesa-Scottsdale, AZ",2011,7297,1784,9081,4253825,2.13478457623433
38060,"Phoenix-Mesa-Scottsdale, AZ",2012,11931,4036,15967,4331053,3.68663232705765
38060,"Phoenix-Mesa-Scottsdale, AZ",2013,12959,5778,18737,4404675,4.25388933349226
38060,"Phoenix-Mesa-Scottsdale, AZ",2014,11557,8784,20341,4491423,4.52885421836242
38060,"Phoenix-Mesa-Scottsdale, AZ",2015,16621,5781,22402,4581122,4.89006841555409
38060,"Phoenix-Mesa-Scottsdale, AZ",2016,18433,10150,28583,4675966,6.1127476119373
38060,"Phoenix-Mesa-Scottsdale, AZ",2017,20471,8841,29312,4761694,6.15579245537407
38060,"Phoenix-Mesa-Scottsdale, AZ",2018,23526,7817,31343,4857962,6.45188249722826
38100,"Picayune, MS",1990,12,0,12,38826,0.309071240921032
38100,"Picayune, MS",1991,36,0,36,39105,0.920598388952819
38100,"Picayune, MS",1992,280,0,280,39638,7.06392855340835
38100,"Picayune, MS",1993,34,4,38,40621,0.935476723862042
38100,"Picayune, MS",1994,261,6,267,41893,6.37337980092139
38100,"Picayune, MS",1995,268,4,272,43271,6.28596519608976
38100,"Picayune, MS",1996,279,20,299,44331,6.74471588730234
38100,"Picayune, MS",1997,270,0,270,45663,5.91288351619473
38100,"Picayune, MS",1998,170,12,182,46789,3.88980315886213
38100,"Picayune, MS",1999,371,170,541,47926,11.2882360305471
38100,"Picayune, MS",2000,330,10,340,48621,6.99286316612163
38100,"Picayune, MS",2001,308,9,317,49083,6.45844793513029
38100,"Picayune, MS",2002,371,5,376,49659,7.57163857508206
38100,"Picayune, MS",2003,380,8,388,49968,7.76496958053154
38100,"Picayune, MS",2004,386,6,392,50624,7.74336283185841
38100,"Picayune, MS",2005,380,8,388,50990,7.6093351637576
38100,"Picayune, MS",2006,533,17,550,55153,9.97225898863162
38100,"Picayune, MS",2007,368,154,522,56053,9.31261484666298
38100,"Picayune, MS",2008,259,113,372,56538,6.57964554812692
38100,"Picayune, MS",2009,168,82,250,56085,4.45751983596327
38100,"Picayune, MS",2010,163,75,238,55705,4.27250695628759
38100,"Picayune, MS",2011,133,17,150,55448,2.70523733948925
38100,"Picayune, MS",2012,142,28,170,55007,3.09051575254059
38100,"Picayune, MS",2013,159,7,166,54844,3.02676682955291
38100,"Picayune, MS",2014,169,8,177,55134,3.21036021329851
38100,"Picayune, MS",2015,178,3,181,54947,3.29408338944801
38100,"Picayune, MS",2016,202,18,220,55037,3.99731089994004
38100,"Picayune, MS",2017,236,13,249,55239,4.50768478792158
38100,"Picayune, MS",2018,245,11,256,55387,4.62202321844476
38180,"Pierre, SD",1990,38,28,66,18858,3.49984091632199
38180,"Pierre, SD",1991,42,24,66,18880,3.49576271186441
38180,"Pierre, SD",1992,77,50,127,19227,6.605294637749
38180,"Pierre, SD",1993,128,103,231,19456,11.8729440789474
38180,"Pierre, SD",1994,87,65,152,19726,7.70556625773091
38180,"Pierre, SD",1995,64,17,81,19892,4.07198873919164
38180,"Pierre, SD",1996,43,14,57,20002,2.84971502849715
38180,"Pierre, SD",1997,48,10,58,19842,2.92309243019857
38180,"Pierre, SD",1998,49,51,100,19750,5.06329113924051
38180,"Pierre, SD",1999,60,16,76,19882,3.82255306307213
38180,"Pierre, SD",2000,66,8,74,20827,3.55308013636145
38180,"Pierre, SD",2001,95,0,95,20629,4.60516748267003
38180,"Pierre, SD",2002,71,11,82,20691,3.96307573341066
38180,"Pierre, SD",2003,85,10,95,20714,4.58627015545042
38180,"Pierre, SD",2004,77,0,77,20826,3.69730145011044
38180,"Pierre, SD",2005,100,12,112,20911,5.35603271005691
38180,"Pierre, SD",2006,67,4,71,20984,3.38353030880671
38180,"Pierre, SD",2007,52,0,52,21110,2.46328754144955
38180,"Pierre, SD",2008,43,0,43,20929,2.05456543552009
38180,"Pierre, SD",2009,51,32,83,21140,3.92620624408704
38180,"Pierre, SD",2010,44,0,44,21420,2.05415499533147
38180,"Pierre, SD",2011,59,14,73,21659,3.37042338058082
38180,"Pierre, SD",2012,61,63,124,21836,5.67869573181901
38180,"Pierre, SD",2013,51,26,77,21840,3.52564102564103
38180,"Pierre, SD",2014,62,83,145,22009,6.58821391249035
38180,"Pierre, SD",2015,67,11,78,21928,3.55709595038307
38180,"Pierre, SD",2016,53,0,53,22018,2.40712144608956
38180,"Pierre, SD",2017,50,12,62,22073,2.80886150500612
38180,"Pierre, SD",2018,46,0,46,22064,2.08484408992023
38220,"Pine Bluff, AR",1990,97,12,109,106863,1.01999756697828
38220,"Pine Bluff, AR",1991,82,16,98,106792,0.91767173571054
38220,"Pine Bluff, AR",1992,79,84,163,106734,1.52716097963161
38220,"Pine Bluff, AR",1993,83,46,129,106054,1.21636147622909
38220,"Pine Bluff, AR",1994,101,30,131,106184,1.23370752655767
38220,"Pine Bluff, AR",1995,111,40,151,105740,1.42803101948175
38220,"Pine Bluff, AR",1996,107,56,163,105369,1.54694454725773
38220,"Pine Bluff, AR",1997,113,118,231,105021,2.1995600879824
38220,"Pine Bluff, AR",1998,132,88,220,104388,2.10752193738744
38220,"Pine Bluff, AR",1999,153,32,185,103844,1.78151843149339
38220,"Pine Bluff, AR",2000,118,30,148,107184,1.38080310494104
38220,"Pine Bluff, AR",2001,141,7,148,106464,1.39014126840998
38220,"Pine Bluff, AR",2002,120,32,152,105965,1.43443589864578
38220,"Pine Bluff, AR",2003,126,88,214,105465,2.02910918314133
38220,"Pine Bluff, AR",2004,88,52,140,104665,1.33760091721206
38220,"Pine Bluff, AR",2005,116,53,169,103917,1.62629791083268
38220,"Pine Bluff, AR",2006,92,9,101,103121,0.979431929480901
38220,"Pine Bluff, AR",2007,95,74,169,101921,1.65814699620294
38220,"Pine Bluff, AR",2008,61,70,131,101305,1.29312472237303
38220,"Pine Bluff, AR",2009,53,36,89,100593,0.884753412265267
38220,"Pine Bluff, AR",2010,46,80,126,100107,1.2586532410321
38220,"Pine Bluff, AR",2011,37,32,69,99044,0.696660070271798
38220,"Pine Bluff, AR",2012,35,96,131,97431,1.34454126510043
38220,"Pine Bluff, AR",2013,101,36,137,95779,1.43037617849424
38220,"Pine Bluff, AR",2014,39,16,55,94897,0.579575750550597
38220,"Pine Bluff, AR",2015,21,10,31,94018,0.32972409538599
38220,"Pine Bluff, AR",2016,32,14,46,92373,0.497981011767508
38220,"Pine Bluff, AR",2017,36,38,74,90923,0.813875477052011
38220,"Pine Bluff, AR",2018,20,10,30,89515,0.335139362118081
38240,"Pinehurst-Southern Pines, NC",1990,465,20,485,59323,8.17558114053571
38240,"Pinehurst-Southern Pines, NC",1991,373,4,377,60304,6.25165826479172
38240,"Pinehurst-Southern Pines, NC",1992,630,2,632,61795,10.2273646735173
38240,"Pinehurst-Southern Pines, NC",1993,617,8,625,63383,9.86068819715065
38240,"Pinehurst-Southern Pines, NC",1994,709,26,735,65590,11.2059765208111
38240,"Pinehurst-Southern Pines, NC",1995,673,6,679,67122,10.1159083459968
38240,"Pinehurst-Southern Pines, NC",1996,696,45,741,68495,10.8183079056865
38240,"Pinehurst-Southern Pines, NC",1997,684,24,708,70019,10.1115411531156
38240,"Pinehurst-Southern Pines, NC",1998,833,107,940,71236,13.1955752709304
38240,"Pinehurst-Southern Pines, NC",1999,721,188,909,72714,12.5010314382375
38240,"Pinehurst-Southern Pines, NC",2000,601,71,672,75177,8.93890418612075
38240,"Pinehurst-Southern Pines, NC",2001,601,36,637,76259,8.3531124195177
38240,"Pinehurst-Southern Pines, NC",2002,597,68,665,77521,8.5783207130971
38240,"Pinehurst-Southern Pines, NC",2003,625,244,869,78333,11.0936642283584
38240,"Pinehurst-Southern Pines, NC",2004,782,75,857,79475,10.7832651777288
38240,"Pinehurst-Southern Pines, NC",2005,989,86,1075,80841,13.2977078462661
38240,"Pinehurst-Southern Pines, NC",2006,965,66,1031,82838,12.4459788985731
38240,"Pinehurst-Southern Pines, NC",2007,784,48,832,84795,9.81189928651454
38240,"Pinehurst-Southern Pines, NC",2008,408,32,440,86122,5.10903137409721
38240,"Pinehurst-Southern Pines, NC",2009,312,22,334,87244,3.8283434964009
38240,"Pinehurst-Southern Pines, NC",2010,366,0,366,88587,4.13153171458566
38240,"Pinehurst-Southern Pines, NC",2011,396,0,396,89247,4.43712393693906
38240,"Pinehurst-Southern Pines, NC",2012,414,12,426,90186,4.72357128600891
38240,"Pinehurst-Southern Pines, NC",2013,490,50,540,91369,5.91010080005253
38240,"Pinehurst-Southern Pines, NC",2014,608,0,608,92825,6.54995960140048
38240,"Pinehurst-Southern Pines, NC",2015,560,2,562,94014,5.97783308868892
38240,"Pinehurst-Southern Pines, NC",2016,731,0,731,95392,7.66311640389131
38240,"Pinehurst-Southern Pines, NC",2017,712,8,720,97232,7.40496955734738
38240,"Pinehurst-Southern Pines, NC",2018,762,0,762,98682,7.72177296771448
38260,"Pittsburg, KS",1990,21,35,56,35532,1.57604412923562
38260,"Pittsburg, KS",1991,44,45,89,35623,2.4983858742947
38260,"Pittsburg, KS",1992,76,22,98,35902,2.72965294412568
38260,"Pittsburg, KS",1993,82,35,117,36284,3.2245617903208
38260,"Pittsburg, KS",1994,117,56,173,36493,4.74063519031047
38260,"Pittsburg, KS",1995,106,99,205,36916,5.55314768663994
38260,"Pittsburg, KS",1996,89,71,160,36746,4.35421542480814
38260,"Pittsburg, KS",1997,79,8,87,36526,2.38186497289602
38260,"Pittsburg, KS",1998,72,6,78,36369,2.14468365916027
38260,"Pittsburg, KS",1999,89,2,91,36393,2.50048086170417
38260,"Pittsburg, KS",2000,75,71,146,38262,3.81579635147143
38260,"Pittsburg, KS",2001,124,81,205,38434,5.33381901441432
38260,"Pittsburg, KS",2002,113,68,181,38330,4.72214975215236
38260,"Pittsburg, KS",2003,176,28,204,38631,5.28073309000544
38260,"Pittsburg, KS",2004,101,6,107,38656,2.76800496688742
38260,"Pittsburg, KS",2005,119,22,141,38638,3.64925720793002
38260,"Pittsburg, KS",2006,100,58,158,38855,4.06640072062798
38260,"Pittsburg, KS",2007,93,138,231,38922,5.93494681671034
38260,"Pittsburg, KS",2008,49,42,91,38997,2.33351283432059
38260,"Pittsburg, KS",2009,47,14,61,38966,1.56546733049325
38260,"Pittsburg, KS",2010,39,8,47,39172,1.19983661799244
38260,"Pittsburg, KS",2011,41,18,59,39197,1.50521723601296
38260,"Pittsburg, KS",2012,70,24,94,39321,2.39058009714911
38260,"Pittsburg, KS",2013,58,14,72,39246,1.83458186821587
38260,"Pittsburg, KS",2014,57,78,135,39263,3.4383516287599
38260,"Pittsburg, KS",2015,55,4,59,39151,1.50698577303262
38260,"Pittsburg, KS",2016,55,4,59,39078,1.50980091099852
38260,"Pittsburg, KS",2017,56,2,58,39031,1.48599830903641
38260,"Pittsburg, KS",2018,95,2,97,39019,2.48596837438171
38300,"Pittsburgh, PA",1990,4955,926,5881,2468646,2.38227757240204
38300,"Pittsburgh, PA",1991,4713,1131,5844,2471783,2.36428521435741
38300,"Pittsburgh, PA",1992,5544,646,6190,2476641,2.49935295426346
38300,"Pittsburgh, PA",1993,5904,679,6583,2477431,2.65718803066564
38300,"Pittsburgh, PA",1994,6078,782,6860,2469423,2.77797687961925
38300,"Pittsburgh, PA",1995,4906,641,5547,2458571,2.25618865593062
38300,"Pittsburgh, PA",1996,4810,917,5727,2445774,2.34159002426226
38300,"Pittsburgh, PA",1997,4525,1638,6163,2430968,2.53520408331167
38300,"Pittsburgh, PA",1998,4949,1562,6511,2416778,2.6940827829449
38300,"Pittsburgh, PA",1999,5220,1859,7079,2401849,2.947312674527
38300,"Pittsburgh, PA",2000,5227,1354,6581,2428303,2.71012307772136
38300,"Pittsburgh, PA",2001,4936,1945,6881,2417480,2.84635240001986
38300,"Pittsburgh, PA",2002,5277,1763,7040,2408348,2.92316558902617
38300,"Pittsburgh, PA",2003,5292,1221,6513,2401168,2.7124299507573
38300,"Pittsburgh, PA",2004,5548,1308,6856,2389107,2.86969147886637
38300,"Pittsburgh, PA",2005,4672,929,5601,2374483,2.35882926936095
38300,"Pittsburgh, PA",2006,4367,1266,5633,2364039,2.38278640919206
38300,"Pittsburgh, PA",2007,3844,836,4680,2358914,1.98396380707393
38300,"Pittsburgh, PA",2008,3383,391,3774,2356802,1.60132247002506
38300,"Pittsburgh, PA",2009,2681,352,3033,2355432,1.28766188113263
38300,"Pittsburgh, PA",2010,3398,217,3615,2357086,1.53367335769675
38300,"Pittsburgh, PA",2011,2654,260,2914,2360160,1.23466205680971
38300,"Pittsburgh, PA",2012,2918,548,3466,2360331,1.46843811312905
38300,"Pittsburgh, PA",2013,3251,1312,4563,2359764,1.93366794306549
38300,"Pittsburgh, PA",2014,3082,1108,4190,2356201,1.77828631767833
38300,"Pittsburgh, PA",2015,3293,1971,5264,2347907,2.24199680822111
38300,"Pittsburgh, PA",2016,3015,1388,4403,2340576,1.88116087663891
38300,"Pittsburgh, PA",2017,2988,1340,4328,2330283,1.85728514519481
38300,"Pittsburgh, PA",2018,2977,1060,4037,2324743,1.73653603860728
38340,"Pittsfield, MA",1990,297,80,377,139329,2.70582577927065
38340,"Pittsfield, MA",1991,276,42,318,138195,2.30109627699989
38340,"Pittsfield, MA",1992,330,6,336,136975,2.45300237269575
38340,"Pittsfield, MA",1993,281,14,295,135943,2.17002714372936
38340,"Pittsfield, MA",1994,301,10,311,135616,2.2932397357244
38340,"Pittsfield, MA",1995,277,4,281,134966,2.08200583850748
38340,"Pittsfield, MA",1996,266,134,400,134380,2.97663342759339
38340,"Pittsfield, MA",1997,226,126,352,133969,2.62747351999343
38340,"Pittsfield, MA",1998,262,8,270,132792,2.03325501536237
38340,"Pittsfield, MA",1999,270,57,327,131916,2.47885017738561
38340,"Pittsfield, MA",2000,265,49,314,134769,2.32991266537557
38340,"Pittsfield, MA",2001,281,76,357,133928,2.66561137327519
38340,"Pittsfield, MA",2002,333,126,459,133529,3.43745553400385
38340,"Pittsfield, MA",2003,371,46,417,133423,3.12539816973086
38340,"Pittsfield, MA",2004,434,46,480,133076,3.60696143557065
38340,"Pittsfield, MA",2005,445,41,486,132563,3.66618136282371
38340,"Pittsfield, MA",2006,352,0,352,131977,2.66713139410655
38340,"Pittsfield, MA",2007,264,34,298,131883,2.25957856585003
38340,"Pittsfield, MA",2008,156,159,315,131372,2.39777121456627
38340,"Pittsfield, MA",2009,126,47,173,131264,1.31795465626524
38340,"Pittsfield, MA",2010,125,14,139,131319,1.05849115512607
38340,"Pittsfield, MA",2011,97,25,122,130531,0.93464387769955
38340,"Pittsfield, MA",2012,89,0,89,130268,0.683206927257653
38340,"Pittsfield, MA",2013,99,0,99,129473,0.764638187112371
38340,"Pittsfield, MA",2014,137,40,177,128845,1.37374364546548
38340,"Pittsfield, MA",2015,106,108,214,127857,1.6737448868658
38340,"Pittsfield, MA",2016,95,96,191,127106,1.50268280018252
38340,"Pittsfield, MA",2017,90,104,194,126485,1.53377870893782
38340,"Pittsfield, MA",2018,87,175,262,126348,2.07363788900497
38380,"Plainview, TX",1990,11,0,11,34658,0.317387039067459
38380,"Plainview, TX",1991,7,0,7,34766,0.201346142783179
38380,"Plainview, TX",1992,11,3,14,35247,0.397196924560956
38380,"Plainview, TX",1993,22,12,34,35137,0.967640948288129
38380,"Plainview, TX",1994,46,2,48,35424,1.3550135501355
38380,"Plainview, TX",1995,29,0,29,36368,0.797404311482622
38380,"Plainview, TX",1996,40,0,40,36446,1.09751413049443
38380,"Plainview, TX",1997,45,0,45,36488,1.23328217496163
38380,"Plainview, TX",1998,47,2,49,36745,1.33351476391346
38380,"Plainview, TX",1999,16,0,16,36520,0.438116100766703
38380,"Plainview, TX",2000,24,100,124,36581,3.38973784204915
38380,"Plainview, TX",2001,18,0,18,35876,0.501728174824395
38380,"Plainview, TX",2002,14,0,14,35598,0.393280521377605
38380,"Plainview, TX",2003,17,0,17,35553,0.478159367704554
38380,"Plainview, TX",2004,19,0,19,36259,0.524007832538128
38380,"Plainview, TX",2005,86,0,86,36066,2.38451727388676
38380,"Plainview, TX",2006,21,0,21,36162,0.580720092915215
38380,"Plainview, TX",2007,4,0,4,36080,0.110864745011086
38380,"Plainview, TX",2008,8,0,8,35662,0.224328416802198
38380,"Plainview, TX",2009,11,0,11,35926,0.306184935701164
38380,"Plainview, TX",2010,13,0,13,36270,0.3584229390681
38380,"Plainview, TX",2011,5,0,5,36383,0.137426820218234
38380,"Plainview, TX",2012,8,0,8,36257,0.220647047466696
38380,"Plainview, TX",2013,12,0,12,35682,0.336304018833025
38380,"Plainview, TX",2014,8,0,8,34463,0.232133012216
38380,"Plainview, TX",2015,16,0,16,34066,0.469676510303528
38380,"Plainview, TX",2016,19,0,19,34163,0.556157246143489
38380,"Plainview, TX",2017,19,0,19,34044,0.558101280695571
38380,"Plainview, TX",2018,12,0,12,33830,0.354714750221697
38420,"Platteville, WI",1990,74,4,78,49323,1.58141232285141
38420,"Platteville, WI",1991,87,22,109,49083,2.22072815435079
38420,"Platteville, WI",1992,99,14,113,49300,2.2920892494929
38420,"Platteville, WI",1993,81,46,127,49414,2.57012182782207
38420,"Platteville, WI",1994,97,26,123,49537,2.48299251064861
38420,"Platteville, WI",1995,92,60,152,49345,3.080352619313
38420,"Platteville, WI",1996,101,10,111,49432,2.24550898203593
38420,"Platteville, WI",1997,174,53,227,49280,4.60633116883117
38420,"Platteville, WI",1998,133,53,186,49284,3.77404431458486
38420,"Platteville, WI",1999,152,47,199,49283,4.03790353671651
38420,"Platteville, WI",2000,143,16,159,49559,3.20829718113763
38420,"Platteville, WI",2001,127,12,139,49739,2.79458774804479
38420,"Platteville, WI",2002,105,8,113,49667,2.27515251575493
38420,"Platteville, WI",2003,124,0,124,49925,2.48372558838257
38420,"Platteville, WI",2004,131,8,139,50143,2.7720718744391
38420,"Platteville, WI",2005,117,32,149,50244,2.9655282222753
38420,"Platteville, WI",2006,102,32,134,50051,2.67726918543086
38420,"Platteville, WI",2007,76,49,125,50544,2.47309275087053
38420,"Platteville, WI",2008,62,162,224,50834,4.40649958689066
38420,"Platteville, WI",2009,64,10,74,50916,1.45337418493204
38420,"Platteville, WI",2010,71,22,93,51233,1.8152362734956
38420,"Platteville, WI",2011,34,62,96,51172,1.87602595169233
38420,"Platteville, WI",2012,111,62,173,50867,3.40102620559498
38420,"Platteville, WI",2013,61,10,71,50992,1.39237527455287
38420,"Platteville, WI",2014,70,12,82,51681,1.58665660494185
38420,"Platteville, WI",2015,109,46,155,52085,2.97590477104733
38420,"Platteville, WI",2016,73,20,93,52014,1.78798015918791
38420,"Platteville, WI",2017,71,24,95,51806,1.83376442883064
38420,"Platteville, WI",2018,76,24,100,51554,1.93971369825814
38460,"Plattsburgh, NY",1990,270,25,295,86152,3.42418051815396
38460,"Plattsburgh, NY",1991,269,9,278,86046,3.23083002115148
38460,"Plattsburgh, NY",1992,284,2,286,85483,3.34569446556625
38460,"Plattsburgh, NY",1993,241,0,241,86316,2.79206636081375
38460,"Plattsburgh, NY",1994,217,4,221,86309,2.56056726413236
38460,"Plattsburgh, NY",1995,171,41,212,82755,2.56177874448674
38460,"Plattsburgh, NY",1996,193,6,199,80257,2.47953449543342
38460,"Plattsburgh, NY",1997,193,5,198,79981,2.47558795213863
38460,"Plattsburgh, NY",1998,173,8,181,79690,2.27130129250847
38460,"Plattsburgh, NY",1999,193,48,241,79612,3.02718183188464
38460,"Plattsburgh, NY",2000,189,52,241,79891,3.0166101313039
38460,"Plattsburgh, NY",2001,245,28,273,80320,3.39890438247012
38460,"Plattsburgh, NY",2002,229,38,267,80707,3.30826322376002
38460,"Plattsburgh, NY",2003,243,14,257,81396,3.15740331220207
38460,"Plattsburgh, NY",2004,257,18,275,81803,3.36173489969806
38460,"Plattsburgh, NY",2005,263,62,325,82233,3.95218464606666
38460,"Plattsburgh, NY",2006,172,57,229,82547,2.77417713545011
38460,"Plattsburgh, NY",2007,155,61,216,82556,2.61640583361597
38460,"Plattsburgh, NY",2008,116,138,254,82401,3.08248686302351
38460,"Plattsburgh, NY",2009,93,67,160,82280,1.94457948468644
38460,"Plattsburgh, NY",2010,92,23,115,82095,1.40081612765698
38460,"Plattsburgh, NY",2011,68,26,94,81716,1.15032551764648
38460,"Plattsburgh, NY",2012,61,49,110,81708,1.34625740441572
38460,"Plattsburgh, NY",2013,94,12,106,81516,1.30035821188478
38460,"Plattsburgh, NY",2014,72,68,140,81460,1.71863491284066
38460,"Plattsburgh, NY",2015,103,42,145,80723,1.79626624382146
38460,"Plattsburgh, NY",2016,94,40,134,80524,1.66410014405643
38460,"Plattsburgh, NY",2017,89,75,164,80567,2.03557287723261
38460,"Plattsburgh, NY",2018,88,49,137,80695,1.69775079001177
38500,"Plymouth, IN",1990,152,39,191,42254,4.52028210346949
38500,"Plymouth, IN",1991,152,18,170,42870,3.9654770235596
38500,"Plymouth, IN",1992,150,0,150,43124,3.47834152676004
38500,"Plymouth, IN",1993,188,26,214,43531,4.91603684730422
38500,"Plymouth, IN",1994,270,38,308,44097,6.98460212712883
38500,"Plymouth, IN",1995,276,58,334,44648,7.48073821895718
38500,"Plymouth, IN",1996,255,61,316,45135,7.00121856652265
38500,"Plymouth, IN",1997,221,28,249,45337,5.49220283653528
38500,"Plymouth, IN",1998,232,24,256,45554,5.61970408745664
38500,"Plymouth, IN",1999,254,66,320,46113,6.93947476850346
38500,"Plymouth, IN",2000,224,62,286,45243,6.32141988815949
38500,"Plymouth, IN",2001,189,28,217,45534,4.76566960952256
38500,"Plymouth, IN",2002,149,26,175,45518,3.84463289248209
38500,"Plymouth, IN",2003,171,8,179,45923,3.8978289745879
38500,"Plymouth, IN",2004,162,12,174,46288,3.75907362599378
38500,"Plymouth, IN",2005,189,12,201,46549,4.31803046252336
38500,"Plymouth, IN",2006,122,18,140,46851,2.98819662333782
38500,"Plymouth, IN",2007,139,0,139,46871,2.96558639670585
38500,"Plymouth, IN",2008,109,0,109,47012,2.31855696417936
38500,"Plymouth, IN",2009,82,18,100,47126,2.12197088655944
38500,"Plymouth, IN",2010,82,6,88,46999,1.87238026340986
38500,"Plymouth, IN",2011,51,25,76,46935,1.61926067966336
38500,"Plymouth, IN",2012,48,2,50,46944,1.06509884117246
38500,"Plymouth, IN",2013,72,26,98,46919,2.08870606790426
38500,"Plymouth, IN",2014,83,0,83,46929,1.76862920582156
38500,"Plymouth, IN",2015,74,0,74,46740,1.58322635857938
38500,"Plymouth, IN",2016,85,0,85,46600,1.82403433476395
38500,"Plymouth, IN",2017,133,0,133,46460,2.86267757210504
38500,"Plymouth, IN",2018,67,0,67,46248,1.44871129562359
38540,"Pocatello, ID",1990,118,7,125,66237,1.88716276401407
38540,"Pocatello, ID",1991,168,4,172,67233,2.55826751743935
38540,"Pocatello, ID",1992,240,8,248,68978,3.59534924178724
38540,"Pocatello, ID",1993,328,59,387,70483,5.49068569726033
38540,"Pocatello, ID",1994,324,33,357,72084,4.95255535208923
38540,"Pocatello, ID",1995,239,91,330,73123,4.51294394376598
38540,"Pocatello, ID",1996,299,126,425,73452,5.78609159723357
38540,"Pocatello, ID",1997,263,110,373,73966,5.04285752913501
38540,"Pocatello, ID",1998,267,25,292,74103,3.94046124988192
38540,"Pocatello, ID",1999,254,54,308,74668,4.12492634060106
38540,"Pocatello, ID",2000,227,8,235,75728,3.10321149376717
38540,"Pocatello, ID",2001,248,37,285,76296,3.73545139981126
38540,"Pocatello, ID",2002,301,45,346,76487,4.52364454090238
38540,"Pocatello, ID",2003,384,17,401,76312,5.2547436838243
38540,"Pocatello, ID",2004,433,127,560,76834,7.28844001353567
38540,"Pocatello, ID",2005,521,128,649,77419,8.38295508854416
38540,"Pocatello, ID",2006,607,72,679,78491,8.65067332560421
38540,"Pocatello, ID",2007,302,14,316,79338,3.98295898560589
38540,"Pocatello, ID",2008,211,8,219,80609,2.71681822129043
38540,"Pocatello, ID",2009,152,0,152,81994,1.85379418006196
38540,"Pocatello, ID",2010,137,3,140,83019,1.68636095351666
38540,"Pocatello, ID",2011,75,0,75,83628,0.896828813316114
38540,"Pocatello, ID",2012,136,0,136,83744,1.62399694306458
38540,"Pocatello, ID",2013,162,0,162,83449,1.9413054680104
38540,"Pocatello, ID",2014,142,20,162,83534,1.93933009313573
38540,"Pocatello, ID",2015,168,22,190,84216,2.25610335328204
38540,"Pocatello, ID",2016,202,0,202,84794,2.3822440267
38540,"Pocatello, ID",2017,203,20,223,85641,2.60389299517754
38540,"Pocatello, ID",2018,372,32,404,87138,4.63632399182905
38580,"Point Pleasant, WV-OH",1990,19,0,19,56148,0.338391394172544
38580,"Point Pleasant, WV-OH",1991,8,6,14,56381,0.248310601089019
38580,"Point Pleasant, WV-OH",1992,10,0,10,57242,0.174696900876978
38580,"Point Pleasant, WV-OH",1993,14,4,18,57039,0.315573554936096
38580,"Point Pleasant, WV-OH",1994,22,4,26,57421,0.452796015395065
38580,"Point Pleasant, WV-OH",1995,11,0,11,58135,0.189214758751183
38580,"Point Pleasant, WV-OH",1996,22,2,24,58518,0.410130216343689
38580,"Point Pleasant, WV-OH",1997,16,4,20,59069,0.338587076131304
38580,"Point Pleasant, WV-OH",1998,12,6,18,59120,0.30446549391069
38580,"Point Pleasant, WV-OH",1999,12,0,12,59192,0.202730098661981
38580,"Point Pleasant, WV-OH",2000,15,2,17,57045,0.298010342711894
38580,"Point Pleasant, WV-OH",2001,9,0,9,57275,0.157136621562636
38580,"Point Pleasant, WV-OH",2002,13,0,13,57426,0.226378295545572
38580,"Point Pleasant, WV-OH",2003,18,0,18,57606,0.312467451307155
38580,"Point Pleasant, WV-OH",2004,9,4,13,57550,0.225890529973936
38580,"Point Pleasant, WV-OH",2005,6,0,6,57356,0.104609805425762
38580,"Point Pleasant, WV-OH",2006,5,0,5,57575,0.0868432479374729
38580,"Point Pleasant, WV-OH",2007,4,0,4,57715,0.0693060729446418
38580,"Point Pleasant, WV-OH",2008,2,3,5,58094,0.0860674079939409
38580,"Point Pleasant, WV-OH",2009,5,5,10,58166,0.171921741223395
38580,"Point Pleasant, WV-OH",2010,3,8,11,58441,0.18822402080731
38580,"Point Pleasant, WV-OH",2011,3,0,3,58338,0.0514244574719737
38580,"Point Pleasant, WV-OH",2012,6,0,6,58097,0.10327555639706
38580,"Point Pleasant, WV-OH",2013,6,0,6,57823,0.103764937827508
38580,"Point Pleasant, WV-OH",2014,4,0,4,57610,0.069432390210033
38580,"Point Pleasant, WV-OH",2015,6,0,6,57315,0.104684637529443
38580,"Point Pleasant, WV-OH",2016,14,0,14,57087,0.245239721828087
38580,"Point Pleasant, WV-OH",2017,6,2,8,56961,0.140446972489949
38580,"Point Pleasant, WV-OH",2018,10,2,12,56697,0.21165141012752
38620,"Ponca City, OK",1990,53,32,85,47975,1.77175612298072
38620,"Ponca City, OK",1991,60,0,60,48051,1.24867328463508
38620,"Ponca City, OK",1992,58,3,61,48567,1.25599687030288
38620,"Ponca City, OK",1993,57,0,57,48283,1.18053973448212
38620,"Ponca City, OK",1994,62,42,104,47673,2.18152832840392
38620,"Ponca City, OK",1995,49,5,54,47527,1.13619626738485
38620,"Ponca City, OK",1996,48,15,63,47124,1.33689839572193
38620,"Ponca City, OK",1997,52,15,67,46752,1.43309377138946
38620,"Ponca City, OK",1998,49,30,79,46560,1.696735395189
38620,"Ponca City, OK",1999,51,30,81,46400,1.74568965517241
38620,"Ponca City, OK",2000,43,35,78,47954,1.62655878550277
38620,"Ponca City, OK",2001,48,0,48,47518,1.01014352455911
38620,"Ponca City, OK",2002,32,0,32,47686,0.671056494568636
38620,"Ponca City, OK",2003,37,0,37,47363,0.781200515170069
38620,"Ponca City, OK",2004,35,0,35,46903,0.74622092403471
38620,"Ponca City, OK",2005,12,0,12,46469,0.25823667391164
38620,"Ponca City, OK",2006,38,25,63,46220,1.3630463003029
38620,"Ponca City, OK",2007,26,0,26,46461,0.55960913454295
38620,"Ponca City, OK",2008,19,0,19,46410,0.409394527041586
38620,"Ponca City, OK",2009,6,4,10,46814,0.213611312855129
38620,"Ponca City, OK",2010,7,4,11,46433,0.236900480261883
38620,"Ponca City, OK",2011,8,0,8,45861,0.17444015612394
38620,"Ponca City, OK",2012,16,0,16,45703,0.35008642758681
38620,"Ponca City, OK",2013,6,2,8,45566,0.175569503577229
38620,"Ponca City, OK",2014,23,48,71,45487,1.5608855277332
38620,"Ponca City, OK",2015,10,6,16,45274,0.353403719574149
38620,"Ponca City, OK",2016,7,2,9,44957,0.200191293903063
38620,"Ponca City, OK",2017,8,52,60,44522,1.34764835362293
38620,"Ponca City, OK",2018,6,0,6,44161,0.135866488530604
38700,"Pontiac, IL",1990,65,16,81,39355,2.05818828611358
38700,"Pontiac, IL",1991,59,10,69,39088,1.76524764633647
38700,"Pontiac, IL",1992,87,26,113,39562,2.85627622466003
38700,"Pontiac, IL",1993,85,27,112,39877,2.80863655741405
38700,"Pontiac, IL",1994,114,42,156,40056,3.89454763331336
38700,"Pontiac, IL",1995,113,92,205,40341,5.08167868917478
38700,"Pontiac, IL",1996,93,32,125,39614,3.15545009340132
38700,"Pontiac, IL",1997,82,48,130,39790,3.26715255089218
38700,"Pontiac, IL",1998,78,34,112,39629,2.82621312675061
38700,"Pontiac, IL",1999,70,6,76,39807,1.9092119476474
38700,"Pontiac, IL",2000,83,12,95,39751,2.38987698422681
38700,"Pontiac, IL",2001,69,0,69,39881,1.73014718788395
38700,"Pontiac, IL",2002,90,3,93,39519,2.35329841342139
38700,"Pontiac, IL",2003,83,4,87,39095,2.22534851003965
38700,"Pontiac, IL",2004,73,10,83,39145,2.12032188018904
38700,"Pontiac, IL",2005,83,16,99,39062,2.53443244073524
38700,"Pontiac, IL",2006,65,16,81,38978,2.07809533583047
38700,"Pontiac, IL",2007,49,88,137,39069,3.50661649901456
38700,"Pontiac, IL",2008,33,2,35,39071,0.895805072816155
38700,"Pontiac, IL",2009,24,4,28,39054,0.716956009627695
38700,"Pontiac, IL",2010,29,0,29,38856,0.746345480749434
38700,"Pontiac, IL",2011,22,2,24,38803,0.618508878179522
38700,"Pontiac, IL",2012,24,2,26,38510,0.675149311867048
38700,"Pontiac, IL",2013,28,4,32,37396,0.855706492673013
38700,"Pontiac, IL",2014,16,6,22,37040,0.593952483801296
38700,"Pontiac, IL",2015,16,2,18,36603,0.49176297024834
38700,"Pontiac, IL",2016,15,2,17,36100,0.470914127423823
38700,"Pontiac, IL",2017,20,20,40,36115,1.1075730305967
38700,"Pontiac, IL",2018,19,4,23,35761,0.643158748357149
38740,"Poplar Bluff, MO",1990,25,17,42,38850,1.08108108108108
38740,"Poplar Bluff, MO",1991,26,32,58,39315,1.47526389418797
38740,"Poplar Bluff, MO",1992,39,36,75,39555,1.89609404626469
38740,"Poplar Bluff, MO",1993,40,4,44,39933,1.10184559136554
38740,"Poplar Bluff, MO",1994,38,4,42,40015,1.0496063976009
38740,"Poplar Bluff, MO",1995,31,12,43,40132,1.07146416824479
38740,"Poplar Bluff, MO",1996,37,0,37,40329,0.91745394133254
38740,"Poplar Bluff, MO",1997,18,0,18,40380,0.445765230312036
38740,"Poplar Bluff, MO",1998,31,0,31,40479,0.765829195385262
38740,"Poplar Bluff, MO",1999,19,0,19,40447,0.469750537740747
38740,"Poplar Bluff, MO",2000,22,0,22,40826,0.538872287267917
38740,"Poplar Bluff, MO",2001,27,6,33,40837,0.808090702059407
38740,"Poplar Bluff, MO",2002,32,18,50,41068,1.21749293854096
38740,"Poplar Bluff, MO",2003,33,8,41,41131,0.996815054338577
38740,"Poplar Bluff, MO",2004,43,0,43,41476,1.03674414119009
38740,"Poplar Bluff, MO",2005,34,0,34,41995,0.809620192880105
38740,"Poplar Bluff, MO",2006,27,0,27,42246,0.63911376224968
38740,"Poplar Bluff, MO",2007,26,0,26,42109,0.617445201738346
38740,"Poplar Bluff, MO",2008,20,0,20,42351,0.472243866732781
38740,"Poplar Bluff, MO",2009,8,0,8,42683,0.187428250123
38740,"Poplar Bluff, MO",2010,24,0,24,42788,0.560904926614939
38740,"Poplar Bluff, MO",2011,23,0,23,42988,0.535033032474179
38740,"Poplar Bluff, MO",2012,17,11,28,42988,0.651344561272913
38740,"Poplar Bluff, MO",2013,7,16,23,42965,0.535319446060747
38740,"Poplar Bluff, MO",2014,7,18,25,42851,0.583416956430422
38740,"Poplar Bluff, MO",2015,4,52,56,42816,1.30792227204783
38740,"Poplar Bluff, MO",2016,1,0,1,42748,0.0233929072705156
38740,"Poplar Bluff, MO",2017,4,4,8,42609,0.187753760942524
38740,"Poplar Bluff, MO",2018,8,2,10,42639,0.234527076150942
38780,"Portales, NM",1990,12,25,37,16762,2.20737382173965
38780,"Portales, NM",1991,0,0,0,17159,0
38780,"Portales, NM",1996,6,4,10,18343,0.545167093714223
38780,"Portales, NM",1997,20,8,28,18148,1.54286973771214
38780,"Portales, NM",1998,16,0,16,17822,0.897766805072382
38780,"Portales, NM",1999,22,0,22,17402,1.26422250316056
38780,"Portales, NM",2000,13,2,15,18007,0.833009385239074
38780,"Portales, NM",2001,12,4,16,18377,0.870653534309191
38780,"Portales, NM",2002,14,36,50,18627,2.68427551403876
38780,"Portales, NM",2003,29,21,50,18722,2.67065484456789
38780,"Portales, NM",2004,17,28,45,18856,2.38650827322868
38780,"Portales, NM",2005,23,12,35,19093,1.83313256167182
38780,"Portales, NM",2006,38,27,65,19186,3.38788700093818
38780,"Portales, NM",2007,31,4,35,19359,1.80794462523891
38780,"Portales, NM",2008,48,0,48,19074,2.51651462724127
38780,"Portales, NM",2009,45,0,45,19192,2.34472696957065
38780,"Portales, NM",2010,51,0,51,20022,2.54719808210968
38780,"Portales, NM",2011,63,0,63,20432,3.08339859044636
38780,"Portales, NM",2012,42,0,42,20323,2.06662402204399
38780,"Portales, NM",2013,34,0,34,20028,1.69762332734172
38780,"Portales, NM",2014,20,0,20,19656,1.01750101750102
38780,"Portales, NM",2015,30,0,30,19140,1.56739811912226
38780,"Portales, NM",2016,17,0,17,19143,0.888053074230789
38780,"Portales, NM",2017,18,0,18,18905,0.952129066384554
38780,"Portales, NM",2018,21,0,21,18743,1.12041828949474
38820,"Port Angeles, WA",1990,500,26,526,56532,9.3044647279417
38820,"Port Angeles, WA",1991,398,50,448,57964,7.72893520115934
38820,"Port Angeles, WA",1992,371,34,405,59564,6.79940903901686
38820,"Port Angeles, WA",1993,426,42,468,60746,7.70421097685444
38820,"Port Angeles, WA",1994,370,140,510,61622,8.27626497030281
38820,"Port Angeles, WA",1995,384,88,472,62280,7.57867694283879
38820,"Port Angeles, WA",1996,372,96,468,63124,7.41397883530828
38820,"Port Angeles, WA",1997,366,101,467,63625,7.33988212180747
38820,"Port Angeles, WA",1998,342,22,364,64281,5.66263748230426
38820,"Port Angeles, WA",1999,337,39,376,64572,5.82295731896178
38820,"Port Angeles, WA",2000,371,8,379,64269,5.8970887986432
38820,"Port Angeles, WA",2001,329,15,344,64756,5.31224905800235
38820,"Port Angeles, WA",2002,396,8,404,65777,6.14196451647232
38820,"Port Angeles, WA",2003,483,71,554,66301,8.35583173707787
38820,"Port Angeles, WA",2004,573,16,589,67411,8.73744641082316
38820,"Port Angeles, WA",2005,666,153,819,68720,11.9179278230501
38820,"Port Angeles, WA",2006,422,4,426,69642,6.11699836305678
38820,"Port Angeles, WA",2007,419,313,732,70186,10.4294303707292
38820,"Port Angeles, WA",2008,255,34,289,70769,4.0837089686162
38820,"Port Angeles, WA",2009,149,8,157,71077,2.20887206832027
38820,"Port Angeles, WA",2010,139,30,169,71509,2.36333888042065
38820,"Port Angeles, WA",2011,114,40,154,71760,2.14604236343367
38820,"Port Angeles, WA",2012,168,0,168,71771,2.34077830878767
38820,"Port Angeles, WA",2013,122,0,122,72056,1.69312756744754
38820,"Port Angeles, WA",2014,160,0,160,72477,2.20759689280737
38820,"Port Angeles, WA",2015,215,2,217,73222,2.96359017781541
38820,"Port Angeles, WA",2016,243,4,247,74285,3.32503197146126
38820,"Port Angeles, WA",2017,287,20,307,75712,4.05483939137785
38820,"Port Angeles, WA",2018,320,16,336,76737,4.37859181359709
38840,"Port Clinton, OH",1990,153,0,153,40052,3.82003395585739
38840,"Port Clinton, OH",1991,159,0,159,40069,3.96815493274102
38840,"Port Clinton, OH",1992,171,10,181,40053,4.51901230869098
38840,"Port Clinton, OH",1993,193,11,204,40214,5.07286019794102
38840,"Port Clinton, OH",1994,211,6,217,40234,5.39344832728538
38840,"Port Clinton, OH",1995,214,8,222,40501,5.48134613960149
38840,"Port Clinton, OH",1996,219,6,225,40494,5.55637872277374
38840,"Port Clinton, OH",1997,220,8,228,40739,5.59660276393628
38840,"Port Clinton, OH",1998,237,8,245,40964,5.98086124401914
38840,"Port Clinton, OH",1999,241,12,253,41083,6.15826497578074
38840,"Port Clinton, OH",2000,239,4,243,40983,5.92928775345875
38840,"Port Clinton, OH",2001,228,17,245,41015,5.97342435694258
38840,"Port Clinton, OH",2002,240,18,258,41029,6.28823515074703
38840,"Port Clinton, OH",2003,247,12,259,41329,6.2667860340197
38840,"Port Clinton, OH",2004,243,12,255,41564,6.13511692811087
38840,"Port Clinton, OH",2005,328,8,336,41629,8.0712964519926
38840,"Port Clinton, OH",2006,291,9,300,41641,7.2044379337672
38840,"Port Clinton, OH",2007,207,69,276,41690,6.62029263612377
38840,"Port Clinton, OH",2008,133,0,133,41554,3.20065456995716
38840,"Port Clinton, OH",2009,87,37,124,41498,2.98809581184635
38840,"Port Clinton, OH",2010,120,16,136,41358,3.28836017215533
38840,"Port Clinton, OH",2011,79,0,79,41317,1.91204588910134
38840,"Port Clinton, OH",2012,114,0,114,41243,2.76410542395073
38840,"Port Clinton, OH",2013,111,6,117,41037,2.85108560567293
38840,"Port Clinton, OH",2014,89,5,94,40904,2.29806375904557
38840,"Port Clinton, OH",2015,88,50,138,40754,3.38617068263238
38840,"Port Clinton, OH",2016,135,0,135,40486,3.33448599515882
38840,"Port Clinton, OH",2017,114,0,114,40632,2.80567040756054
38840,"Port Clinton, OH",2018,114,54,168,40769,4.12077804213986
38860,"Portland-South Portland, ME",1990,1918,363,2281,442481,5.15502360553335
38860,"Portland-South Portland, ME",1991,1665,111,1776,443863,4.00123461518532
38860,"Portland-South Portland, ME",1992,2128,179,2307,444096,5.19482274102897
38860,"Portland-South Portland, ME",1993,1919,93,2012,445567,4.51559473659405
38860,"Portland-South Portland, ME",1994,2026,96,2122,448325,4.73317347906095
38860,"Portland-South Portland, ME",1995,1818,163,1981,450840,4.3940200514595
38860,"Portland-South Portland, ME",1996,2013,159,2172,455850,4.76472523856532
38860,"Portland-South Portland, ME",1997,2020,202,2222,460748,4.82259282731558
38860,"Portland-South Portland, ME",1998,2694,430,3124,464621,6.72375979561836
38860,"Portland-South Portland, ME",1999,2768,171,2939,469696,6.25723872462188
38860,"Portland-South Portland, ME",2000,3001,138,3139,489179,6.41687398682282
38860,"Portland-South Portland, ME",2001,2795,357,3152,494975,6.36799838375676
38860,"Portland-South Portland, ME",2002,3097,453,3550,500178,7.09747329950538
38860,"Portland-South Portland, ME",2003,3162,343,3505,504858,6.94254622091757
38860,"Portland-South Portland, ME",2004,3290,387,3677,508428,7.232095793308
38860,"Portland-South Portland, ME",2005,3188,592,3780,510287,7.40759611747899
38860,"Portland-South Portland, ME",2006,2750,452,3202,510614,6.27088172278864
38860,"Portland-South Portland, ME",2007,2124,548,2672,512265,5.21605028647282
38860,"Portland-South Portland, ME",2008,1114,145,1259,514191,2.44850648883392
38860,"Portland-South Portland, ME",2009,1123,84,1207,514728,2.34492780653083
38860,"Portland-South Portland, ME",2010,1225,35,1260,513904,2.45181979513684
38860,"Portland-South Portland, ME",2011,956,156,1112,516004,2.1550220540926
38860,"Portland-South Portland, ME",2012,1204,186,1390,517611,2.68541433624865
38860,"Portland-South Portland, ME",2013,1485,333,1818,520030,3.49595215660635
38860,"Portland-South Portland, ME",2014,1419,277,1696,524052,3.23632005984139
38860,"Portland-South Portland, ME",2015,1584,396,1980,525926,3.76478820214251
38860,"Portland-South Portland, ME",2016,1838,559,2397,528941,4.53169635176702
38860,"Portland-South Portland, ME",2017,1973,544,2517,532280,4.72871421056587
38860,"Portland-South Portland, ME",2018,1952,672,2624,535420,4.9008255201524
38900,"Portland-Vancouver-Hillsboro, OR-WA",1990,9212,6926,16138,1534825,10.5145537764892
38900,"Portland-Vancouver-Hillsboro, OR-WA",1991,7578,2904,10482,1578868,6.63893371706818
38900,"Portland-Vancouver-Hillsboro, OR-WA",1992,9003,2890,11893,1614848,7.36477984305644
38900,"Portland-Vancouver-Hillsboro, OR-WA",1993,10719,3092,13811,1653559,8.35228739948197
38900,"Portland-Vancouver-Hillsboro, OR-WA",1994,11286,5814,17100,1686679,10.1382657873846
38900,"Portland-Vancouver-Hillsboro, OR-WA",1995,11027,7081,18108,1722026,10.515520671581
38900,"Portland-Vancouver-Hillsboro, OR-WA",1996,11260,7055,18315,1763901,10.3832357938456
38900,"Portland-Vancouver-Hillsboro, OR-WA",1997,11386,8394,19780,1800631,10.985038022782
38900,"Portland-Vancouver-Hillsboro, OR-WA",1998,11376,6581,17957,1829937,9.81290612736941
38900,"Portland-Vancouver-Hillsboro, OR-WA",1999,10638,4484,15122,1854538,8.15405238393605
38900,"Portland-Vancouver-Hillsboro, OR-WA",2000,9760,3238,12998,1934792,6.71803480684229
38900,"Portland-Vancouver-Hillsboro, OR-WA",2001,10689,3185,13874,1971152,7.03852366534899
38900,"Portland-Vancouver-Hillsboro, OR-WA",2002,10467,3911,14378,2002918,7.17852652979303
38900,"Portland-Vancouver-Hillsboro, OR-WA",2003,10576,5427,16003,2024115,7.90617133907905
38900,"Portland-Vancouver-Hillsboro, OR-WA",2004,11285,4574,15859,2039297,7.77669951949128
38900,"Portland-Vancouver-Hillsboro, OR-WA",2005,12789,4462,17251,2067325,8.34459990567521
38900,"Portland-Vancouver-Hillsboro, OR-WA",2006,10210,5166,15376,2103164,7.31088968810801
38900,"Portland-Vancouver-Hillsboro, OR-WA",2007,8410,4705,13115,2137828,6.13473113833293
38900,"Portland-Vancouver-Hillsboro, OR-WA",2008,4285,3123,7408,2172853,3.40934246357209
38900,"Portland-Vancouver-Hillsboro, OR-WA",2009,3011,1009,4020,2206737,1.82169420279807
38900,"Portland-Vancouver-Hillsboro, OR-WA",2010,3359,1117,4476,2232205,2.00519217544984
38900,"Portland-Vancouver-Hillsboro, OR-WA",2011,3132,2081,5213,2262637,2.30394888795684
38900,"Portland-Vancouver-Hillsboro, OR-WA",2012,4501,3284,7785,2288535,3.40173954079793
38900,"Portland-Vancouver-Hillsboro, OR-WA",2013,5717,6013,11730,2311294,5.07507915479381
38900,"Portland-Vancouver-Hillsboro, OR-WA",2014,5462,6894,12356,2344562,5.27006750088076
38900,"Portland-Vancouver-Hillsboro, OR-WA",2015,7102,6865,13967,2382370,5.86264937856001
38900,"Portland-Vancouver-Hillsboro, OR-WA",2016,7397,7332,14729,2427459,6.06766169892056
38900,"Portland-Vancouver-Hillsboro, OR-WA",2017,6211,9772,15983,2456462,6.50651221146511
38900,"Portland-Vancouver-Hillsboro, OR-WA",2018,6869,7311,14180,2478810,5.72048684651103
38920,"Port Lavaca, TX",1990,39,0,39,19061,2.0460626409947
38920,"Port Lavaca, TX",1991,38,54,92,19430,4.73494595985589
38920,"Port Lavaca, TX",1992,55,58,113,20055,5.6345051109449
38920,"Port Lavaca, TX",1993,34,0,34,20365,1.66953105818807
38920,"Port Lavaca, TX",1994,49,0,49,20540,2.38558909444985
38920,"Port Lavaca, TX",1995,71,0,71,20507,3.4622324084459
38920,"Port Lavaca, TX",1996,148,0,148,20624,7.17610550814585
38920,"Port Lavaca, TX",1997,49,0,49,20650,2.3728813559322
38920,"Port Lavaca, TX",1998,48,0,48,20595,2.3306627822287
38920,"Port Lavaca, TX",1999,55,0,55,20457,2.6885662609375802
38920,"Port Lavaca, TX",2000,64,4,68,20676,3.28883729928419
38920,"Port Lavaca, TX",2001,77,3,80,20762,3.85319333397553
38920,"Port Lavaca, TX",2002,109,2,111,20550,5.4014598540146
38920,"Port Lavaca, TX",2003,125,2,127,20575,6.17253948967193
38920,"Port Lavaca, TX",2004,135,20,155,20692,7.4908177073265
38920,"Port Lavaca, TX",2005,115,3,118,20715,5.69635529809317
38920,"Port Lavaca, TX",2006,96,0,96,20839,4.60674696482557
38920,"Port Lavaca, TX",2007,82,2,84,20888,4.02144772117962
38920,"Port Lavaca, TX",2008,86,0,86,21127,4.07062053296729
38920,"Port Lavaca, TX",2009,60,0,60,21388,2.80531138956424
38920,"Port Lavaca, TX",2010,56,0,56,21313,2.62750434007413
38920,"Port Lavaca, TX",2011,65,0,65,21358,3.04335611948684
38920,"Port Lavaca, TX",2012,64,8,72,21578,3.33673185652053
38920,"Port Lavaca, TX",2013,100,94,194,21735,8.92569588221762
38920,"Port Lavaca, TX",2014,74,7,81,21821,3.71202053068145
38920,"Port Lavaca, TX",2015,69,12,81,21906,3.69761709120789
38920,"Port Lavaca, TX",2016,60,0,60,21977,2.73012695090322
38920,"Port Lavaca, TX",2017,64,12,76,21770,3.49104271933854
38920,"Port Lavaca, TX",2018,57,0,57,21561,2.64366216780298
38940,"Port St. Lucie, FL",1990,3101,677,3778,254298,14.8565855806967
38940,"Port St. Lucie, FL",1991,2055,525,2580,261061,9.88274771030525
38940,"Port St. Lucie, FL",1992,2124,661,2785,265888,10.4743350583704
38940,"Port St. Lucie, FL",1993,2225,881,3106,271574,11.4370300544235
38940,"Port St. Lucie, FL",1994,2311,939,3250,277426,11.7148356678898
38940,"Port St. Lucie, FL",1995,2078,713,2791,281018,9.93174814424699
38940,"Port St. Lucie, FL",1996,2439,821,3260,286374,11.3837150020602
38940,"Port St. Lucie, FL",1997,2285,791,3076,291223,10.5623525614392
38940,"Port St. Lucie, FL",1998,2403,1063,3466,295329,11.7360638474379
38940,"Port St. Lucie, FL",1999,2699,648,3347,298312,11.2197967228942
38940,"Port St. Lucie, FL",2000,2745,732,3477,320819,10.8378867835134
38940,"Port St. Lucie, FL",2001,3093,983,4076,328315,12.4149064160943
38940,"Port St. Lucie, FL",2002,4744,1288,6032,338741,17.8071151705876
38940,"Port St. Lucie, FL",2003,8195,1495,9690,351522,27.5658422516941
38940,"Port St. Lucie, FL",2004,8856,1700,10556,368277,28.6632073140598
38940,"Port St. Lucie, FL",2005,9112,1670,10782,383877,28.0871216561555
38940,"Port St. Lucie, FL",2006,5572,756,6328,397053,15.9374189339962
38940,"Port St. Lucie, FL",2007,2008,401,2409,410402,5.86985443540723
38940,"Port St. Lucie, FL",2008,858,395,1253,417520,3.00105384173213
38940,"Port St. Lucie, FL",2009,360,24,384,419850,0.914612361557699
38940,"Port St. Lucie, FL",2010,432,60,492,425186,1.15714063962595
38940,"Port St. Lucie, FL",2011,471,68,539,428285,1.25850776935919
38940,"Port St. Lucie, FL",2012,578,57,635,431957,1.4700537322002
38940,"Port St. Lucie, FL",2013,1061,56,1117,436514,2.55890990896054
38940,"Port St. Lucie, FL",2014,1048,346,1394,443299,3.14460443177178
38940,"Port St. Lucie, FL",2015,1268,333,1601,453066,3.53370149161491
38940,"Port St. Lucie, FL",2016,1696,241,1937,464263,4.17220411706296
38940,"Port St. Lucie, FL",2017,2087,200,2287,473192,4.83313327359719
38940,"Port St. Lucie, FL",2018,2974,996,3970,482040,8.23583105136503
39020,"Portsmouth, OH",1990,8,4,12,80389,0.149274154424113
39020,"Portsmouth, OH",1991,14,2,16,80165,0.199588349030125
39020,"Portsmouth, OH",1992,41,24,65,80879,0.803669679397619
39020,"Portsmouth, OH",1993,17,0,17,80619,0.210868405710813
39020,"Portsmouth, OH",1994,8,0,8,80900,0.0988875154511743
39020,"Portsmouth, OH",1995,5,0,5,80992,0.0617344922955354
39020,"Portsmouth, OH",1996,4,0,4,80954,0.0494107764903525
39020,"Portsmouth, OH",1997,6,0,6,81092,0.0739900360084842
39020,"Portsmouth, OH",1998,5,0,5,80682,0.0619716913313998
39020,"Portsmouth, OH",1999,5,0,5,80254,0.0623021905450196
39020,"Portsmouth, OH",2000,4,2,6,79168,0.0757881972514147
39020,"Portsmouth, OH",2001,5,51,56,78784,0.710804224207961
39020,"Portsmouth, OH",2002,5,52,57,78652,0.724711386868738
39020,"Portsmouth, OH",2003,6,60,66,78278,0.843148777434273
39020,"Portsmouth, OH",2004,8,35,43,77788,0.552784491181159
39020,"Portsmouth, OH",2005,5,54,59,77926,0.757128557862588
39020,"Portsmouth, OH",2006,3,51,54,78285,0.689787315577697
39020,"Portsmouth, OH",2007,2,40,42,78775,0.533164074896858
39020,"Portsmouth, OH",2008,1,45,46,79133,0.581299836983307
39020,"Portsmouth, OH",2009,1,35,36,79241,0.454310268674045
39020,"Portsmouth, OH",2010,1,35,36,79502,0.452818797011396
39020,"Portsmouth, OH",2011,1,60,61,79240,0.769813225643614
39020,"Portsmouth, OH",2012,3,92,95,78622,1.20831319478009
39020,"Portsmouth, OH",2013,3,125,128,78143,1.63802259959305
39020,"Portsmouth, OH",2014,3,148,151,77321,1.95289766040274
39020,"Portsmouth, OH",2015,4,142,146,76849,1.89982953584302
39020,"Portsmouth, OH",2016,4,159,163,76315,2.13588416431894
39020,"Portsmouth, OH",2017,4,0,4,75898,0.0527023109963372
39020,"Portsmouth, OH",2018,4,0,4,75502,0.0529787290402903
39060,"Pottsville, PA",1990,213,20,233,152664,1.52622753235864
39060,"Pottsville, PA",1991,213,10,223,152668,1.46068593287395
39060,"Pottsville, PA",1992,207,59,266,154037,1.72685783285834
39060,"Pottsville, PA",1993,330,130,460,153690,2.99303793350251
39060,"Pottsville, PA",1994,348,0,348,152965,2.27503023567483
39060,"Pottsville, PA",1995,278,74,352,152860,2.30276069606176
39060,"Pottsville, PA",1996,290,81,371,151862,2.44300746730584
39060,"Pottsville, PA",1997,271,88,359,150588,2.38398809998141
39060,"Pottsville, PA",1998,269,51,320,149399,2.14191527386395
39060,"Pottsville, PA",1999,327,61,388,148200,2.61808367071525
39060,"Pottsville, PA",2000,289,63,352,149994,2.34676053708815
39060,"Pottsville, PA",2001,273,58,331,149175,2.21887045416457
39060,"Pottsville, PA",2002,367,59,426,148705,2.86473218788877
39060,"Pottsville, PA",2003,437,61,498,147792,3.36960051964924
39060,"Pottsville, PA",2004,567,72,639,147081,4.34454484263773
39060,"Pottsville, PA",2005,455,88,543,146976,3.69448073154801
39060,"Pottsville, PA",2006,411,73,484,148005,3.27015979189892
39060,"Pottsville, PA",2007,326,77,403,148387,2.71587133643783
39060,"Pottsville, PA",2008,230,88,318,148463,2.1419478253841
39060,"Pottsville, PA",2009,146,4,150,148358,1.01106782242953
39060,"Pottsville, PA",2010,186,2,188,148285,1.26782884310618
39060,"Pottsville, PA",2011,101,0,101,147519,0.684657569533416
39060,"Pottsville, PA",2012,104,2,106,147120,0.720500271886895
39060,"Pottsville, PA",2013,93,0,93,146665,0.634098114751304
39060,"Pottsville, PA",2014,134,0,134,145391,0.921652647000158
39060,"Pottsville, PA",2015,99,0,99,144129,0.686884665820203
39060,"Pottsville, PA",2016,96,0,96,143521,0.668891660453871
39060,"Pottsville, PA",2017,105,0,105,142666,0.735984747592278
39060,"Pottsville, PA",2018,93,12,105,142067,0.739087895148064
39140,"Prescott, AZ",1990,1180,106,1286,108625,11.8388952819333
39140,"Prescott, AZ",1991,1110,159,1269,112120,11.3182304673564
39140,"Prescott, AZ",1992,1369,189,1558,116551,13.3675386740569
39140,"Prescott, AZ",1993,1796,371,2167,122311,17.7171309203588
39140,"Prescott, AZ",1994,2221,606,2827,128067,22.0743829401797
39140,"Prescott, AZ",1995,1690,501,2191,134789,16.2550356483096
39140,"Prescott, AZ",1996,1899,370,2269,140068,16.199274638033
39140,"Prescott, AZ",1997,1646,369,2015,144316,13.9624158097508
39140,"Prescott, AZ",1998,2150,418,2568,148735,17.2656066157932
39140,"Prescott, AZ",1999,2016,468,2484,152612,16.2765706497523
39140,"Prescott, AZ",2000,2032,195,2227,168608,13.2081514518884
39140,"Prescott, AZ",2001,2125,187,2312,172636,13.3923399522695
39140,"Prescott, AZ",2002,2542,722,3264,177362,18.4030401100574
39140,"Prescott, AZ",2003,2641,343,2984,182090,16.3875006864737
39140,"Prescott, AZ",2004,3666,337,4003,187822,21.3127322677855
39140,"Prescott, AZ",2005,4329,110,4439,195424,22.7147126248567
39140,"Prescott, AZ",2006,2869,118,2987,204082,14.6362736547074
39140,"Prescott, AZ",2007,1416,45,1461,208773,6.99803135462919
39140,"Prescott, AZ",2008,604,183,787,211211,3.726131688217
39140,"Prescott, AZ",2009,348,140,488,211172,2.31091243157237
39140,"Prescott, AZ",2010,237,102,339,210983,1.60676452605186
39140,"Prescott, AZ",2011,290,12,302,211023,1.43112362159575
39140,"Prescott, AZ",2012,444,8,452,211977,2.13230680687056
39140,"Prescott, AZ",2013,841,20,861,214426,4.01537127027506
39140,"Prescott, AZ",2014,948,20,968,217739,4.44568956411116
39140,"Prescott, AZ",2015,1120,257,1377,220845,6.23514229436935
39140,"Prescott, AZ",2016,1366,236,1602,224591,7.1329661473523
39140,"Prescott, AZ",2017,1493,483,1976,228055,8.66457652759203
39140,"Prescott, AZ",2018,1696,383,2079,231993,8.96147728595259
39220,"Price, UT",1990,16,0,16,20155,0.793847680476309
39220,"Price, UT",1991,18,0,18,20194,0.891353867485392
39220,"Price, UT",1992,23,0,23,20262,1.13512979962491
39220,"Price, UT",1993,29,3,32,20091,1.59275297396844
39220,"Price, UT",1994,37,0,37,20306,1.8221215404314
39220,"Price, UT",1995,32,0,32,20480,1.5625
39220,"Price, UT",1996,36,0,36,20716,1.73778721760958
39220,"Price, UT",1997,34,2,36,20914,1.72133499091518
39220,"Price, UT",1998,48,0,48,21028,2.28267072474796
39220,"Price, UT",1999,55,72,127,20905,6.07510165032289
39220,"Price, UT",2000,32,84,116,20491,5.66102191205895
39220,"Price, UT",2001,31,24,55,19937,2.75868987310027
39220,"Price, UT",2002,34,0,34,20114,1.69036491995625
39220,"Price, UT",2003,38,2,40,20146,1.98550580760449
39220,"Price, UT",2004,35,0,35,20026,1.74772795366024
39220,"Price, UT",2005,51,0,51,19870,2.56668344237544
39220,"Price, UT",2006,47,0,47,20072,2.34157034675169
39220,"Price, UT",2007,74,0,74,20554,3.6002724530505
39220,"Price, UT",2008,34,4,38,20596,1.8450184501845
39220,"Price, UT",2009,35,0,35,21143,1.65539422030932
39220,"Price, UT",2010,39,0,39,21403,1.82217446152409
39220,"Price, UT",2011,34,0,34,21303,1.59601933999906
39220,"Price, UT",2012,31,15,46,21221,2.16766410630979
39220,"Price, UT",2013,23,30,53,20901,2.53576383905076
39220,"Price, UT",2014,22,44,66,20634,3.19860424542018
39220,"Price, UT",2015,22,0,22,20385,1.07922492028452
39220,"Price, UT",2016,18,0,18,20323,0.885696009447424
39220,"Price, UT",2017,15,4,19,20168,0.942086473621579
39220,"Price, UT",2018,23,0,23,20269,1.13473777690069
39260,"Prineville, OR",1990,82,7,89,14238,6.25087793229386
39260,"Prineville, OR",1991,79,18,97,14706,6.59594723242214
39260,"Prineville, OR",1992,71,8,79,15107,5.22936387105315
39260,"Prineville, OR",1993,96,13,109,15595,6.98941968579673
39260,"Prineville, OR",1994,110,24,134,15948,8.40230749937296
39260,"Prineville, OR",1995,102,4,106,16350,6.48318042813456
39260,"Prineville, OR",1996,113,4,117,16628,7.03632427231176
39260,"Prineville, OR",1997,132,12,144,16924,8.50862680217443
39260,"Prineville, OR",1998,144,2,146,17301,8.43881856540084
39260,"Prineville, OR",1999,140,0,140,17649,7.93246076264944
39260,"Prineville, OR",2000,201,4,205,19262,10.6427162288444
39260,"Prineville, OR",2001,201,5,206,19705,10.4541994417661
39260,"Prineville, OR",2002,156,58,214,19779,10.8195560948481
39260,"Prineville, OR",2003,214,10,224,20011,11.1938433861376
39260,"Prineville, OR",2004,279,20,299,20643,14.4843288281742
39260,"Prineville, OR",2005,337,14,351,21019,16.6991769351539
39260,"Prineville, OR",2006,338,51,389,21673,17.9485996401052
39260,"Prineville, OR",2007,163,14,177,21818,8.11256760473004
39260,"Prineville, OR",2008,71,0,71,21811,3.25523818256843
39260,"Prineville, OR",2009,51,0,51,21410,2.38206445586175
39260,"Prineville, OR",2010,61,0,61,20885,2.92075652382092
39260,"Prineville, OR",2011,57,0,57,20636,2.7621632099244
39260,"Prineville, OR",2012,52,0,52,20606,2.52353683393186
39260,"Prineville, OR",2013,85,0,85,20700,4.10628019323672
39260,"Prineville, OR",2014,85,0,85,20957,4.05592403492866
39260,"Prineville, OR",2015,90,0,90,21459,4.19404445687124
39260,"Prineville, OR",2016,110,0,110,22313,4.92986151570833
39260,"Prineville, OR",2017,128,0,128,23091,5.54328526265645
39260,"Prineville, OR",2018,305,0,305,23867,12.7791511291742
39300,"Providence-Warwick, RI-MA",1990,3577,993,4570,1511570,3.02334658666155
39300,"Providence-Warwick, RI-MA",1991,3369,404,3773,1510994,2.49703175525515
39300,"Providence-Warwick, RI-MA",1992,4014,285,4299,1507570,2.85160888051633
39300,"Providence-Warwick, RI-MA",1993,4195,265,4460,1506723,2.96006631610455
39300,"Providence-Warwick, RI-MA",1994,4166,318,4484,1504155,2.98107575349615
39300,"Providence-Warwick, RI-MA",1995,3465,364,3829,1501443,2.55021336141299
39300,"Providence-Warwick, RI-MA",1996,3590,547,4137,1500773,2.75657944272718
39300,"Providence-Warwick, RI-MA",1997,3797,447,4244,1501413,2.82667060961907
39300,"Providence-Warwick, RI-MA",1998,4206,307,4513,1504208,3.00024996543031
39300,"Providence-Warwick, RI-MA",1999,4385,821,5206,1510636,3.44623059426626
39300,"Providence-Warwick, RI-MA",2000,3782,464,4246,1586085,2.67703181103156
39300,"Providence-Warwick, RI-MA",2001,3522,380,3902,1595424,2.44574483021441
39300,"Providence-Warwick, RI-MA",2002,3722,829,4551,1608716,2.82896421742557
39300,"Providence-Warwick, RI-MA",2003,3338,697,4035,1617623,2.49440073490548
39300,"Providence-Warwick, RI-MA",2004,3403,1007,4410,1620567,2.72126977779999
39300,"Providence-Warwick, RI-MA",2005,3202,1451,4653,1613353,2.88405575221294
39300,"Providence-Warwick, RI-MA",2006,2831,854,3685,1607583,2.2922611149782
39300,"Providence-Warwick, RI-MA",2007,2241,844,3085,1602603,1.92499327656319
39300,"Providence-Warwick, RI-MA",2008,1368,230,1598,1601459,0.99784009456377
39300,"Providence-Warwick, RI-MA",2009,1158,279,1437,1600970,0.897580841614771
39300,"Providence-Warwick, RI-MA",2010,1205,234,1439,1603115,0.897627431594115
39300,"Providence-Warwick, RI-MA",2011,963,215,1178,1602828,0.734950974153184
39300,"Providence-Warwick, RI-MA",2012,1144,217,1361,1605752,0.847577957243709
39300,"Providence-Warwick, RI-MA",2013,1465,509,1974,1607576,1.22793572434523
39300,"Providence-Warwick, RI-MA",2014,1441,334,1775,1611223,1.1016476304025
39300,"Providence-Warwick, RI-MA",2015,1482,336,1818,1613051,1.12705673906157
39300,"Providence-Warwick, RI-MA",2016,1662,902,2564,1614911,1.58770359481111
39300,"Providence-Warwick, RI-MA",2017,1722,288,2010,1617057,1.24299885532792
39300,"Providence-Warwick, RI-MA",2018,1553,410,1963,1621337,1.21072916981479
39340,"Provo-Orem, UT",1990,988,321,1309,270442,4.84022452133914
39340,"Provo-Orem, UT",1991,1318,345,1663,277556,5.99158368041044
39340,"Provo-Orem, UT",1992,2020,671,2691,287342,9.36514675891446
39340,"Provo-Orem, UT",1993,2674,777,3451,298095,11.5768463073852
39340,"Provo-Orem, UT",1994,2786,1029,3815,309602,12.3222718199495
39340,"Provo-Orem, UT",1995,2973,1481,4454,318439,13.9869802379734
39340,"Provo-Orem, UT",1996,2649,1371,4020,329325,12.2067866089729
39340,"Provo-Orem, UT",1997,2448,872,3320,337934,9.82440358176449
39340,"Provo-Orem, UT",1998,3090,1091,4181,349482,11.9634201475326
39340,"Provo-Orem, UT",1999,3529,685,4214,356297,11.8272115678774
39340,"Provo-Orem, UT",2000,3278,538,3816,380079,10.0400179962587
39340,"Provo-Orem, UT",2001,3166,747,3913,394059,9.9299851037535
39340,"Provo-Orem, UT",2002,2998,805,3803,405672,9.37456861701079
39340,"Provo-Orem, UT",2003,3324,1017,4341,414780,10.4657890930132
39340,"Provo-Orem, UT",2004,3602,959,4561,425023,10.7311839594563
39340,"Provo-Orem, UT",2005,4690,706,5396,439623,12.2741530811627
39340,"Provo-Orem, UT",2006,5464,1022,6486,457471,14.1779478917789
39340,"Provo-Orem, UT",2007,3882,616,4498,479181,9.38684964554104
39340,"Provo-Orem, UT",2008,1067,258,1325,497639,2.66257266813895
39340,"Provo-Orem, UT",2009,1260,264,1524,515010,2.95916584143997
39340,"Provo-Orem, UT",2010,1553,432,1985,530257,3.74346779014704
39340,"Provo-Orem, UT",2011,1452,480,1932,540969,3.57136915423989
39340,"Provo-Orem, UT",2012,2226,213,2439,549998,4.43456158022393
39340,"Provo-Orem, UT",2013,2675,748,3423,561594,6.0951505892157
39340,"Provo-Orem, UT",2014,2679,2616,5295,571160,9.27060718537713
39340,"Provo-Orem, UT",2015,3098,1451,4549,583191,7.80018896039205
39340,"Provo-Orem, UT",2016,4429,888,5317,601067,8.84593564444563
39340,"Provo-Orem, UT",2017,5090,2155,7245,617751,11.7280263407101
39340,"Provo-Orem, UT",2018,5516,1325,6841,633768,10.794170737557
39380,"Pueblo, CO",1990,188,36,224,123060,1.82025028441411
39380,"Pueblo, CO",1991,190,0,190,123073,1.54379920859977
39380,"Pueblo, CO",1992,238,8,246,123709,1.98853761650325
39380,"Pueblo, CO",1993,379,14,393,125649,3.12776066661891
39380,"Pueblo, CO",1994,590,67,657,127467,5.15427522417567
39380,"Pueblo, CO",1995,820,118,938,129211,7.25944385539931
39380,"Pueblo, CO",1996,877,316,1193,130693,9.1282624165028
39380,"Pueblo, CO",1997,991,148,1139,132450,8.59947149867875
39380,"Pueblo, CO",1998,1111,240,1351,134974,10.0093351312105
39380,"Pueblo, CO",1999,1173,264,1437,137090,10.4821650010942
39380,"Pueblo, CO",2000,1028,70,1098,141800,7.74330042313117
39380,"Pueblo, CO",2001,1114,276,1390,144014,9.65183940450234
39380,"Pueblo, CO",2002,1075,228,1303,146537,8.89195220319783
39380,"Pueblo, CO",2003,1078,204,1282,147907,8.66760870006152
39380,"Pueblo, CO",2004,1100,120,1220,148654,8.20697727609079
39380,"Pueblo, CO",2005,1119,60,1179,149825,7.8691807108293
39380,"Pueblo, CO",2006,1202,102,1304,152026,8.57748016786602
39380,"Pueblo, CO",2007,663,14,677,155121,4.36433493853186
39380,"Pueblo, CO",2008,379,37,416,156748,2.65394135810345
39380,"Pueblo, CO",2009,184,193,377,157846,2.38840388733322
39380,"Pueblo, CO",2010,209,25,234,159466,1.4673974389525
39380,"Pueblo, CO",2011,114,4,118,160248,0.736358644101643
39380,"Pueblo, CO",2012,172,94,266,160810,1.65412598718985
39380,"Pueblo, CO",2013,158,0,158,161145,0.980483415557417
39380,"Pueblo, CO",2014,157,0,157,161480,0.97225662620758
39380,"Pueblo, CO",2015,200,82,282,163111,1.72888401150137
39380,"Pueblo, CO",2016,265,17,282,164877,1.71036590913226
39380,"Pueblo, CO",2017,352,16,368,166426,2.21119296263805
39380,"Pueblo, CO",2018,479,0,479,167529,2.85920646574623
39420,"Pullman, WA",1990,22,142,164,38803,4.22647733422674
39420,"Pullman, WA",1991,41,64,105,38506,2.72684776398483
39420,"Pullman, WA",1992,53,17,70,38466,1.81978890448708
39420,"Pullman, WA",1993,65,286,351,38693,9.07140826506086
39420,"Pullman, WA",1994,65,72,137,38932,3.51895612863454
39420,"Pullman, WA",1995,116,310,426,39292,10.8419016593709
39420,"Pullman, WA",1996,85,130,215,39067,5.50336601223539
39420,"Pullman, WA",1997,62,147,209,38503,5.42814845596447
39420,"Pullman, WA",1998,102,17,119,38776,3.06890860325975
39420,"Pullman, WA",1999,71,12,83,38838,2.13708223904423
39420,"Pullman, WA",2000,63,184,247,40754,6.06075477253767
39420,"Pullman, WA",2001,69,37,106,40814,2.59714803743813
39420,"Pullman, WA",2002,78,177,255,41484,6.14694822100087
39420,"Pullman, WA",2003,103,151,254,41442,6.12904782587713
39420,"Pullman, WA",2004,106,219,325,42158,7.70909435931496
39420,"Pullman, WA",2005,138,300,438,42836,10.2250443552152
39420,"Pullman, WA",2006,98,241,339,42827,7.9155672823219
39420,"Pullman, WA",2007,125,173,298,42608,6.99399173864063
39420,"Pullman, WA",2008,80,24,104,43802,2.37432080726907
39420,"Pullman, WA",2009,67,12,79,44705,1.76714014092383
39420,"Pullman, WA",2010,62,28,90,44794,2.00919766040095
39420,"Pullman, WA",2011,33,60,93,45048,2.06446457112413
39420,"Pullman, WA",2012,70,213,283,46636,6.06827343682992
39420,"Pullman, WA",2013,100,280,380,46793,8.12087278011668
39420,"Pullman, WA",2014,75,143,218,46916,4.64660243840055
39420,"Pullman, WA",2015,81,124,205,48128,4.25947473404255
39420,"Pullman, WA",2016,78,116,194,48784,3.97671367661528
39420,"Pullman, WA",2017,80,162,242,49344,4.90434500648508
39420,"Pullman, WA",2018,126,138,264,49791,5.30216304151353
39460,"Punta Gorda, FL",1990,1993,724,2717,112738,24.1001259557558
39460,"Punta Gorda, FL",1991,1347,77,1424,117378,12.1317453015045
39460,"Punta Gorda, FL",1992,1424,134,1558,120057,12.9771691779738
39460,"Punta Gorda, FL",1993,1366,109,1475,122945,11.997234535768
39460,"Punta Gorda, FL",1994,1331,255,1586,125841,12.6032056325045
39460,"Punta Gorda, FL",1995,941,32,973,128717,7.55921906197316
39460,"Punta Gorda, FL",1996,941,124,1065,130160,8.18223724646589
39460,"Punta Gorda, FL",1997,1096,59,1155,132100,8.74337623012869
39460,"Punta Gorda, FL",1998,1200,294,1494,134289,11.1252597010924
39460,"Punta Gorda, FL",1999,1197,221,1418,136467,10.3907904475075
39460,"Punta Gorda, FL",2000,1211,459,1670,142266,11.7385742201229
39460,"Punta Gorda, FL",2001,1529,597,2126,146311,14.5306914722748
39460,"Punta Gorda, FL",2002,1589,403,1992,150123,13.2691193221558
39460,"Punta Gorda, FL",2003,1953,569,2522,153235,16.4583809181975
39460,"Punta Gorda, FL",2004,2331,1321,3652,157755,23.1498209248518
39460,"Punta Gorda, FL",2005,2902,1792,4694,155262,30.2327678375907
39460,"Punta Gorda, FL",2006,3052,1283,4335,157099,27.594064889019
39460,"Punta Gorda, FL",2007,932,438,1370,159742,8.57632933104631
39460,"Punta Gorda, FL",2008,312,121,433,160467,2.69837412053569
39460,"Punta Gorda, FL",2009,286,10,296,159629,1.85429965733044
39460,"Punta Gorda, FL",2010,293,132,425,159867,2.65845984474595
39460,"Punta Gorda, FL",2011,302,10,312,159851,1.95181763016809
39460,"Punta Gorda, FL",2012,327,2,329,162749,2.02151779734438
39460,"Punta Gorda, FL",2013,549,4,553,164694,3.35774223711854
39460,"Punta Gorda, FL",2014,610,0,610,168075,3.62933214338837
39460,"Punta Gorda, FL",2015,947,182,1129,172437,6.54731873089882
39460,"Punta Gorda, FL",2016,657,8,665,177722,3.74179898943293
39460,"Punta Gorda, FL",2017,1251,46,1297,181537,7.14454904509824
39460,"Punta Gorda, FL",2018,1932,136,2068,184998,11.1784992270187
39500,"Quincy, IL-MO",1990,83,24,107,76291,1.40252454417952
39500,"Quincy, IL-MO",1991,75,53,128,76730,1.66818714974586
39500,"Quincy, IL-MO",1992,97,78,175,76745,2.2802788455274
39500,"Quincy, IL-MO",1993,105,72,177,77165,2.29378604289509
39500,"Quincy, IL-MO",1994,113,50,163,77731,2.09697546667353
39500,"Quincy, IL-MO",1995,104,40,144,77910,1.84828648440508
39500,"Quincy, IL-MO",1996,88,49,137,77759,1.76185393330676
39500,"Quincy, IL-MO",1997,98,47,145,77605,1.86843631209329
39500,"Quincy, IL-MO",1998,55,81,136,77466,1.75560891229701
39500,"Quincy, IL-MO",1999,68,26,94,77113,1.21899031291741
39500,"Quincy, IL-MO",2000,68,40,108,78683,1.37259636770332
39500,"Quincy, IL-MO",2001,89,91,180,78434,2.29492312007548
39500,"Quincy, IL-MO",2002,104,17,121,78184,1.54763122889594
39500,"Quincy, IL-MO",2003,121,32,153,77621,1.97111606395177
39500,"Quincy, IL-MO",2004,129,12,141,77137,1.82791656403542
39500,"Quincy, IL-MO",2005,130,0,130,77192,1.68411234324801
39500,"Quincy, IL-MO",2006,142,16,158,77392,2.04155468265454
39500,"Quincy, IL-MO",2007,69,56,125,77229,1.61856297504823
39500,"Quincy, IL-MO",2008,64,36,100,77139,1.29636111435201
39500,"Quincy, IL-MO",2009,59,69,128,77243,1.65710808746424
39500,"Quincy, IL-MO",2010,56,88,144,77369,1.86121056236994
39500,"Quincy, IL-MO",2011,53,2,55,77419,0.710419922757979
39500,"Quincy, IL-MO",2012,83,57,140,77253,1.8122273568664
39500,"Quincy, IL-MO",2013,47,0,47,77111,0.609510964713206
39500,"Quincy, IL-MO",2014,72,18,90,77071,1.16775440827289
39500,"Quincy, IL-MO",2015,69,0,69,76998,0.896127172134341
39500,"Quincy, IL-MO",2016,69,0,69,76598,0.900806809577274
39500,"Quincy, IL-MO",2017,65,16,81,76058,1.06497672828631
39500,"Quincy, IL-MO",2018,48,2,50,75546,0.661848410240119
39540,"Racine, WI",1990,486,380,866,175466,4.93542908597677
39540,"Racine, WI",1991,483,224,707,177619,3.98043002156301
39540,"Racine, WI",1992,589,362,951,179765,5.29024003560204
39540,"Racine, WI",1993,648,516,1164,181070,6.42845308444248
39540,"Racine, WI",1994,601,281,882,182409,4.8352877325132
39540,"Racine, WI",1995,507,324,831,183654,4.52481296350747
39540,"Racine, WI",1996,634,296,930,184281,5.04664072801862
39540,"Racine, WI",1997,670,294,964,185020,5.2102475408064
39540,"Racine, WI",1998,670,372,1042,185862,5.60631005800002
39540,"Racine, WI",1999,667,243,910,186311,4.88430634798804
39540,"Racine, WI",2000,536,331,867,188904,4.58963282937365
39540,"Racine, WI",2001,578,220,798,189047,4.22117251265558
39540,"Racine, WI",2002,642,309,951,189833,5.00966639098576
39540,"Racine, WI",2003,876,312,1188,190845,6.22494694647489
39540,"Racine, WI",2004,939,339,1278,191808,6.66291291291291
39540,"Racine, WI",2005,810,196,1006,193251,5.20566517120222
39540,"Racine, WI",2006,484,322,806,193915,4.15646030477271
39540,"Racine, WI",2007,508,124,632,194395,3.25111242573111
39540,"Racine, WI",2008,271,6,277,194730,1.42248241154419
39540,"Racine, WI",2009,194,149,343,195130,1.75780249064726
39540,"Racine, WI",2010,156,84,240,195405,1.22821831580563
39540,"Racine, WI",2011,99,8,107,194892,0.549022022453461
39540,"Racine, WI",2012,143,20,163,194608,0.837581188851435
39540,"Racine, WI",2013,182,28,210,194703,1.07856581562688
39540,"Racine, WI",2014,159,48,207,194833,1.06244835320505
39540,"Racine, WI",2015,189,28,217,194710,1.11447794155411
39540,"Racine, WI",2016,222,136,358,194913,1.83671689420408
39540,"Racine, WI",2017,244,34,278,195949,1.41873650796891
39540,"Racine, WI",2018,282,97,379,196584,1.92792902779473
39580,"Raleigh, NC",1990,4057,1034,5091,548239,9.28609602746248
39580,"Raleigh, NC",1991,4765,805,5570,564836,9.86126946582725
39580,"Raleigh, NC",1992,6429,598,7027,582632,12.0607862252674
39580,"Raleigh, NC",1993,7343,836,8179,603407,13.5546985699536
39580,"Raleigh, NC",1994,7984,3444,11428,625686,18.264752607538
39580,"Raleigh, NC",1995,7548,2808,10356,650289,15.9252270913394
39580,"Raleigh, NC",1996,8491,2238,10729,674650,15.9030608463648
39580,"Raleigh, NC",1997,9435,2482,11917,697661,17.0813618648599
39580,"Raleigh, NC",1998,10906,3495,14401,721896,19.9488568990547
39580,"Raleigh, NC",1999,11239,4853,16092,744123,21.6254570816921
39580,"Raleigh, NC",2000,9519,4683,14202,804157,17.6607304295057
39580,"Raleigh, NC",2001,10681,3101,13782,833100,16.5430320489737
39580,"Raleigh, NC",2002,10581,1097,11678,859117,13.5930263281951
39580,"Raleigh, NC",2003,10357,2303,12660,883333,14.3320808800305
39580,"Raleigh, NC",2004,12083,2321,14404,909510,15.8370990973161
39580,"Raleigh, NC",2005,13967,647,14614,944725,15.4690518404827
39580,"Raleigh, NC",2006,13521,4191,17712,989219,17.9050341734237
39580,"Raleigh, NC",2007,12764,3850,16614,1034476,16.0603049273255
39580,"Raleigh, NC",2008,6572,4825,11397,1077163,10.5805713712781
39580,"Raleigh, NC",2009,4377,517,4894,1110061,4.40876672543221
39580,"Raleigh, NC",2010,4653,560,5213,1137381,4.58333663038155
39580,"Raleigh, NC",2011,4753,1613,6366,1162096,5.47803279591359
39580,"Raleigh, NC",2012,6425,6501,12926,1187686,10.8833479556044
39580,"Raleigh, NC",2013,8034,3397,11431,1213328,9.42119525800113
39580,"Raleigh, NC",2014,7680,3967,11647,1241236,9.38338881566439
39580,"Raleigh, NC",2015,8694,3293,11987,1271196,9.42970242197112
39580,"Raleigh, NC",2016,9442,4072,13514,1303845,10.3647289363383
39580,"Raleigh, NC",2017,10752,3428,14180,1334342,10.6269607042273
39580,"Raleigh, NC",2018,11160,4790,15950,1362540,11.706078353663
39660,"Rapid City, SD",1990,329,848,1177,109756,10.7237873100332
39660,"Rapid City, SD",1991,270,49,319,112147,2.84448090452709
39660,"Rapid City, SD",1992,435,84,519,114072,4.54975804754892
39660,"Rapid City, SD",1993,494,146,640,115216,5.55478405776975
39660,"Rapid City, SD",1994,480,329,809,115777,6.98757093377787
39660,"Rapid City, SD",1995,402,373,775,116456,6.6548739438071
39660,"Rapid City, SD",1996,419,83,502,116045,4.32590805291051
39660,"Rapid City, SD",1997,400,141,541,115729,4.67471420300875
39660,"Rapid City, SD",1998,413,288,701,115909,6.047847880665
39660,"Rapid City, SD",1999,506,102,608,116575,5.21552648509543
39660,"Rapid City, SD",2000,575,23,598,120469,4.9639326299712
39660,"Rapid City, SD",2001,703,39,742,121692,6.0973605495842
39660,"Rapid City, SD",2002,826,254,1080,122822,8.79321294230675
39660,"Rapid City, SD",2003,873,100,973,123278,7.89273025195087
39660,"Rapid City, SD",2004,1131,387,1518,125419,12.1034293049697
39660,"Rapid City, SD",2005,1056,234,1290,125998,10.238257750123
39660,"Rapid City, SD",2006,789,273,1062,127471,8.33130672858925
39660,"Rapid City, SD",2007,693,336,1029,128918,7.98181789975023
39660,"Rapid City, SD",2008,557,18,575,131119,4.38532935730138
39660,"Rapid City, SD",2009,468,28,496,133254,3.72221471775707
39660,"Rapid City, SD",2010,472,204,676,135002,5.00733322469297
39660,"Rapid City, SD",2011,362,102,464,136234,3.40590454658896
39660,"Rapid City, SD",2012,562,194,756,138384,5.4630593132154
39660,"Rapid City, SD",2013,643,429,1072,140719,7.61801888870728
39660,"Rapid City, SD",2014,524,147,671,142658,4.70355675812082
39660,"Rapid City, SD",2015,572,226,798,143284,5.56935875603696
39660,"Rapid City, SD",2016,540,431,971,144897,6.70131196643133
39660,"Rapid City, SD",2017,560,219,779,146869,5.30404646317467
39660,"Rapid City, SD",2018,532,302,834,148749,5.6067603815824
39700,"Raymondville, TX",1990,38,0,38,17689,2.14822771213749
39700,"Raymondville, TX",1991,11,0,11,17921,0.613805033201272
39700,"Raymondville, TX",1992,17,0,17,18238,0.932119749972585
39700,"Raymondville, TX",1993,12,0,12,18743,0.640239022568426
39700,"Raymondville, TX",1994,53,0,53,18949,2.7969813710486
39700,"Raymondville, TX",1995,67,6,73,19153,3.81141335561009
39700,"Raymondville, TX",1996,66,0,66,19313,3.41738725210998
39700,"Raymondville, TX",1997,48,0,48,19497,2.46191721803354
39700,"Raymondville, TX",1998,19,0,19,19545,0.97211563059606
39700,"Raymondville, TX",1999,57,0,57,19575,2.91187739463602
39700,"Raymondville, TX",2000,42,0,42,20076,2.09205020920502
39700,"Raymondville, TX",2001,49,0,49,20016,2.4480415667466
39700,"Raymondville, TX",2002,86,72,158,20198,7.82255668878107
39700,"Raymondville, TX",2003,64,72,136,20418,6.66078949946126
39700,"Raymondville, TX",2004,33,2,35,20767,1.6853662059999
39700,"Raymondville, TX",2005,36,0,36,21229,1.69579349003721
39700,"Raymondville, TX",2006,42,0,42,21463,1.95685598471789
39700,"Raymondville, TX",2007,30,4,34,21576,1.57582499073044
39700,"Raymondville, TX",2008,34,0,34,21763,1.56228461149658
39700,"Raymondville, TX",2009,25,0,25,21862,1.14353673039978
39700,"Raymondville, TX",2010,16,0,16,22227,0.719845233274846
39700,"Raymondville, TX",2011,19,0,19,22171,0.856975328131343
39700,"Raymondville, TX",2012,37,0,37,22219,1.6652414600117
39700,"Raymondville, TX",2013,46,0,46,22043,2.08683028625868
39700,"Raymondville, TX",2014,98,0,98,21966,4.46144040790312
39700,"Raymondville, TX",2015,54,80,134,21902,6.11816272486531
39700,"Raymondville, TX",2016,37,0,37,21813,1.69623618942832
39700,"Raymondville, TX",2017,10,0,10,21574,0.463520904792806
39700,"Raymondville, TX",2018,43,0,43,21515,1.99860562398327
39740,"Reading, PA",1990,1171,230,1401,337493,4.15119721001621
39740,"Reading, PA",1991,1407,75,1482,341019,4.34579891442999
39740,"Reading, PA",1992,1466,313,1779,343111,5.18491100547636
39740,"Reading, PA",1993,1590,132,1722,345901,4.97830304046534
39740,"Reading, PA",1994,1718,48,1766,348441,5.06828989699834
39740,"Reading, PA",1995,1358,20,1378,350168,3.93525393525394
39740,"Reading, PA",1996,1435,118,1553,351962,4.41240815769884
39740,"Reading, PA",1997,1534,173,1707,353909,4.82327377941787
39740,"Reading, PA",1998,1576,202,1778,355823,4.99686641954005
39740,"Reading, PA",1999,1561,228,1789,358217,4.9941795057186
39740,"Reading, PA",2000,1583,226,1809,374546,4.82984733517378
39740,"Reading, PA",2001,1691,340,2031,377487,5.3803177327961
39740,"Reading, PA",2002,1754,367,2121,381338,5.56199487069214
39740,"Reading, PA",2003,1566,425,1991,385846,5.16008977675031
39740,"Reading, PA",2004,1493,147,1640,390848,4.19600458490257
39740,"Reading, PA",2005,1273,95,1368,395933,3.45513003462707
39740,"Reading, PA",2006,1063,110,1173,401834,2.91911585381028
39740,"Reading, PA",2007,1009,279,1288,405223,3.17849677831712
39740,"Reading, PA",2008,614,45,659,407737,1.61623791806974
39740,"Reading, PA",2009,372,28,400,409904,0.9758382450525
39740,"Reading, PA",2010,350,65,415,412025,1.00722043565318
39740,"Reading, PA",2011,267,39,306,412966,0.740981097717488
39740,"Reading, PA",2012,253,36,289,413515,0.698886376552241
39740,"Reading, PA",2013,344,156,500,413935,1.20791911773588
39740,"Reading, PA",2014,322,136,458,414593,1.1046978603112
39740,"Reading, PA",2015,343,73,416,415193,1.00194367438757
39740,"Reading, PA",2016,366,70,436,415748,1.04871220066002
39740,"Reading, PA",2017,399,12,411,417524,0.984374550924019
39740,"Reading, PA",2018,380,220,600,420152,1.42805460880824
39780,"Red Bluff, CA",1990,311,8,319,49873,6.3962464660237
39780,"Red Bluff, CA",1991,259,70,329,51000,6.45098039215686
39780,"Red Bluff, CA",1992,225,81,306,51812,5.90596772948352
39780,"Red Bluff, CA",1993,226,43,269,52142,5.15898891488627
39780,"Red Bluff, CA",1994,231,22,253,52942,4.77881455177364
39780,"Red Bluff, CA",1995,174,61,235,53775,4.37006043700604
39780,"Red Bluff, CA",1996,142,8,150,53852,2.78541186956845
39780,"Red Bluff, CA",1997,92,2,94,53784,1.74773166741038
39780,"Red Bluff, CA",1998,154,0,154,53949,2.85454781367588
39780,"Red Bluff, CA",1999,154,2,156,53897,2.89440970740486
39780,"Red Bluff, CA",2000,135,82,217,56170,3.86327220936443
39780,"Red Bluff, CA",2001,180,2,182,56685,3.21072594160713
39780,"Red Bluff, CA",2002,282,4,286,57380,4.98431509236668
39780,"Red Bluff, CA",2003,417,7,424,58528,7.24439584472389
39780,"Red Bluff, CA",2004,706,9,715,59571,12.0024844303436
39780,"Red Bluff, CA",2005,667,18,685,60602,11.3032573182403
39780,"Red Bluff, CA",2006,385,140,525,61587,8.52452627989673
39780,"Red Bluff, CA",2007,225,22,247,62147,3.97444768049946
39780,"Red Bluff, CA",2008,102,54,156,62648,2.49010343506576
39780,"Red Bluff, CA",2009,62,0,62,62891,0.985832631060088
39780,"Red Bluff, CA",2010,77,0,77,63565,1.21135845197829
39780,"Red Bluff, CA",2011,48,0,48,63336,0.757862826828344
39780,"Red Bluff, CA",2012,58,0,58,63227,0.917329621838771
39780,"Red Bluff, CA",2013,70,0,70,62898,1.11291297020573
39780,"Red Bluff, CA",2014,76,2,78,62788,1.24227559406256
39780,"Red Bluff, CA",2015,73,0,73,63090,1.157077191314
39780,"Red Bluff, CA",2016,92,0,92,63352,1.45220356105569
39780,"Red Bluff, CA",2017,101,14,115,63718,1.80482752126558
39780,"Red Bluff, CA",2018,128,16,144,63916,2.25295700607047
39820,"Redding, CA",1990,1855,513,2368,148666,15.9283225485316
39820,"Redding, CA",1991,1086,142,1228,154058,7.97102390008958
39820,"Redding, CA",1992,1048,43,1091,157371,6.93266230754078
39820,"Redding, CA",1993,1054,189,1243,158567,7.83895766458343
39820,"Redding, CA",1994,876,92,968,159717,6.06071989832015
39820,"Redding, CA",1995,642,131,773,160560,4.81439960139512
39820,"Redding, CA",1996,577,133,710,161367,4.39990828360198
39820,"Redding, CA",1997,609,55,664,162669,4.08190866114625
39820,"Redding, CA",1998,629,65,694,164228,4.22583237937502
39820,"Redding, CA",1999,744,60,804,164452,4.88896456108773
39820,"Redding, CA",2000,791,179,970,163615,5.92855178314947
39820,"Redding, CA",2001,1018,6,1024,166408,6.15355031008125
39820,"Redding, CA",2002,1160,181,1341,170198,7.8790585083256
39820,"Redding, CA",2003,1065,293,1358,173202,7.84055611367074
39820,"Redding, CA",2004,887,151,1038,174867,5.93593988574174
39820,"Redding, CA",2005,1326,240,1566,175615,8.91723372149304
39820,"Redding, CA",2006,733,219,952,176166,5.40399396024204
39820,"Redding, CA",2007,545,167,712,176548,4.03289756893309
39820,"Redding, CA",2008,358,172,530,177247,2.99017754884427
39820,"Redding, CA",2009,217,26,243,177279,1.37072072834346
39820,"Redding, CA",2010,167,86,253,177277,1.42714508932349
39820,"Redding, CA",2011,97,41,138,177572,0.777149550604825
39820,"Redding, CA",2012,192,13,205,177868,1.1525400859064
39820,"Redding, CA",2013,204,0,204,178401,1.14349134814267
39820,"Redding, CA",2014,240,2,242,178905,1.35267320645035
39820,"Redding, CA",2015,321,54,375,178361,2.10247755955618
39820,"Redding, CA",2016,349,51,400,178581,2.23987994243509
39820,"Redding, CA",2017,382,0,382,179539,2.12767142514997
39820,"Redding, CA",2018,306,0,306,180040,1.69962230615419
39860,"Red Wing, MN",1990,139,129,268,40815,6.56621340193556
39860,"Red Wing, MN",1991,162,52,214,41078,5.20960124640927
39860,"Red Wing, MN",1992,187,44,231,41214,5.60489154170913
39860,"Red Wing, MN",1993,209,72,281,41769,6.72747731571261
39860,"Red Wing, MN",1994,180,28,208,41930,4.96064870021464
39860,"Red Wing, MN",1995,191,12,203,42146,4.81658994922413
39860,"Red Wing, MN",1996,156,37,193,42320,4.56049149338374
39860,"Red Wing, MN",1997,163,8,171,42739,4.00102950466787
39860,"Red Wing, MN",1998,200,8,208,43099,4.8260980533191
39860,"Red Wing, MN",1999,175,65,240,43203,5.5551697798764
39860,"Red Wing, MN",2000,238,69,307,44154,6.95293744621099
39860,"Red Wing, MN",2001,308,26,334,44574,7.49315744604478
39860,"Red Wing, MN",2002,314,17,331,44927,7.36750728960313
39860,"Red Wing, MN",2003,379,6,385,45029,8.55004552621644
39860,"Red Wing, MN",2004,365,16,381,45329,8.40521520439454
39860,"Red Wing, MN",2005,284,65,349,45339,7.69756721586272
39860,"Red Wing, MN",2006,204,0,204,45598,4.47388043335234
39860,"Red Wing, MN",2007,144,0,144,45866,3.13958051715868
39860,"Red Wing, MN",2008,87,0,87,45919,1.89464056273002
39860,"Red Wing, MN",2009,50,0,50,46035,1.08613011838818
39860,"Red Wing, MN",2010,42,0,42,46214,0.908815510451378
39860,"Red Wing, MN",2011,39,0,39,46102,0.845950284152531
39860,"Red Wing, MN",2012,53,0,53,46146,1.14852858319248
39860,"Red Wing, MN",2013,56,0,56,46113,1.21440808448811
39860,"Red Wing, MN",2014,64,0,64,46021,1.3906694769779
39860,"Red Wing, MN",2015,72,0,72,46073,1.56273739500358
39860,"Red Wing, MN",2016,86,64,150,46252,3.24310300095131
39860,"Red Wing, MN",2017,93,4,97,46334,2.09349505762507
39860,"Red Wing, MN",2018,100,36,136,46403,2.93084498847057
39900,"Reno, NV",1990,1881,741,2622,258873,10.128518617237
39900,"Reno, NV",1991,1618,76,1694,265096,6.39013791230347
39900,"Reno, NV",1992,2003,117,2120,270674,7.83230011009554
39900,"Reno, NV",1993,2363,247,2610,277021,9.4216683933709
39900,"Reno, NV",1994,2834,641,3475,285485,12.1722682452668
39900,"Reno, NV",1995,2495,804,3299,292924,11.2623069465117
39900,"Reno, NV",1996,2916,1492,4408,301187,14.6354258317922
39900,"Reno, NV",1997,2851,811,3662,308729,11.8615355214444
39900,"Reno, NV",1998,3296,1604,4900,315520,15.5299188640974
39900,"Reno, NV",1999,3105,1351,4456,321945,13.8408734411157
39900,"Reno, NV",2000,3204,1370,4574,344782,13.2663538119739
39900,"Reno, NV",2001,3878,1076,4954,355341,13.9415378467444
39900,"Reno, NV",2002,3801,915,4716,365706,12.8956046660432
39900,"Reno, NV",2003,4265,768,5033,375713,13.3958633318517
39900,"Reno, NV",2004,5009,734,5743,386308,14.8663760522692
39900,"Reno, NV",2005,5158,1171,6329,396546,15.9603173402329
39900,"Reno, NV",2006,3345,325,3670,404366,9.075936156848
39900,"Reno, NV",2007,2022,88,2110,412724,5.1123753404212
39900,"Reno, NV",2008,938,986,1924,418892,4.59306933529406
39900,"Reno, NV",2009,497,276,773,421787,1.83267857947258
39900,"Reno, NV",2010,472,134,606,425956,1.42268215496436
39900,"Reno, NV",2011,534,22,556,427906,1.29935079199637
39900,"Reno, NV",2012,777,68,845,431291,1.95923402064963
39900,"Reno, NV",2013,1243,477,1720,435018,3.95385938053138
39900,"Reno, NV",2014,1507,709,2216,440296,5.03297781492451
39900,"Reno, NV",2015,2000,787,2787,446606,6.24039981549733
39900,"Reno, NV",2016,1868,1732,3600,454134,7.92717567942501
39900,"Reno, NV",2017,2091,2473,4564,461336,9.89300639880694
39900,"Reno, NV",2018,2255,2195,4450,469764,9.47284168220638
39940,"Rexburg, ID",1990,73,2,75,34698,2.16150786788864
39940,"Rexburg, ID",1991,111,119,230,34938,6.58309004522297
39940,"Rexburg, ID",1992,84,33,117,35594,3.28707085463842
39940,"Rexburg, ID",1993,152,30,182,36068,5.0460241765554
39940,"Rexburg, ID",1994,179,0,179,35960,4.97775305895439
39940,"Rexburg, ID",1995,161,37,198,36225,5.46583850931677
39940,"Rexburg, ID",1996,314,89,403,36065,11.1742686815472
39940,"Rexburg, ID",1997,179,9,188,36625,5.13310580204778
39940,"Rexburg, ID",1998,188,52,240,36911,6.50212673728699
39940,"Rexburg, ID",1999,156,62,218,36550,5.96443228454172
39940,"Rexburg, ID",2000,162,6,168,39288,4.27611484422725
39940,"Rexburg, ID",2001,193,171,364,39590,9.1942409699419
39940,"Rexburg, ID",2002,268,909,1177,40507,29.0567062483028
39940,"Rexburg, ID",2003,336,708,1044,42367,24.6418202846555
39940,"Rexburg, ID",2004,403,354,757,44630,16.96168496527
39940,"Rexburg, ID",2005,360,121,481,46417,10.3625826744512
39940,"Rexburg, ID",2006,373,9,382,47754,7.99932989906605
39940,"Rexburg, ID",2007,381,11,392,48776,8.03673938002296
39940,"Rexburg, ID",2008,265,24,289,49676,5.81769868749497
39940,"Rexburg, ID",2009,150,99,249,50294,4.95088877400883
39940,"Rexburg, ID",2010,88,213,301,50818,5.9230981148412
39940,"Rexburg, ID",2011,55,34,89,51012,1.74468752450404
39940,"Rexburg, ID",2012,106,8,114,50629,2.25167394181201
39940,"Rexburg, ID",2013,120,238,358,50411,7.10162464541469
39940,"Rexburg, ID",2014,149,302,451,50719,8.8921311540054
39940,"Rexburg, ID",2015,197,144,341,50794,6.7133913454345
39940,"Rexburg, ID",2016,221,293,514,51876,9.90824273267021
39940,"Rexburg, ID",2017,209,363,572,52488,10.8977290047249
39940,"Rexburg, ID",2018,247,700,947,52472,18.0477206891294
39980,"Richmond, IN",1990,110,25,135,71996,1.87510417245403
39980,"Richmond, IN",1991,76,63,139,72006,1.93039468933144
39980,"Richmond, IN",1992,100,4,104,72005,1.44434414276786
39980,"Richmond, IN",1993,281,8,289,72354,3.99425049064323
39980,"Richmond, IN",1994,338,34,372,72346,5.14195670804191
39980,"Richmond, IN",1995,334,45,379,72387,5.23574675010706
39980,"Richmond, IN",1996,369,10,379,72024,5.26213484394091
39980,"Richmond, IN",1997,383,12,395,71855,5.49718182450769
39980,"Richmond, IN",1998,363,52,415,71482,5.80565736828852
39980,"Richmond, IN",1999,157,6,163,71162,2.29054832635395
39980,"Richmond, IN",2000,142,4,146,71033,2.05538270944491
39980,"Richmond, IN",2001,126,0,126,70712,1.78187577780292
39980,"Richmond, IN",2002,117,33,150,70545,2.12630236019562
39980,"Richmond, IN",2003,131,7,138,70490,1.95772449992907
39980,"Richmond, IN",2004,161,50,211,70070,3.01127443984587
39980,"Richmond, IN",2005,132,27,159,69793,2.27816543206339
39980,"Richmond, IN",2006,81,4,85,69642,1.22052784239396
39980,"Richmond, IN",2007,70,16,86,69365,1.23981835219491
39980,"Richmond, IN",2008,52,2,54,69093,0.781555295037124
39980,"Richmond, IN",2009,29,0,29,68984,0.4203873361939
39980,"Richmond, IN",2010,88,61,149,68890,2.16286834083321
39980,"Richmond, IN",2011,33,0,33,68628,0.480853296030775
39980,"Richmond, IN",2012,24,0,24,68221,0.351797833511675
39980,"Richmond, IN",2013,26,0,26,67783,0.383577003083369
39980,"Richmond, IN",2014,22,63,85,67377,1.2615580984609
39980,"Richmond, IN",2015,41,63,104,66965,1.55305010079892
39980,"Richmond, IN",2016,35,72,107,66609,1.6063895269408
39980,"Richmond, IN",2017,41,74,115,66178,1.73773761673064
39980,"Richmond, IN",2018,43,79,122,65936,1.85027905848095
40060,"Richmond, VA",1990,6549,770,7319,919069,7.96349349178353
40060,"Richmond, VA",1991,5600,90,5690,930481,6.11511680517926
40060,"Richmond, VA",1992,5994,247,6241,944772,6.60582659096586
40060,"Richmond, VA",1993,6477,406,6883,956672,7.19473340915173
40060,"Richmond, VA",1994,6591,351,6942,967287,7.17677380136402
40060,"Richmond, VA",1995,5899,426,6325,977430,6.47105163541123
40060,"Richmond, VA",1996,5738,783,6521,986754,6.60853667682117
40060,"Richmond, VA",1997,5922,1866,7788,997685,7.80607105449115
40060,"Richmond, VA",1998,6678,1013,7691,1008088,7.62929426796073
40060,"Richmond, VA",1999,6839,1323,8162,1019458,8.00621506722199
40060,"Richmond, VA",2000,5966,217,6183,1058966,5.83871436854441
40060,"Richmond, VA",2001,6892,1613,8505,1070817,7.94253359817784
40060,"Richmond, VA",2002,7400,1771,9171,1084389,8.45729715074572
40060,"Richmond, VA",2003,7015,1563,8578,1098631,7.80789910352065
40060,"Richmond, VA",2004,7234,1370,8604,1115900,7.71036831257281
40060,"Richmond, VA",2005,7918,1063,8981,1135074,7.91225946502166
40060,"Richmond, VA",2006,6751,489,7240,1157286,6.25601623107857
40060,"Richmond, VA",2007,5319,1160,6479,1174344,5.51712275108486
40060,"Richmond, VA",2008,3554,1029,4583,1189113,3.8541332909488
40060,"Richmond, VA",2009,2448,614,3062,1200712,2.55015357554518
40060,"Richmond, VA",2010,2264,984,3248,1209896,2.68452825697415
40060,"Richmond, VA",2011,2205,357,2562,1218638,2.10234704645678
40060,"Richmond, VA",2012,2656,1431,4087,1232938,3.31484632641706
40060,"Richmond, VA",2013,3370,1450,4820,1244814,3.8720644208693
40060,"Richmond, VA",2014,3181,1131,4312,1257769,3.42829247659944
40060,"Richmond, VA",2015,3619,1256,4875,1269483,3.84014594917774
40060,"Richmond, VA",2016,4003,916,4919,1281314,3.83902774807736
40060,"Richmond, VA",2017,4614,2531,7145,1292911,5.5262891258563
40060,"Richmond, VA",2018,4498,1563,6061,1306172,4.64027708448811
40080,"Richmond-Berea, KY",1990,60,330,390,72507,5.37879101328148
40080,"Richmond-Berea, KY",1991,85,208,293,73481,3.98742532083124
40080,"Richmond-Berea, KY",1992,89,283,372,74487,4.99416005477466
40080,"Richmond-Berea, KY",1993,92,454,546,76145,7.17052991004006
40080,"Richmond-Berea, KY",1994,104,631,735,61913,11.8714971007704
40080,"Richmond-Berea, KY",1995,141,387,528,62894,8.3950774318695
40080,"Richmond-Berea, KY",1996,181,214,395,64242,6.1486255097911
40080,"Richmond-Berea, KY",1997,167,291,458,65466,6.99599792258577
40080,"Richmond-Berea, KY",1998,236,107,343,66439,5.16263038275712
40080,"Richmond-Berea, KY",1999,313,304,617,67636,9.12236087290792
40080,"Richmond-Berea, KY",2000,228,123,351,71309,4.92223982947454
40080,"Richmond-Berea, KY",2001,221,82,303,72571,4.17522150721363
40080,"Richmond-Berea, KY",2002,287,257,544,73634,7.38789146318277
40080,"Richmond-Berea, KY",2003,274,178,452,74998,6.02682738206352
40080,"Richmond-Berea, KY",2004,348,196,544,76673,7.09506605976028
40080,"Richmond-Berea, KY",2005,406,156,562,78732,7.13813951125337
40080,"Richmond-Berea, KY",2006,323,141,464,80264,5.78092295425097
40080,"Richmond-Berea, KY",2007,276,82,358,80659,4.43843836397674
40080,"Richmond-Berea, KY",2008,195,57,252,81521,3.09122802713411
40080,"Richmond-Berea, KY",2009,124,61,185,82299,2.24790094654856
40080,"Richmond-Berea, KY",2010,131,55,186,83469,2.22837221004205
40080,"Richmond-Berea, KY",2011,107,132,239,84776,2.819194111541
40080,"Richmond-Berea, KY",2012,112,106,218,85415,2.55224492185213
40080,"Richmond-Berea, KY",2013,123,84,207,85959,2.40812480368548
40080,"Richmond-Berea, KY",2014,120,105,225,87101,2.58320799990815
40080,"Richmond-Berea, KY",2015,132,144,276,88237,3.12793952650249
40080,"Richmond-Berea, KY",2016,192,151,343,89568,3.8294926759557
40080,"Richmond-Berea, KY",2017,171,77,248,91226,2.7185232280271
40080,"Richmond-Berea, KY",2018,205,124,329,92368,3.56183959812922
40100,"Rio Grande City, TX",1990,0,16,16,40871,0.391475618409141
40100,"Rio Grande City, TX",1991,0,13,13,42871,0.30323528725712
40100,"Rio Grande City, TX",1992,0,0,0,44839,0
40100,"Rio Grande City, TX",1993,0,0,0,47315,0
40100,"Rio Grande City, TX",1994,0,0,0,49749,0
40100,"Rio Grande City, TX",1995,0,0,0,51296,0
40100,"Rio Grande City, TX",1996,0,0,0,53095,0
40100,"Rio Grande City, TX",1997,0,0,0,54359,0
40100,"Rio Grande City, TX",1998,0,0,0,55377,0
40100,"Rio Grande City, TX",1999,0,0,0,56484,0
40100,"Rio Grande City, TX",2000,0,0,0,53733,0
40100,"Rio Grande City, TX",2001,0,0,0,54294,0
40100,"Rio Grande City, TX",2002,0,0,0,55412,0
40100,"Rio Grande City, TX",2003,0,0,0,56704,0
40100,"Rio Grande City, TX",2015,6,3,9,63595,0.141520559792437
40100,"Rio Grande City, TX",2016,4,0,4,64025,0.0624755954705193
40100,"Rio Grande City, TX",2017,0,2,2,64267,0.0311201705385346
40100,"Rio Grande City, TX",2018,0,2,2,64525,0.0309957380860132
40140,"Riverside-San Bernardino-Ontario, CA",1990,23126,5486,28612,2630703,10.8761802453565
40140,"Riverside-San Bernardino-Ontario, CA",1991,12840,3252,16092,2740350,5.87224259674859
40140,"Riverside-San Bernardino-Ontario, CA",1992,13511,1960,15471,2823555,5.47926284418048
40140,"Riverside-San Bernardino-Ontario, CA",1993,12300,752,13052,2867862,4.55112554230294
40140,"Riverside-San Bernardino-Ontario, CA",1994,12314,510,12824,2910103,4.40671687565698
40140,"Riverside-San Bernardino-Ontario, CA",1995,10504,194,10698,2955686,3.61946431386825
40140,"Riverside-San Bernardino-Ontario, CA",1996,11713,649,12362,2997477,4.12413506425571
40140,"Riverside-San Bernardino-Ontario, CA",1997,13871,1324,15195,3051003,4.98032941953843
40140,"Riverside-San Bernardino-Ontario, CA",1998,16259,2395,18654,3118479,5.98176226294934
40140,"Riverside-San Bernardino-Ontario, CA",1999,19018,1903,20921,3201571,6.53460441764371
40140,"Riverside-San Bernardino-Ontario, CA",2000,19090,2406,21496,3277022,6.55961418629475
40140,"Riverside-San Bernardino-Ontario, CA",2001,23596,3821,27417,3377365,8.11786703539594
40140,"Riverside-San Bernardino-Ontario, CA",2002,30038,2436,32474,3486938,9.31304198698113
40140,"Riverside-San Bernardino-Ontario, CA",2003,35965,6287,42252,3617771,11.6790145092102
40140,"Riverside-San Bernardino-Ontario, CA",2004,43142,8321,51463,3755607,13.7029779739999
40140,"Riverside-San Bernardino-Ontario, CA",2005,45485,5523,51008,3875709,13.1609468099901
40140,"Riverside-San Bernardino-Ontario, CA",2006,33498,4591,38089,3986510,9.55447245836584
40140,"Riverside-San Bernardino-Ontario, CA",2007,16019,4067,20086,4067344,4.9383578079454296
40140,"Riverside-San Bernardino-Ontario, CA",2008,5796,3150,8946,4113447,2.17481834578153
40140,"Riverside-San Bernardino-Ontario, CA",2009,4887,1448,6335,4160685,1.52258582420923
40140,"Riverside-San Bernardino-Ontario, CA",2010,5287,1049,6336,4242562,1.49343722024569
40140,"Riverside-San Bernardino-Ontario, CA",2011,3378,1358,4736,4295341,1.10258999227302
40140,"Riverside-San Bernardino-Ontario, CA",2012,4488,1461,5949,4336162,1.37195058671701
40140,"Riverside-San Bernardino-Ontario, CA",2013,6472,2876,9348,4371914,2.13819393519635
40140,"Riverside-San Bernardino-Ontario, CA",2014,7222,2944,10166,4418731,2.30066052900708
40140,"Riverside-San Bernardino-Ontario, CA",2015,7816,2110,9926,4465232,2.2229528051398
40140,"Riverside-San Bernardino-Ontario, CA",2016,8837,2084,10921,4516744,2.41789218073905
40140,"Riverside-San Bernardino-Ontario, CA",2017,10955,3721,14676,4570427,3.21107852723608
40140,"Riverside-San Bernardino-Ontario, CA",2018,11591,3218,14809,4622361,3.20377400207383
40180,"Riverton, WY",1990,10,48,58,33576,1.72742435072671
40180,"Riverton, WY",1991,14,0,14,34103,0.410521068527695
40180,"Riverton, WY",1992,50,0,50,34251,1.45981139236811
40180,"Riverton, WY",1993,55,16,71,34712,2.04540216639779
40180,"Riverton, WY",1994,67,6,73,35119,2.07864688630086
40180,"Riverton, WY",1995,65,0,65,35658,1.82287284760783
40180,"Riverton, WY",1996,56,4,60,35907,1.67098337371543
40180,"Riverton, WY",1997,48,6,54,36032,1.49866785079929
40180,"Riverton, WY",1998,47,34,81,36086,2.24463780967688
40180,"Riverton, WY",1999,52,10,62,36159,1.7146491883072
40180,"Riverton, WY",2000,37,6,43,35840,1.19977678571429
40180,"Riverton, WY",2001,55,52,107,35718,2.99568844840137
40180,"Riverton, WY",2002,37,8,45,36015,1.24947938359017
40180,"Riverton, WY",2003,39,26,65,36130,1.79905895377802
40180,"Riverton, WY",2004,60,6,66,36383,1.81403402688069
40180,"Riverton, WY",2005,40,45,85,36838,2.30739996742494
40180,"Riverton, WY",2006,51,2,53,37408,1.41680923866553
40180,"Riverton, WY",2007,45,9,54,38132,1.41613343123885
40180,"Riverton, WY",2008,43,0,43,38907,1.10519957848202
40180,"Riverton, WY",2009,26,6,32,39685,0.806350006299609
40180,"Riverton, WY",2010,21,0,21,40200,0.522388059701492
40180,"Riverton, WY",2011,19,2,21,40511,0.518377724568636
40180,"Riverton, WY",2012,18,40,58,41009,1.41432368504475
40180,"Riverton, WY",2013,16,4,20,40908,0.48890192627359
40180,"Riverton, WY",2014,12,6,18,40562,0.44376510034022
40180,"Riverton, WY",2015,15,4,19,40228,0.472307845281893
40180,"Riverton, WY",2016,19,0,19,40223,0.472366556447804
40180,"Riverton, WY",2017,17,0,17,39834,0.426771100065271
40180,"Riverton, WY",2018,12,0,12,39531,0.303559231995143
40220,"Roanoke, VA",1990,1119,123,1242,269201,4.61365299534549
40220,"Roanoke, VA",1991,1078,114,1192,271697,4.38724019772025
40220,"Roanoke, VA",1992,1269,50,1319,271766,4.85344009184372
40220,"Roanoke, VA",1993,1294,104,1398,273465,5.11217157588723
40220,"Roanoke, VA",1994,1377,191,1568,274990,5.70202552820103
40220,"Roanoke, VA",1995,1385,80,1465,275743,5.31291818831303
40220,"Roanoke, VA",1996,1260,155,1415,276699,5.11386018742388
40220,"Roanoke, VA",1997,1156,437,1593,277354,5.74356237876504
40220,"Roanoke, VA",1998,1126,128,1254,277506,4.51882121467644
40220,"Roanoke, VA",1999,1318,171,1489,277905,5.3579460607042
40220,"Roanoke, VA",2000,1340,260,1600,288699,5.54210440631938
40220,"Roanoke, VA",2001,1419,254,1673,289547,5.7779911378809
40220,"Roanoke, VA",2002,1507,106,1613,290466,5.55314563494523
40220,"Roanoke, VA",2003,1544,83,1627,292082,5.57035353085777
40220,"Roanoke, VA",2004,1577,181,1758,293745,5.98478271970587
40220,"Roanoke, VA",2005,1410,194,1604,296405,5.41151465056258
40220,"Roanoke, VA",2006,1189,39,1228,299930,4.09428866735572
40220,"Roanoke, VA",2007,981,25,1006,302858,3.32168871220176
40220,"Roanoke, VA",2008,774,84,858,305596,2.80762837209911
40220,"Roanoke, VA",2009,447,2,449,307816,1.45866361722588
40220,"Roanoke, VA",2010,404,32,436,308593,1.41286419329019
40220,"Roanoke, VA",2011,472,38,510,309106,1.64991944510944
40220,"Roanoke, VA",2012,388,40,428,310542,1.37823547217446
40220,"Roanoke, VA",2013,476,209,685,311879,2.19636461576445
40220,"Roanoke, VA",2014,425,86,511,312762,1.63383019676303
40220,"Roanoke, VA",2015,408,355,763,313205,2.43610414903977
40220,"Roanoke, VA",2016,380,162,542,312828,1.73258148247599
40220,"Roanoke, VA",2017,424,168,592,313488,1.88842954116266
40220,"Roanoke, VA",2018,432,83,515,314172,1.63922946666157
40260,"Roanoke Rapids, NC",1990,164,94,258,76638,3.36647616065137
40260,"Roanoke Rapids, NC",1991,144,16,160,76739,2.08498937958535
40260,"Roanoke Rapids, NC",1992,200,87,287,76874,3.7333818976507
40260,"Roanoke Rapids, NC",1993,150,30,180,77565,2.3206343067105
40260,"Roanoke Rapids, NC",1994,143,60,203,77969,2.60359886621606
40260,"Roanoke Rapids, NC",1995,112,4,116,78295,1.48157609042723
40260,"Roanoke Rapids, NC",1996,130,25,155,78100,1.98463508322663
40260,"Roanoke Rapids, NC",1997,130,2,132,77854,1.69548128548308
40260,"Roanoke Rapids, NC",1998,149,44,193,77650,2.48551191242756
40260,"Roanoke Rapids, NC",1999,151,0,151,76986,1.96139557841685
40260,"Roanoke Rapids, NC",2000,139,0,139,79347,1.75179905982583
40260,"Roanoke Rapids, NC",2001,154,9,163,78851,2.06719001661361
40260,"Roanoke Rapids, NC",2002,154,31,185,78580,2.3542886230593
40260,"Roanoke Rapids, NC",2003,120,8,128,78402,1.63261141297416
40260,"Roanoke Rapids, NC",2004,179,55,234,77981,3.00073094728203
40260,"Roanoke Rapids, NC",2005,221,46,267,78040,3.42132239876986
40260,"Roanoke Rapids, NC",2006,218,41,259,77797,3.3291772176305
40260,"Roanoke Rapids, NC",2007,175,0,175,77909,2.24621032229909
40260,"Roanoke Rapids, NC",2008,115,18,133,77827,1.70891849872152
40260,"Roanoke Rapids, NC",2009,86,0,86,77135,1.11492837233422
40260,"Roanoke Rapids, NC",2010,60,86,146,76513,1.90817246742384
40260,"Roanoke Rapids, NC",2011,64,0,64,76025,0.841828345938836
40260,"Roanoke Rapids, NC",2012,57,0,57,75020,0.75979738736337
40260,"Roanoke Rapids, NC",2013,65,40,105,74048,1.41799913569576
40260,"Roanoke Rapids, NC",2014,71,0,71,73498,0.96601268061716
40260,"Roanoke Rapids, NC",2015,72,0,72,72716,0.990153473788437
40260,"Roanoke Rapids, NC",2016,54,0,54,71954,0.750479472996637
40260,"Roanoke Rapids, NC",2017,92,48,140,71195,1.96643022684177
40260,"Roanoke Rapids, NC",2018,55,92,147,70250,2.09252669039146
40300,"Rochelle, IL",1990,187,6,193,46063,4.18991381368995
40300,"Rochelle, IL",1991,192,10,202,46911,4.30602630513099
40300,"Rochelle, IL",1992,272,10,282,47448,5.9433485078401596
40300,"Rochelle, IL",1993,254,34,288,48104,5.98702810577083
40300,"Rochelle, IL",1994,301,90,391,48793,8.01344455147255
40300,"Rochelle, IL",1995,284,84,368,49252,7.47177779582555
40300,"Rochelle, IL",1996,219,45,264,49914,5.2890972472653
40300,"Rochelle, IL",1997,228,16,244,50196,4.86094509522671
40300,"Rochelle, IL",1998,237,24,261,50509,5.16739590963987
40300,"Rochelle, IL",1999,244,4,248,50911,4.87124589970733
40300,"Rochelle, IL",2000,207,0,207,51275,4.03705509507557
40300,"Rochelle, IL",2001,235,2,237,51468,4.60480298437864
40300,"Rochelle, IL",2002,247,18,265,51758,5.11998145214266
40300,"Rochelle, IL",2003,290,40,330,52227,6.3185708541559
40300,"Rochelle, IL",2004,267,24,291,52536,5.53905893101873
40300,"Rochelle, IL",2005,272,17,289,52893,5.46386100240107
40300,"Rochelle, IL",2006,247,12,259,53358,4.85400502267701
40300,"Rochelle, IL",2007,198,17,215,53634,4.00865122869821
40300,"Rochelle, IL",2008,82,0,82,53802,1.52410691052377
40300,"Rochelle, IL",2009,35,6,41,53621,0.764625799593443
40300,"Rochelle, IL",2010,49,48,97,53423,1.81569735881549
40300,"Rochelle, IL",2011,20,8,28,53070,0.527605049934049
40300,"Rochelle, IL",2012,30,2,32,52786,0.606221346569166
40300,"Rochelle, IL",2013,24,0,24,52279,0.45907534574112
40300,"Rochelle, IL",2014,32,6,38,51949,0.731486650368631
40300,"Rochelle, IL",2015,51,4,55,51573,1.06644949876874
40300,"Rochelle, IL",2016,40,2,42,51162,0.820921777882022
40300,"Rochelle, IL",2017,65,6,71,51032,1.39128390029785
40300,"Rochelle, IL",2018,59,14,73,50923,1.43353690866603
40340,"Rochester, MN",1990,952,351,1303,163324,7.97800690651711
40340,"Rochester, MN",1991,970,326,1296,165644,7.82400811378619
40340,"Rochester, MN",1992,975,267,1242,167201,7.42818523812657
40340,"Rochester, MN",1993,801,66,867,169925,5.10225099308518
40340,"Rochester, MN",1994,626,148,774,170616,4.53650302433535
40340,"Rochester, MN",1995,544,108,652,170460,3.82494426845008
40340,"Rochester, MN",1996,738,299,1037,171429,6.04915154378781
40340,"Rochester, MN",1997,893,284,1177,173048,6.8015810642134
40340,"Rochester, MN",1998,1071,466,1537,175775,8.74413312473332
40340,"Rochester, MN",1999,1245,566,1811,178268,10.1588619382054
40340,"Rochester, MN",2000,1294,688,1982,185573,10.6804330371336
40340,"Rochester, MN",2001,1604,567,2171,187803,11.5599857297274
40340,"Rochester, MN",2002,1766,327,2093,190646,10.9784627005025
40340,"Rochester, MN",2003,1827,336,2163,193067,11.2033646350749
40340,"Rochester, MN",2004,1750,65,1815,195300,9.29339477726574
40340,"Rochester, MN",2005,1246,443,1689,197188,8.56542994502708
40340,"Rochester, MN",2006,934,265,1199,199763,6.00211250331643
40340,"Rochester, MN",2007,726,136,862,201782,4.271937040965
40340,"Rochester, MN",2008,543,164,707,204181,3.46261405321749
40340,"Rochester, MN",2009,461,154,615,206097,2.98403179085576
40340,"Rochester, MN",2010,388,144,532,207217,2.56735692534879
40340,"Rochester, MN",2011,354,30,384,208450,1.84216838570401
40340,"Rochester, MN",2012,533,62,595,209539,2.83956685867547
40340,"Rochester, MN",2013,645,44,689,211505,3.25760620316305
40340,"Rochester, MN",2014,621,211,832,212664,3.91227476206598
40340,"Rochester, MN",2015,658,1118,1776,213859,8.30453710154822
40340,"Rochester, MN",2016,744,993,1737,216019,8.04095936005629
40340,"Rochester, MN",2017,818,631,1449,217828,6.6520373872964
40340,"Rochester, MN",2018,690,1126,1816,219802,8.26198123765935
40380,"Rochester, NY",1990,3355,419,3774,1027424,3.67326439717196
40380,"Rochester, NY",1991,2972,261,3233,1033950,3.12684365781711
40380,"Rochester, NY",1992,3403,509,3912,1043797,3.74785518640119
40380,"Rochester, NY",1993,2942,481,3423,1049173,3.26256966200998
40380,"Rochester, NY",1994,2737,823,3560,1049493,3.39211409699731
40380,"Rochester, NY",1995,2428,487,2915,1048250,2.78082518483186
40380,"Rochester, NY",1996,2407,644,3051,1048183,2.91075127148599
40380,"Rochester, NY",1997,2163,814,2977,1046713,2.84414161283943
40380,"Rochester, NY",1998,2405,823,3228,1044714,3.08984085596632
40380,"Rochester, NY",1999,2674,1522,4196,1043511,4.02104050652077
40380,"Rochester, NY",2000,2486,865,3351,1066482,3.14210647718386
40380,"Rochester, NY",2001,2464,606,3070,1068215,2.87395327719607
40380,"Rochester, NY",2002,2525,539,3064,1070355,2.86260166019685
40380,"Rochester, NY",2003,2699,798,3497,1071918,3.26237641312115
40380,"Rochester, NY",2004,2486,684,3170,1072494,2.95572749124937
40380,"Rochester, NY",2005,2327,535,2862,1070418,2.67372185445312
40380,"Rochester, NY",2006,2028,327,2355,1070370,2.20017377168643
40380,"Rochester, NY",2007,1671,295,1966,1072040,1.83388679526883
40380,"Rochester, NY",2008,1496,454,1950,1075302,1.81344403711701
40380,"Rochester, NY",2009,1213,468,1681,1077941,1.55945455270743
40380,"Rochester, NY",2010,1173,320,1493,1079966,1.38245092901073
40380,"Rochester, NY",2011,1080,476,1556,1081465,1.43878905003861
40380,"Rochester, NY",2012,1230,416,1646,1081491,1.5219729059234
40380,"Rochester, NY",2013,1106,249,1355,1081766,1.2525814270369
40380,"Rochester, NY",2014,1269,522,1791,1080149,1.65810457631308
40380,"Rochester, NY",2015,1381,1271,2652,1076800,2.462852897474
40380,"Rochester, NY",2016,1315,752,2067,1073713,1.92509543984286
40380,"Rochester, NY",2017,1185,593,1778,1071589,1.6592182263909
40380,"Rochester, NY",2018,1176,1030,2206,1071082,2.05959954513287
40420,"Rockford, IL",1990,1034,438,1472,284460,5.17471700766364
40420,"Rockford, IL",1991,1221,229,1450,288664,5.02314109137267
40420,"Rockford, IL",1992,1648,412,2060,292050,7.05358671460366
40420,"Rockford, IL",1993,1693,282,1975,295297,6.68818172890344
40420,"Rockford, IL",1994,1493,236,1729,297834,5.80524721824909
40420,"Rockford, IL",1995,1356,677,2033,300263,6.77073099249658
40420,"Rockford, IL",1996,1427,711,2138,303137,7.05291666804118
40420,"Rockford, IL",1997,1240,593,1833,304747,6.01482541255533
40420,"Rockford, IL",1998,1319,419,1738,306331,5.67360143113168
40420,"Rockford, IL",1999,1376,432,1808,307792,5.87409679263919
40420,"Rockford, IL",2000,1374,254,1628,321033,5.07112975924593
40420,"Rockford, IL",2001,1384,537,1921,323229,5.94315485306083
40420,"Rockford, IL",2002,1547,433,1980,325747,6.07833686879695
40420,"Rockford, IL",2003,2052,573,2625,329472,7.96729312354312
40420,"Rockford, IL",2004,2226,347,2573,332230,7.74463474099269
40420,"Rockford, IL",2005,2040,526,2566,335903,7.63911010023727
40420,"Rockford, IL",2006,1929,234,2163,341202,6.33935322770675
40420,"Rockford, IL",2007,1127,208,1335,347503,3.84169345300616
40420,"Rockford, IL",2008,358,107,465,349937,1.32881061448204
40420,"Rockford, IL",2009,220,2,222,349766,0.634710063299463
40420,"Rockford, IL",2010,293,6,299,349191,0.856264909462157
40420,"Rockford, IL",2011,109,59,168,347766,0.483083452666448
40420,"Rockford, IL",2012,111,24,135,345862,0.390329090793438
40420,"Rockford, IL",2013,96,0,96,344761,0.278453769422876
40420,"Rockford, IL",2014,134,16,150,342515,0.437937024655854
40420,"Rockford, IL",2015,90,44,134,340828,0.393160186369664
40420,"Rockford, IL",2016,193,20,213,339648,0.627119841718485
40420,"Rockford, IL",2017,228,7,235,338252,0.69474829417121
40420,"Rockford, IL",2018,209,56,265,337658,0.784817774197561
40460,"Rockingham, NC",1990,124,8,132,44592,2.96017222820237
40460,"Rockingham, NC",1991,145,4,149,44956,3.31435181065931
40460,"Rockingham, NC",1992,192,6,198,44911,4.40871946739106
40460,"Rockingham, NC",1993,235,4,239,45295,5.27652058726129
40460,"Rockingham, NC",1994,217,36,253,45183,5.59945112099683
40460,"Rockingham, NC",1995,236,4,240,45389,5.28762475489656
40460,"Rockingham, NC",1996,291,4,295,45815,6.43893921204846
40460,"Rockingham, NC",1997,297,8,305,45888,6.64661785216179
40460,"Rockingham, NC",1998,303,0,303,46014,6.58495240578954
40460,"Rockingham, NC",1999,321,0,321,45842,7.0023122900397
40460,"Rockingham, NC",2000,274,0,274,46611,5.87844071142005
40460,"Rockingham, NC",2001,286,0,286,46480,6.15318416523236
40460,"Rockingham, NC",2002,258,0,258,46659,5.52947984311708
40460,"Rockingham, NC",2003,273,32,305,46292,6.58861142314007
40460,"Rockingham, NC",2004,286,45,331,46227,7.16031756332879
40460,"Rockingham, NC",2005,285,107,392,46310,8.46469445044267
40460,"Rockingham, NC",2006,242,55,297,46263,6.41981713248168
40460,"Rockingham, NC",2007,188,116,304,46390,6.55313645182151
40460,"Rockingham, NC",2008,132,53,185,46538,3.97524603549787
40460,"Rockingham, NC",2009,90,35,125,46537,2.68603476803404
40460,"Rockingham, NC",2010,90,25,115,46633,2.46606480389424
40460,"Rockingham, NC",2011,82,36,118,46647,2.52963749008511
40460,"Rockingham, NC",2012,85,52,137,46358,2.95526122783554
40460,"Rockingham, NC",2013,98,59,157,46133,3.40320378037414
40460,"Rockingham, NC",2014,93,104,197,45778,4.303377168072
40460,"Rockingham, NC",2015,90,98,188,45435,4.13777924507538
40460,"Rockingham, NC",2016,109,96,205,45021,4.55343062126563
40460,"Rockingham, NC",2017,122,109,231,44825,5.15337423312883
40460,"Rockingham, NC",2018,132,98,230,44887,5.12397798917281
40540,"Rock Springs, WY",1990,56,0,56,38828,1.44225816421139
40540,"Rock Springs, WY",1991,80,0,80,39776,2.01126307320998
40540,"Rock Springs, WY",1992,102,0,102,40347,2.52806900141274
40540,"Rock Springs, WY",1993,99,0,99,40552,2.44130992306175
40540,"Rock Springs, WY",1994,115,8,123,40595,3.02992979430964
40540,"Rock Springs, WY",1995,90,0,90,40633,2.2149484409224
40540,"Rock Springs, WY",1996,90,0,90,40179,2.23997610692153
40540,"Rock Springs, WY",1997,75,0,75,39786,1.8850852058513
40540,"Rock Springs, WY",1998,73,0,73,39767,1.83569291120779
40540,"Rock Springs, WY",1999,39,12,51,39478,1.29185875677593
40540,"Rock Springs, WY",2000,36,5,41,37552,1.0918193438432
40540,"Rock Springs, WY",2001,38,0,38,36899,1.02983820699748
40540,"Rock Springs, WY",2002,48,0,48,37428,1.28246232766912
40540,"Rock Springs, WY",2003,63,0,63,37450,1.68224299065421
40540,"Rock Springs, WY",2004,216,0,216,38026,5.68032398884973
40540,"Rock Springs, WY",2005,260,0,260,38739,6.71158264281473
40540,"Rock Springs, WY",2006,236,32,268,39749,6.74230798259076
40540,"Rock Springs, WY",2007,438,34,472,41470,11.3817217265493
40540,"Rock Springs, WY",2008,144,101,245,42358,5.78403135181076
40540,"Rock Springs, WY",2009,130,221,351,44133,7.95323227516824
40540,"Rock Springs, WY",2010,100,47,147,43574,3.37357139578648
40540,"Rock Springs, WY",2011,102,20,122,43981,2.77392510402219
40540,"Rock Springs, WY",2012,116,16,132,45005,2.93300744361738
40540,"Rock Springs, WY",2013,87,16,103,45162,2.28067844648156
40540,"Rock Springs, WY",2014,108,119,227,44957,5.04926930177725
40540,"Rock Springs, WY",2015,84,0,84,44754,1.87692720203781
40540,"Rock Springs, WY",2016,70,2,72,44275,1.62619988706945
40540,"Rock Springs, WY",2017,67,38,105,43547,2.41118791191127
40540,"Rock Springs, WY",2018,54,0,54,43051,1.25432626419828
40580,"Rocky Mount, NC",1990,442,150,592,133738,4.42656537408964
40580,"Rocky Mount, NC",1991,421,54,475,135170,3.51409336391211
40580,"Rocky Mount, NC",1992,488,28,516,136563,3.77847586828057
40580,"Rocky Mount, NC",1993,506,14,520,138247,3.76138361049426
40580,"Rocky Mount, NC",1994,479,214,693,140339,4.93804288187888
40580,"Rocky Mount, NC",1995,460,18,478,142215,3.36110818127483
40580,"Rocky Mount, NC",1996,450,14,464,143651,3.23005060876708
40580,"Rocky Mount, NC",1997,454,268,722,145301,4.96899539576465
40580,"Rocky Mount, NC",1998,557,82,639,145799,4.38274610936975
40580,"Rocky Mount, NC",1999,598,192,790,146635,5.38752685238858
40580,"Rocky Mount, NC",2000,618,172,790,143139,5.51911079440264
40580,"Rocky Mount, NC",2001,670,137,807,144034,5.60284377299804
40580,"Rocky Mount, NC",2002,645,267,912,144698,6.30278234668067
40580,"Rocky Mount, NC",2003,664,98,762,145487,5.23758136465801
40580,"Rocky Mount, NC",2004,671,84,755,146326,5.15971187622159
40580,"Rocky Mount, NC",2005,669,97,766,147027,5.20992742829548
40580,"Rocky Mount, NC",2006,685,17,702,148256,4.73505288150227
40580,"Rocky Mount, NC",2007,780,65,845,149644,5.64673491753762
40580,"Rocky Mount, NC",2008,363,4,367,151138,2.42824438592545
40580,"Rocky Mount, NC",2009,265,6,271,151729,1.78607912791886
40580,"Rocky Mount, NC",2010,210,2,212,152415,1.39093921201981
40580,"Rocky Mount, NC",2011,166,26,192,151788,1.26492212823148
40580,"Rocky Mount, NC",2012,141,4,145,150867,0.96111144252885
40580,"Rocky Mount, NC",2013,188,62,250,149863,1.66819028045615
40580,"Rocky Mount, NC",2014,202,14,216,149091,1.44877960440268
40580,"Rocky Mount, NC",2015,249,14,263,147549,1.78245870863239
40580,"Rocky Mount, NC",2016,236,80,316,147245,2.1460830588475
40580,"Rocky Mount, NC",2017,215,0,215,146769,1.46488699929822
40580,"Rocky Mount, NC",2018,235,0,235,146021,1.60935755815944
40620,"Rolla, MO",1990,52,67,119,35301,3.3710093198493
40620,"Rolla, MO",1991,49,28,77,35506,2.16864755252633
40620,"Rolla, MO",1992,55,78,133,36050,3.68932038834951
40620,"Rolla, MO",1993,64,122,186,36491,5.09714724178565
40620,"Rolla, MO",1994,71,135,206,36742,5.606662674868
40620,"Rolla, MO",1995,81,106,187,37290,5.01474926253687
40620,"Rolla, MO",1996,90,94,184,37883,4.85705989493968
40620,"Rolla, MO",1997,58,125,183,38281,4.78043938246127
40620,"Rolla, MO",1998,77,56,133,38593,3.44622081724665
40620,"Rolla, MO",1999,82,48,130,38900,3.34190231362468
40620,"Rolla, MO",2000,68,98,166,39945,4.15571410689698
40620,"Rolla, MO",2001,81,196,277,40219,6.88729207588453
40620,"Rolla, MO",2002,60,56,116,41193,2.81601242929624
40620,"Rolla, MO",2003,115,109,224,41883,5.34823197956211
40620,"Rolla, MO",2004,72,98,170,42616,3.98911207058382
40620,"Rolla, MO",2005,103,54,157,43327,3.62360652710781
40620,"Rolla, MO",2006,110,167,277,44025,6.29187961385576
40620,"Rolla, MO",2007,55,83,138,44300,3.11512415349887
40620,"Rolla, MO",2008,20,99,119,44200,2.69230769230769
40620,"Rolla, MO",2009,39,40,79,44540,1.77368657386619
40620,"Rolla, MO",2010,35,63,98,45327,2.16206675932667
40620,"Rolla, MO",2011,37,102,139,45276,3.07005919250817
40620,"Rolla, MO",2012,22,50,72,45261,1.590773513621
40620,"Rolla, MO",2013,66,33,99,45037,2.19819259719786
40620,"Rolla, MO",2014,68,46,114,44958,2.53569998665421
40620,"Rolla, MO",2015,59,85,144,44806,3.21385528723832
40620,"Rolla, MO",2016,92,137,229,44762,5.11594656181583
40620,"Rolla, MO",2017,41,64,105,44686,2.34972922168017
40620,"Rolla, MO",2018,29,102,131,44732,2.92855226683359
40660,"Rome, GA",1990,249,57,306,81377,3.76027624513069
40660,"Rome, GA",1991,236,38,274,81741,3.35205099032309
40660,"Rome, GA",1992,301,53,354,82133,4.31008242728258
40660,"Rome, GA",1993,333,87,420,82686,5.07945722371381
40660,"Rome, GA",1994,316,127,443,83057,5.33368650444875
40660,"Rome, GA",1995,269,160,429,83749,5.12244922327431
40660,"Rome, GA",1996,323,285,608,84282,7.21387722170808
40660,"Rome, GA",1997,389,188,577,84743,6.80882196759614
40660,"Rome, GA",1998,419,163,582,85113,6.83796834796095
40660,"Rome, GA",1999,390,89,479,85462,5.60483021693852
40660,"Rome, GA",2000,307,75,382,90837,4.2053348305206
40660,"Rome, GA",2001,373,78,451,91181,4.94620589815861
40660,"Rome, GA",2002,678,44,722,92597,7.79722885190665
40660,"Rome, GA",2003,424,78,502,93539,5.36674542169576
40660,"Rome, GA",2004,390,183,573,94014,6.09483693917927
40660,"Rome, GA",2005,424,189,613,94332,6.49832506466523
40660,"Rome, GA",2006,391,74,465,95165,4.88625019702622
40660,"Rome, GA",2007,284,24,308,95308,3.23162798505897
40660,"Rome, GA",2008,180,44,224,95922,2.33523070828381
40660,"Rome, GA",2009,72,39,111,96383,1.15165537491051
40660,"Rome, GA",2010,55,0,55,96423,0.570403327007042
40660,"Rome, GA",2011,32,77,109,96153,1.13360997576779
40660,"Rome, GA",2012,32,11,43,95934,0.448224821231263
40660,"Rome, GA",2013,53,9,62,95885,0.646607915732388
40660,"Rome, GA",2014,70,5,75,95890,0.782146209198039
40660,"Rome, GA",2015,89,4,93,96200,0.966735966735967
40660,"Rome, GA",2016,102,124,226,96675,2.33772950607706
40660,"Rome, GA",2017,157,0,157,97427,1.61146294148439
40660,"Rome, GA",2018,198,12,210,97927,2.14445454266954
40700,"Roseburg, OR",1990,282,116,398,95084,4.1857725800345
40700,"Roseburg, OR",1991,225,4,229,95805,2.3902719064767
40700,"Roseburg, OR",1992,229,56,285,96324,2.95876417092313
40700,"Roseburg, OR",1993,262,55,317,97298,3.25803202532426
40700,"Roseburg, OR",1994,308,97,405,98255,4.12192763727037
40700,"Roseburg, OR",1995,257,119,376,99624,3.77419095800209
40700,"Roseburg, OR",1996,240,146,386,100704,3.83301557038449
40700,"Roseburg, OR",1997,226,37,263,101585,2.58896490623616
40700,"Roseburg, OR",1998,283,122,405,101802,3.97831083868686
40700,"Roseburg, OR",1999,294,184,478,101718,4.69926659981518
40700,"Roseburg, OR",2000,305,58,363,100485,3.61247947454844
40700,"Roseburg, OR",2001,311,94,405,100562,4.02736620194507
40700,"Roseburg, OR",2002,328,32,360,101529,3.5457849481429
40700,"Roseburg, OR",2003,303,45,348,102776,3.38600451467269
40700,"Roseburg, OR",2004,346,14,360,103965,3.4627037945462402
40700,"Roseburg, OR",2005,438,59,497,105285,4.72052049199791
40700,"Roseburg, OR",2006,397,18,415,106658,3.89094113896754
40700,"Roseburg, OR",2007,373,9,382,107057,3.56819264503956
40700,"Roseburg, OR",2008,272,4,276,107316,2.57184390025718
40700,"Roseburg, OR",2009,170,12,182,107378,1.69494682337164
40700,"Roseburg, OR",2010,133,48,181,107634,1.6816247654087
40700,"Roseburg, OR",2011,96,4,100,107219,0.932670515486994
40700,"Roseburg, OR",2012,102,58,160,106918,1.49647393329467
40700,"Roseburg, OR",2013,150,14,164,106605,1.5383893813611
40700,"Roseburg, OR",2014,160,6,166,106702,1.55573466289292
40700,"Roseburg, OR",2015,170,2,172,107191,1.6046123275275
40700,"Roseburg, OR",2016,211,4,215,108154,1.98790613384618
40700,"Roseburg, OR",2017,238,6,244,109284,2.23271476153874
40700,"Roseburg, OR",2018,276,8,284,110283,2.57519291277894
40740,"Roswell, NM",1990,67,0,67,58041,1.1543564032322
40740,"Roswell, NM",1991,33,0,33,58857,0.560680972526632
40740,"Roswell, NM",1992,38,32,70,58724,1.19201689258225
40740,"Roswell, NM",1993,73,2,75,59607,1.25824148170517
40740,"Roswell, NM",1994,86,4,90,60733,1.48189616847513
40740,"Roswell, NM",1995,84,4,88,61537,1.43003396330663
40740,"Roswell, NM",1996,65,4,69,62295,1.10763303635926
40740,"Roswell, NM",1997,146,4,150,62581,2.39689362586088
40740,"Roswell, NM",1998,60,30,90,62673,1.43602508257144
40740,"Roswell, NM",1999,34,2,36,62364,0.577256109293823
40740,"Roswell, NM",2000,30,0,30,61317,0.48926072704144
40740,"Roswell, NM",2001,27,0,27,60928,0.443146008403361
40740,"Roswell, NM",2002,29,0,29,60768,0.47722485518694
40740,"Roswell, NM",2003,55,0,55,61248,0.897988505747127
40740,"Roswell, NM",2004,52,0,52,61478,0.845831028985979
40740,"Roswell, NM",2005,78,0,78,62172,1.25458405713183
40740,"Roswell, NM",2006,66,0,66,62486,1.05623659699773
40740,"Roswell, NM",2007,54,0,54,63587,0.849230188560555
40740,"Roswell, NM",2008,43,0,43,64378,0.667930038211812
40740,"Roswell, NM",2009,25,0,25,65110,0.383965596682537
40740,"Roswell, NM",2010,21,0,21,65727,0.319503400429047
40740,"Roswell, NM",2011,33,0,33,65739,0.501985122986355
40740,"Roswell, NM",2012,20,0,20,65800,0.303951367781155
40740,"Roswell, NM",2013,63,0,63,66059,0.953692910882696
40740,"Roswell, NM",2014,54,0,54,65880,0.819672131147541
40740,"Roswell, NM",2015,70,0,70,65878,1.06257020553144
40740,"Roswell, NM",2016,74,144,218,65697,3.31826415209218
40740,"Roswell, NM",2017,66,4,70,65153,1.07439411845963
40740,"Roswell, NM",2018,57,0,57,64689,0.881138988081436
40780,"Russellville, AR",1990,227,15,242,63968,3.78314157078539
40780,"Russellville, AR",1991,179,20,199,65058,3.05880906268253
40780,"Russellville, AR",1992,204,48,252,66111,3.81177111222036
40780,"Russellville, AR",1993,175,195,370,67223,5.50406854796721
40780,"Russellville, AR",1994,190,45,235,68437,3.43381504157108
40780,"Russellville, AR",1995,155,210,365,69456,5.25512554710896
40780,"Russellville, AR",1996,154,221,375,69976,5.35898022179033
40780,"Russellville, AR",1997,105,103,208,70476,2.95135932799818
40780,"Russellville, AR",1998,120,89,209,71271,2.93246902667284
40780,"Russellville, AR",1999,126,12,138,71913,1.9189854407409
40780,"Russellville, AR",2000,105,70,175,75688,2.31212345418032
40780,"Russellville, AR",2001,129,200,329,76131,4.32149846974294
40780,"Russellville, AR",2002,128,33,161,76552,2.10314557425018
40780,"Russellville, AR",2003,114,22,136,76819,1.77039534490165
40780,"Russellville, AR",2004,157,31,188,77680,2.42018537590113
40780,"Russellville, AR",2005,161,43,204,78676,2.59291270527226
40780,"Russellville, AR",2006,190,32,222,80365,2.76239656566913
40780,"Russellville, AR",2007,124,251,375,81426,4.60540859185027
40780,"Russellville, AR",2008,83,23,106,82463,1.28542497847519
40780,"Russellville, AR",2009,69,10,79,83447,0.94670868934773
40780,"Russellville, AR",2010,130,4,134,84258,1.59035343824919
40780,"Russellville, AR",2011,67,17,84,84641,0.992426838057206
40780,"Russellville, AR",2012,65,27,92,84451,1.08938911321358
40780,"Russellville, AR",2013,149,14,163,84406,1.9311423358529
40780,"Russellville, AR",2014,37,17,54,84885,0.636154797667432
40780,"Russellville, AR",2015,72,68,140,85090,1.64531672346927
40780,"Russellville, AR",2016,107,16,123,85377,1.44066903264345
40780,"Russellville, AR",2017,125,20,145,85199,1.70189790959988
40780,"Russellville, AR",2018,94,2,96,85535,1.12234757701526
40820,"Ruston, LA",1990,44,3,47,41729,1.12631503271106
40820,"Ruston, LA",1991,42,2,44,42223,1.04208606683561
40820,"Ruston, LA",1992,71,4,75,42288,1.77355278093076
40820,"Ruston, LA",1993,61,8,69,43070,1.60204318551196
40820,"Ruston, LA",1994,61,91,152,42960,3.53817504655493
40820,"Ruston, LA",1995,42,42,84,42435,1.97949805585012
40820,"Ruston, LA",1996,61,30,91,42080,2.16254752851711
40820,"Ruston, LA",1997,41,88,129,41607,3.10043982983633
40820,"Ruston, LA",1998,32,204,236,41180,5.73093734822729
40820,"Ruston, LA",1999,36,66,102,40947,2.49102498351528
40820,"Ruston, LA",2000,105,15,120,42575,2.81855549031122
40820,"Ruston, LA",2001,48,12,60,42625,1.40762463343109
40820,"Ruston, LA",2002,57,36,93,42808,2.17249112315455
40820,"Ruston, LA",2003,73,72,145,43539,3.33034750453616
40820,"Ruston, LA",2004,136,225,361,44272,8.15413805565595
40820,"Ruston, LA",2005,136,32,168,44580,3.76850605652759
40820,"Ruston, LA",2006,124,2,126,44867,2.80830008692357
40820,"Ruston, LA",2007,84,128,212,45323,4.67753679147453
40820,"Ruston, LA",2008,57,0,57,45726,1.24655557013515
40820,"Ruston, LA",2009,34,7,41,46270,0.886103306678193
40820,"Ruston, LA",2010,29,0,29,46849,0.619010010886038
40820,"Ruston, LA",2011,25,0,25,47054,0.531304458707017
40820,"Ruston, LA",2012,70,68,138,47026,2.93454684642538
40820,"Ruston, LA",2013,70,0,70,47235,1.48195194241558
40820,"Ruston, LA",2014,74,0,74,47199,1.56782982690311
40820,"Ruston, LA",2015,84,0,84,47437,1.77076965238105
40820,"Ruston, LA",2016,125,0,125,47484,2.63246567264763
40820,"Ruston, LA",2017,42,192,234,47465,4.92994838301907
40820,"Ruston, LA",2018,79,0,79,47196,1.67387066700568
40860,"Rutland, VT",1990,224,54,278,62253,4.4656482418518
40860,"Rutland, VT",1991,187,41,228,62431,3.65203184315484
40860,"Rutland, VT",1992,113,40,153,62404,2.45176591244151
40860,"Rutland, VT",1993,145,25,170,62228,2.73188918171884
40860,"Rutland, VT",1994,103,0,103,62205,1.6558154489189
40860,"Rutland, VT",1995,106,32,138,62389,2.21192838481142
40860,"Rutland, VT",1996,104,0,104,62623,1.66073168005365
40860,"Rutland, VT",1997,105,4,109,62527,1.74324691733171
40860,"Rutland, VT",1998,104,0,104,62528,1.6632548618219
40860,"Rutland, VT",1999,120,10,130,62338,2.08540537072091
40860,"Rutland, VT",2000,133,2,135,63373,2.13024474145141
40860,"Rutland, VT",2001,114,0,114,63132,1.80574035354495
40860,"Rutland, VT",2002,164,7,171,62982,2.71506144612747
40860,"Rutland, VT",2003,138,0,138,63113,2.18655427566428
40860,"Rutland, VT",2004,151,14,165,62997,2.61917234154007
40860,"Rutland, VT",2005,161,8,169,63003,2.68241194863737
40860,"Rutland, VT",2006,119,4,123,62894,1.95567144719687
40860,"Rutland, VT",2007,76,2,78,62618,1.24564821616788
40860,"Rutland, VT",2008,71,2,73,62368,1.17047203694202
40860,"Rutland, VT",2009,43,0,43,61946,0.694152971943305
40860,"Rutland, VT",2010,54,2,56,61578,0.909415700412485
40860,"Rutland, VT",2011,34,2,36,61220,0.588043123162365
40860,"Rutland, VT",2012,49,0,49,60791,0.806040367817605
40860,"Rutland, VT",2013,46,0,46,60480,0.760582010582011
40860,"Rutland, VT",2014,48,2,50,60031,0.832903000116606
40860,"Rutland, VT",2015,54,0,54,59547,0.906846692528591
40860,"Rutland, VT",2016,38,0,38,59113,0.642836601086056
40860,"Rutland, VT",2017,39,0,39,59000,0.661016949152542
40860,"Rutland, VT",2018,47,0,47,58672,0.801063539678211
40900,"Sacramento--Roseville--Arden-Arcade, CA",1990,13456,2889,16345,1520851,10.7472724152465
40900,"Sacramento--Roseville--Arden-Arcade, CA",1991,7650,2175,9825,1563857,6.2825437364158
40900,"Sacramento--Roseville--Arden-Arcade, CA",1992,7854,1169,9023,1585669,5.69034268816506
40900,"Sacramento--Roseville--Arden-Arcade, CA",1993,7921,714,8635,1599838,5.39742148892575
40900,"Sacramento--Roseville--Arden-Arcade, CA",1994,8630,713,9343,1610670,5.80069163764148
40900,"Sacramento--Roseville--Arden-Arcade, CA",1995,7455,588,8043,1631671,4.92930253709234
40900,"Sacramento--Roseville--Arden-Arcade, CA",1996,8096,878,8974,1656399,5.41777675547981
40900,"Sacramento--Roseville--Arden-Arcade, CA",1997,8564,1240,9804,1681493,5.8305327467911
40900,"Sacramento--Roseville--Arden-Arcade, CA",1998,10733,3603,14336,1709963,8.38380713500819
40900,"Sacramento--Roseville--Arden-Arcade, CA",1999,10964,3511,14475,1742266,8.30814582847854
40900,"Sacramento--Roseville--Arden-Arcade, CA",2000,13468,3325,16793,1807949,9.2884257243982
40900,"Sacramento--Roseville--Arden-Arcade, CA",2001,14719,3715,18434,1866310,9.87724440205539
40900,"Sacramento--Roseville--Arden-Arcade, CA",2002,17614,4485,22099,1923508,11.4889046471343
40900,"Sacramento--Roseville--Arden-Arcade, CA",2003,18165,4667,22832,1970542,11.5866599138714
40900,"Sacramento--Roseville--Arden-Arcade, CA",2004,18523,3476,21999,2008663,10.9520611471412
40900,"Sacramento--Roseville--Arden-Arcade, CA",2005,16380,3802,20182,2034850,9.91817578691304
40900,"Sacramento--Roseville--Arden-Arcade, CA",2006,8714,3163,11877,2057885,5.77145953248116
40900,"Sacramento--Roseville--Arden-Arcade, CA",2007,6924,1126,8050,2082217,3.8660715958039
40900,"Sacramento--Roseville--Arden-Arcade, CA",2008,3952,1559,5511,2108310,2.61394197248033
40900,"Sacramento--Roseville--Arden-Arcade, CA",2009,2415,295,2710,2132657,1.27071535647786
40900,"Sacramento--Roseville--Arden-Arcade, CA",2010,2166,536,2702,2153656,1.25461076420747
40900,"Sacramento--Roseville--Arden-Arcade, CA",2011,1873,618,2491,2172928,1.14637944745523
40900,"Sacramento--Roseville--Arden-Arcade, CA",2012,2848,560,3408,2190556,1.55576940283654
40900,"Sacramento--Roseville--Arden-Arcade, CA",2013,3539,650,4189,2211060,1.89456640706268
40900,"Sacramento--Roseville--Arden-Arcade, CA",2014,3694,465,4159,2236623,1.85949979053242
40900,"Sacramento--Roseville--Arden-Arcade, CA",2015,5175,1009,6184,2264065,2.73137034493268
40900,"Sacramento--Roseville--Arden-Arcade, CA",2016,6135,1069,7204,2292410,3.14254430926405
40900,"Sacramento--Roseville--Arden-Arcade, CA",2017,6815,2688,9503,2320381,4.09544811821852
40900,"Sacramento--Roseville--Arden-Arcade, CA",2018,6393,1480,7873,2345210,3.35705544492817
40940,"Safford, AZ",1990,47,0,47,26584,1.76798074029491
40940,"Safford, AZ",1991,47,6,53,27199,1.94860105150925
40940,"Safford, AZ",1992,92,4,96,27714,3.46395323663131
40940,"Safford, AZ",1993,84,0,84,28581,2.93901542983101
40940,"Safford, AZ",1994,107,44,151,29142,5.18152494681216
40940,"Safford, AZ",1995,104,0,104,29933,3.47442621855477
40940,"Safford, AZ",1996,117,0,117,30703,3.81070253721135
40940,"Safford, AZ",1997,127,3,130,31257,4.15906836868541
40940,"Safford, AZ",1998,110,64,174,31702,5.48861270582298
40940,"Safford, AZ",1999,84,8,92,32039,2.87150035893754
40940,"Safford, AZ",2000,70,0,70,33511,2.08886634239503
40940,"Safford, AZ",2001,70,0,70,33356,2.09857297038014
40940,"Safford, AZ",2002,56,6,62,33224,1.86612087647484
40940,"Safford, AZ",2003,66,0,66,32985,2.00090950432015
40940,"Safford, AZ",2004,68,25,93,32703,2.84377580038529
40940,"Safford, AZ",2005,200,8,208,32964,6.30991384540711
40940,"Safford, AZ",2006,219,195,414,33701,12.2845019435625
40940,"Safford, AZ",2007,434,34,468,35175,13.3049040511727
40940,"Safford, AZ",2008,268,2,270,36639,7.36919675755343
40940,"Safford, AZ",2009,81,2,83,37525,2.21185876082612
40940,"Safford, AZ",2010,78,2,80,37159,2.152910465836
40940,"Safford, AZ",2011,119,16,135,37134,3.63548230731944
40940,"Safford, AZ",2012,77,5,82,37024,2.21477960242005
40940,"Safford, AZ",2013,77,44,121,37454,3.23062957227532
40940,"Safford, AZ",2014,73,14,87,38124,2.28202706956248
40940,"Safford, AZ",2015,88,12,100,37873,2.64040345364772
40940,"Safford, AZ",2016,69,6,75,37823,1.98292044523174
40940,"Safford, AZ",2017,85,12,97,37501,2.58659769072825
40940,"Safford, AZ",2018,132,6,138,38072,3.62471107375499
40980,"Saginaw, MI",1990,339,65,404,212051,1.90520205045013
40980,"Saginaw, MI",1991,410,82,492,212281,2.31768269416481
40980,"Saginaw, MI",1992,434,119,553,212234,2.6056145575167
40980,"Saginaw, MI",1993,533,179,712,211897,3.36012307866558
40980,"Saginaw, MI",1994,524,75,599,211914,2.82661834517776
40980,"Saginaw, MI",1995,508,89,597,211649,2.82070787010569
40980,"Saginaw, MI",1996,509,221,730,211420,3.45284268281147
40980,"Saginaw, MI",1997,449,219,668,210825,3.1685046839796
40980,"Saginaw, MI",1998,553,255,808,210184,3.8442507517223
40980,"Saginaw, MI",1999,534,75,609,209672,2.9045366095616
40980,"Saginaw, MI",2000,630,342,972,209899,4.63079862219448
40980,"Saginaw, MI",2001,490,40,530,209460,2.53031605079729
40980,"Saginaw, MI",2002,605,25,630,209323,3.00970270825471
40980,"Saginaw, MI",2003,652,47,699,208755,3.34842279226845
40980,"Saginaw, MI",2004,604,14,618,208489,2.96418516084781
40980,"Saginaw, MI",2005,484,98,582,207368,2.80660468346129
40980,"Saginaw, MI",2006,236,34,270,205822,1.31181312007463
40980,"Saginaw, MI",2007,173,67,240,203144,1.18142795258536
40980,"Saginaw, MI",2008,142,2,144,201966,0.7129912955646
40980,"Saginaw, MI",2009,88,28,116,200835,0.577588567729728
40980,"Saginaw, MI",2010,113,24,137,199862,0.685472976353684
40980,"Saginaw, MI",2011,91,86,177,198883,0.889970485159616
40980,"Saginaw, MI",2012,109,103,212,198354,1.06879619266564
40980,"Saginaw, MI",2013,128,83,211,196798,1.07216536753422
40980,"Saginaw, MI",2014,104,110,214,195254,1.09600827639895
40980,"Saginaw, MI",2015,156,226,382,193314,1.97605967493301
40980,"Saginaw, MI",2016,149,132,281,192525,1.4595507077003
40980,"Saginaw, MI",2017,182,153,335,191996,1.74482801725036
40980,"Saginaw, MI",2018,179,154,333,190800,1.74528301886792
41060,"St. Cloud, MN",1990,646,724,1370,150065,9.12937726984973
41060,"St. Cloud, MN",1991,709,79,788,151743,5.19299078046434
41060,"St. Cloud, MN",1992,772,190,962,153305,6.27507256775709
41060,"St. Cloud, MN",1993,919,302,1221,155315,7.86144287415897
41060,"St. Cloud, MN",1994,872,491,1363,157025,8.68014647349148
41060,"St. Cloud, MN",1995,920,348,1268,158928,7.97845565287426
41060,"St. Cloud, MN",1996,913,434,1347,160209,8.40776735389398
41060,"St. Cloud, MN",1997,778,396,1174,161826,7.25470567152374
41060,"St. Cloud, MN",1998,934,236,1170,162894,7.18258499392243
41060,"St. Cloud, MN",1999,1059,158,1217,164956,7.37772496908267
41060,"St. Cloud, MN",2000,1125,229,1354,168139,8.05286102569898
41060,"St. Cloud, MN",2001,1325,163,1488,170587,8.72282178595086
41060,"St. Cloud, MN",2002,1476,374,1850,173123,10.6860440265014
41060,"St. Cloud, MN",2003,1636,379,2015,175161,11.5037023081622
41060,"St. Cloud, MN",2004,1526,180,1706,176860,9.64604772136153
41060,"St. Cloud, MN",2005,1541,173,1714,179222,9.56355804532926
41060,"St. Cloud, MN",2006,1100,167,1267,181873,6.9663996305114
41060,"St. Cloud, MN",2007,700,80,780,184598,4.2253978916348
41060,"St. Cloud, MN",2008,376,253,629,186507,3.37252757269164
41060,"St. Cloud, MN",2009,288,249,537,188114,2.85465196636082
41060,"St. Cloud, MN",2010,314,0,314,189218,1.65946157342325
41060,"St. Cloud, MN",2011,246,122,368,190075,1.93607786400105
41060,"St. Cloud, MN",2012,316,256,572,190555,3.00175802261814
41060,"St. Cloud, MN",2013,376,221,597,191550,3.11667971808927
41060,"St. Cloud, MN",2014,387,190,577,193113,2.98788792054393
41060,"St. Cloud, MN",2015,376,482,858,195302,4.39319617822654
41060,"St. Cloud, MN",2016,475,632,1107,196666,5.62883264011064
41060,"St. Cloud, MN",2017,514,305,819,198106,4.134150404329
41060,"St. Cloud, MN",2018,532,238,770,199801,3.85383456539257
41100,"St. George, UT",1990,777,22,799,49137,16.2606589738893
41100,"St. George, UT",1991,974,4,978,52562,18.6065979224535
41100,"St. George, UT",1992,1131,35,1166,55872,20.8691294387171
41100,"St. George, UT",1993,1835,208,2043,59916,34.0977368315642
41100,"St. George, UT",1994,1934,368,2302,65434,35.1804872084849
41100,"St. George, UT",1995,1645,258,1903,70843,26.8622164504609
41100,"St. George, UT",1996,1422,407,1829,75838,24.11719718347
41100,"St. George, UT",1997,1266,179,1445,79322,18.2168881268753
41100,"St. George, UT",1998,1373,232,1605,82241,19.5158132804805
41100,"St. George, UT",1999,1336,192,1528,85036,17.9688602474246
41100,"St. George, UT",2000,1357,194,1551,91206,17.0054601670943
41100,"St. George, UT",2001,1626,196,1822,94512,19.2779752835619
41100,"St. George, UT",2002,1898,185,2083,99274,20.9823317283478
41100,"St. George, UT",2003,2313,416,2729,104188,26.1930356662955
41100,"St. George, UT",2004,3312,480,3792,110207,34.4079777146642
41100,"St. George, UT",2005,3563,285,3848,119000,32.3361344537815
41100,"St. George, UT",2006,2078,175,2253,126796,17.7686993280545
41100,"St. George, UT",2007,1792,157,1949,132277,14.7342319526448
41100,"St. George, UT",2008,687,41,728,135552,5.37063267233239
41100,"St. George, UT",2009,591,7,598,137088,4.36216153127918
41100,"St. George, UT",2010,873,20,893,138392,6.45268512630788
41100,"St. George, UT",2011,854,39,893,141245,6.32234769372367
41100,"St. George, UT",2012,1317,75,1392,144146,9.65687566772578
41100,"St. George, UT",2013,1835,50,1885,147004,12.822780332508
41100,"St. George, UT",2014,1573,55,1628,151109,10.7736799264107
41100,"St. George, UT",2015,1614,44,1658,154680,10.718903542798
41100,"St. George, UT",2016,1889,307,2196,159337,13.7821096167243
41100,"St. George, UT",2017,2315,894,3209,165859,19.3477592412833
41100,"St. George, UT",2018,2351,538,2889,171700,16.8258590564939
41140,"St. Joseph, MO-KS",1990,183,74,257,115873,2.2179455093076
41140,"St. Joseph, MO-KS",1991,141,33,174,115857,1.50185142028535
41140,"St. Joseph, MO-KS",1992,223,60,283,116152,2.43646256629244
41140,"St. Joseph, MO-KS",1993,207,32,239,116377,2.05367039879014
41140,"St. Joseph, MO-KS",1994,211,86,297,115803,2.56470039636279
41140,"St. Joseph, MO-KS",1995,190,207,397,116055,3.42079186592564
41140,"St. Joseph, MO-KS",1996,231,153,384,115783,3.31654906160663
41140,"St. Joseph, MO-KS",1997,172,108,280,116050,2.4127531236536
41140,"St. Joseph, MO-KS",1998,215,120,335,116461,2.8764994289934
41140,"St. Joseph, MO-KS",1999,268,130,398,116523,3.41563468156501
41140,"St. Joseph, MO-KS",2000,237,64,301,124091,2.42563924861594
41140,"St. Joseph, MO-KS",2001,189,52,241,123936,1.94455202685257
41140,"St. Joseph, MO-KS",2002,243,46,289,123894,2.33263919156698
41140,"St. Joseph, MO-KS",2003,247,57,304,123923,2.45313622168605
41140,"St. Joseph, MO-KS",2004,206,133,339,123366,2.74792082097174
41140,"St. Joseph, MO-KS",2005,229,68,297,123484,2.40516990055392
41140,"St. Joseph, MO-KS",2006,181,47,228,124222,1.83542367696543
41140,"St. Joseph, MO-KS",2007,147,30,177,125483,1.4105496362057
41140,"St. Joseph, MO-KS",2008,93,10,103,126077,0.816961063477082
41140,"St. Joseph, MO-KS",2009,110,42,152,127001,1.19684096975614
41140,"St. Joseph, MO-KS",2010,96,35,131,127281,1.02921881506274
41140,"St. Joseph, MO-KS",2011,86,32,118,127692,0.924098612285813
41140,"St. Joseph, MO-KS",2012,101,12,113,127907,0.883454384826476
41140,"St. Joseph, MO-KS",2013,114,9,123,127642,0.963632660096207
41140,"St. Joseph, MO-KS",2014,98,6,104,127262,0.817211736417784
41140,"St. Joseph, MO-KS",2015,94,117,211,126807,1.66394599667211
41140,"St. Joseph, MO-KS",2016,95,6,101,126736,0.796932205529605
41140,"St. Joseph, MO-KS",2017,101,8,109,126598,0.860993064661369
41140,"St. Joseph, MO-KS",2018,85,8,93,126490,0.735235987034548
41180,"St. Louis, MO-IL",1990,7308,1204,8512,2564213,3.31953702754022
41180,"St. Louis, MO-IL",1991,7525,1059,8584,2575319,3.3331793071072
41180,"St. Louis, MO-IL",1992,10022,726,10748,2583173,4.16077436547997
41180,"St. Louis, MO-IL",1993,10913,953,11866,2595687,4.5714294520102
41180,"St. Louis, MO-IL",1994,11912,1383,13295,2603496,5.10659513208394
41180,"St. Louis, MO-IL",1995,10147,1489,11636,2613321,4.4525720338221
41180,"St. Louis, MO-IL",1996,10637,2137,12774,2621277,4.87319730039977
41180,"St. Louis, MO-IL",1997,9433,1742,11175,2629611,4.24967799419762
41180,"St. Louis, MO-IL",1998,10459,1954,12413,2632898,4.71457686549194
41180,"St. Louis, MO-IL",1999,10590,2149,12739,2639664,4.82599300517035
41180,"St. Louis, MO-IL",2000,9638,2669,12307,2678822,4.59418356277498
41180,"St. Louis, MO-IL",2001,10105,1972,12077,2690131,4.4893724506353
41180,"St. Louis, MO-IL",2002,11299,3041,14340,2700121,5.31087310531639
41180,"St. Louis, MO-IL",2003,12174,2579,14753,2711031,5.44184112981371
41180,"St. Louis, MO-IL",2004,13465,2248,15713,2721868,5.7728736294339
41180,"St. Louis, MO-IL",2005,13362,2140,15502,2730316,5.67773107581687
41180,"St. Louis, MO-IL",2006,10138,1669,11807,2744265,4.30242706152649
41180,"St. Louis, MO-IL",2007,8119,2192,10311,2755581,3.74186060943228
41180,"St. Louis, MO-IL",2008,4655,1079,5734,2767776,2.07169944388563
41180,"St. Louis, MO-IL",2009,4048,1112,5160,2779404,1.8565131229573
41180,"St. Louis, MO-IL",2010,4251,1403,5654,2789979,2.02653855100702
41180,"St. Louis, MO-IL",2011,3287,1116,4403,2794881,1.5753801324636
41180,"St. Louis, MO-IL",2012,4014,1475,5489,2796568,1.9627629294192
41180,"St. Louis, MO-IL",2013,4646,902,5548,2799459,1.98181148571921
41180,"St. Louis, MO-IL",2014,4538,2454,6992,2803516,2.49401109178617
41180,"St. Louis, MO-IL",2015,5054,2644,7698,2807498,2.74194318215009
41180,"St. Louis, MO-IL",2016,5378,2333,7711,2805437,2.74859139592156
41180,"St. Louis, MO-IL",2017,5608,1687,7295,2805850,2.59992515636973
41180,"St. Louis, MO-IL",2018,5242,2096,7338,2805465,2.61560917708829
41220,"St. Marys, GA",1990,371,83,454,30792,14.7440893738633
41220,"St. Marys, GA",1991,414,0,414,34159,12.1197927339793
41220,"St. Marys, GA",1992,535,6,541,37561,14.4032374004952
41220,"St. Marys, GA",1993,587,40,627,39656,15.8109743796651
41220,"St. Marys, GA",1994,538,90,628,41182,15.2493807974358
41220,"St. Marys, GA",1995,503,36,539,40695,13.2448703771962
41220,"St. Marys, GA",1996,612,16,628,42944,14.623695976155
41220,"St. Marys, GA",1997,547,10,557,45556,12.2267099833172
41220,"St. Marys, GA",1998,500,19,519,47282,10.9766930332896
41220,"St. Marys, GA",1999,477,12,489,46748,10.4603405493283
41220,"St. Marys, GA",2000,452,60,512,43824,11.6830960204454
41220,"St. Marys, GA",2001,508,60,568,44469,12.7729429490207
41220,"St. Marys, GA",2002,520,46,566,45299,12.4947570586547
41220,"St. Marys, GA",2003,428,12,440,44568,9.87255429904864
41220,"St. Marys, GA",2004,514,0,514,46096,11.1506421381465
41220,"St. Marys, GA",2005,718,0,718,46673,15.3836265078311
41220,"St. Marys, GA",2006,619,0,619,47086,13.1461580937009
41220,"St. Marys, GA",2007,379,0,379,48947,7.74306903385294
41220,"St. Marys, GA",2008,231,64,295,49713,5.93406151308511
41220,"St. Marys, GA",2009,181,396,577,50024,11.5344634575404
41220,"St. Marys, GA",2010,96,0,96,50660,1.89498618239242
41220,"St. Marys, GA",2011,90,0,90,50297,1.7893711354554
41220,"St. Marys, GA",2012,62,50,112,51341,2.18149237451549
41220,"St. Marys, GA",2013,69,0,69,51403,1.34233410501333
41220,"St. Marys, GA",2014,126,0,126,51918,2.42690396394314
41220,"St. Marys, GA",2015,140,0,140,52470,2.66819134743663
41220,"St. Marys, GA",2016,215,0,215,52438,4.10008009458789
41220,"St. Marys, GA",2017,322,76,398,53067,7.49995288974316
41220,"St. Marys, GA",2018,296,14,310,53677,5.77528550403339
41400,"Salem, OH",1990,98,15,113,108483,1.04163786030991
41400,"Salem, OH",1991,84,196,280,109299,2.56178007118089
41400,"Salem, OH",1992,49,39,88,110187,0.79864230807627
41400,"Salem, OH",1993,113,147,260,110813,2.34629510977954
41400,"Salem, OH",1994,87,0,87,111056,0.78338856072612
41400,"Salem, OH",1995,86,20,106,111254,0.95277473169504
41400,"Salem, OH",1996,94,10,104,111320,0.934243621990658
41400,"Salem, OH",1997,80,0,80,111344,0.718494036499497
41400,"Salem, OH",1998,131,20,151,111466,1.35467317388262
41400,"Salem, OH",1999,66,38,104,111505,0.932693601183803
41400,"Salem, OH",2000,55,85,140,112048,1.24946451520777
41400,"Salem, OH",2001,89,66,155,111370,1.39175720571069
41400,"Salem, OH",2002,80,22,102,111097,0.918116600808303
41400,"Salem, OH",2003,45,38,83,111000,0.747747747747748
41400,"Salem, OH",2004,105,37,142,110627,1.28359261301491
41400,"Salem, OH",2005,138,55,193,109784,1.75799752240764
41400,"Salem, OH",2006,115,10,125,109673,1.13975180764637
41400,"Salem, OH",2007,59,4,63,109153,0.577171493225106
41400,"Salem, OH",2008,50,2,52,108469,0.479399644137956
41400,"Salem, OH",2009,30,0,30,107948,0.277911587060437
41400,"Salem, OH",2010,19,0,19,107891,0.176103660175548
41400,"Salem, OH",2011,12,0,12,107408,0.111723521525398
41400,"Salem, OH",2012,18,0,18,106613,0.168834945081744
41400,"Salem, OH",2013,28,2,30,105953,0.283144413088822
41400,"Salem, OH",2014,16,0,16,105619,0.151487895170377
41400,"Salem, OH",2015,27,23,50,104734,0.477399889243226
41400,"Salem, OH",2016,32,58,90,103850,0.866634569090034
41400,"Salem, OH",2017,28,52,80,103149,0.775577077819465
41400,"Salem, OH",2018,19,33,52,102665,0.506501728924171
41420,"Salem, OR",1990,1096,1060,2156,279657,7.70944406898451
41420,"Salem, OR",1991,1174,1008,2182,286150,7.62537130875415
41420,"Salem, OR",1992,1406,754,2160,293095,7.36962418328528
41420,"Salem, OR",1993,1362,1050,2412,300323,8.03135291003353
41420,"Salem, OR",1994,1425,450,1875,306786,6.11175216600497
41420,"Salem, OR",1995,1325,1086,2411,312795,7.70792372000831
41420,"Salem, OR",1996,1696,1677,3373,318582,10.587541041239
41420,"Salem, OR",1997,1737,834,2571,324751,7.91683474415783
41420,"Salem, OR",1998,1625,732,2357,330254,7.13693096828502
41420,"Salem, OR",1999,1619,399,2018,334864,6.02632710592957
41420,"Salem, OR",2000,1360,324,1684,348007,4.83898312390268
41420,"Salem, OR",2001,1241,549,1790,351581,5.09128764068593
41420,"Salem, OR",2002,1552,408,1960,356668,5.49530655960165
41420,"Salem, OR",2003,1566,413,1979,360377,5.49147143130666
41420,"Salem, OR",2004,1963,597,2560,363708,7.03861339316155
41420,"Salem, OR",2005,2083,355,2438,368046,6.62417197850269
41420,"Salem, OR",2006,1729,624,2353,374317,6.28611577887192
41420,"Salem, OR",2007,1342,449,1791,379755,4.71619860173006
41420,"Salem, OR",2008,645,410,1055,384075,2.746859337369
41420,"Salem, OR",2009,510,325,835,388323,2.15027180980781
41420,"Salem, OR",2010,468,231,699,391496,1.78545885526289
41420,"Salem, OR",2011,319,112,431,393980,1.09396416061729
41420,"Salem, OR",2012,395,326,721,396138,1.82007280291212
41420,"Salem, OR",2013,646,304,950,398141,2.38608935025531
41420,"Salem, OR",2014,712,232,944,402269,2.34668840999431
41420,"Salem, OR",2015,807,490,1297,408278,3.17675701360348
41420,"Salem, OR",2016,814,664,1478,417284,3.54195224355595
41420,"Salem, OR",2017,790,765,1555,424968,3.65909903804522
41420,"Salem, OR",2018,1168,516,1684,432102,3.89722796932206
41460,"Salina, KS",1990,104,82,186,54957,3.38446421747912
41460,"Salina, KS",1991,110,4,114,55547,2.05231605667273
41460,"Salina, KS",1992,146,44,190,56045,3.39013292889642
41460,"Salina, KS",1993,194,2,196,56623,3.46149091358635
41460,"Salina, KS",1994,185,35,220,56959,3.8624273600309
41460,"Salina, KS",1995,200,4,204,57542,3.54523652288763
41460,"Salina, KS",1996,160,192,352,57613,6.10973217850138
41460,"Salina, KS",1997,181,24,205,57459,3.56776136027428
41460,"Salina, KS",1998,170,160,330,57314,5.75775552221098
41460,"Salina, KS",1999,124,8,132,57418,2.29893064892542
41460,"Salina, KS",2000,144,0,144,59851,2.40597483751316
41460,"Salina, KS",2001,143,72,215,60094,3.57772822577961
41460,"Salina, KS",2002,131,110,241,60345,3.99370287513464
41460,"Salina, KS",2003,149,0,149,60171,2.47627594688471
41460,"Salina, KS",2004,167,48,215,60290,3.56609719688174
41460,"Salina, KS",2005,137,54,191,60458,3.15921796949949
41460,"Salina, KS",2006,164,0,164,60586,2.70689598257023
41460,"Salina, KS",2007,160,3,163,60824,2.67986321189004
41460,"Salina, KS",2008,103,5,108,60948,1.77200236266982
41460,"Salina, KS",2009,96,0,96,61278,1.56663076471164
41460,"Salina, KS",2010,100,2,102,61879,1.64837828665622
41460,"Salina, KS",2011,60,36,96,61841,1.55236816998431
41460,"Salina, KS",2012,79,0,79,61864,1.27699469804733
41460,"Salina, KS",2013,71,10,81,61805,1.31057357818947
41460,"Salina, KS",2014,68,2,70,61553,1.1372313290985
41460,"Salina, KS",2015,77,8,85,61390,1.38459032415703
41460,"Salina, KS",2016,52,4,56,60885,0.91976677342531
41460,"Salina, KS",2017,69,30,99,60363,1.64007753093783
41460,"Salina, KS",2018,42,4,46,60203,0.764081524176536
41500,"Salinas, CA",1990,1027,156,1183,356944,3.31424537182303
41500,"Salinas, CA",1991,705,226,931,361795,2.57328044887298
41500,"Salinas, CA",1992,627,109,736,366352,2.00899681180941
41500,"Salinas, CA",1993,756,113,869,363093,2.39332622771576
41500,"Salinas, CA",1994,1305,173,1478,342577,4.31435852377714
41500,"Salinas, CA",1995,1119,207,1326,343334,3.86212842305161
41500,"Salinas, CA",1996,1168,334,1502,347526,4.32197878719866
41500,"Salinas, CA",1997,1334,351,1685,359135,4.69182897796093
41500,"Salinas, CA",1998,1178,11,1189,367279,3.23732094674621
41500,"Salinas, CA",1999,1484,574,2058,372745,5.52120082093657
41500,"Salinas, CA",2000,1505,209,1714,402990,4.25320727561478
41500,"Salinas, CA",2001,890,166,1056,407082,2.59407195601869
41500,"Salinas, CA",2002,1054,168,1222,408977,2.98794308726408
41500,"Salinas, CA",2003,1047,308,1355,409725,3.30709622307645
41500,"Salinas, CA",2004,1064,134,1198,408731,2.9310230934282
41500,"Salinas, CA",2005,1296,134,1430,405139,3.529652785834
41500,"Salinas, CA",2006,752,113,865,401831,2.1526462617369
41500,"Salinas, CA",2007,563,544,1107,402376,2.75115812076267
41500,"Salinas, CA",2008,236,220,456,406022,1.12309185216565
41500,"Salinas, CA",2009,113,81,194,410263,0.472867404567314
41500,"Salinas, CA",2010,112,167,279,416396,0.670035254901584
41500,"Salinas, CA",2011,130,26,156,420542,0.370949869454181
41500,"Salinas, CA",2012,110,136,246,425000,0.578823529411765
41500,"Salinas, CA",2013,190,246,436,427054,1.02094817048898
41500,"Salinas, CA",2014,236,125,361,428980,0.84153107370973
41500,"Salinas, CA",2015,315,272,587,431241,1.361187827688
41500,"Salinas, CA",2016,471,156,627,434767,1.44215177324866
41500,"Salinas, CA",2017,534,242,776,435477,1.7819540412008
41500,"Salinas, CA",2018,571,161,732,435594,1.6804639182357901
41540,"Salisbury, MD-DE",1990,2387,336,2723,247200,11.0153721682848
41540,"Salisbury, MD-DE",1991,1999,383,2382,251964,9.4537314854503
41540,"Salisbury, MD-DE",1992,2305,295,2600,256521,10.1356224246748
41540,"Salisbury, MD-DE",1993,2143,228,2371,261615,9.06293599373125
41540,"Salisbury, MD-DE",1994,2502,401,2903,266275,10.9022626983382
41540,"Salisbury, MD-DE",1995,2352,187,2539,270889,9.37284275108993
41540,"Salisbury, MD-DE",1996,2484,153,2637,275691,9.56505653068109
41540,"Salisbury, MD-DE",1997,2301,583,2884,279533,10.3172076284374
41540,"Salisbury, MD-DE",1998,2647,605,3252,283600,11.4668547249647
41540,"Salisbury, MD-DE",1999,2804,349,3153,287230,10.9772656059604
41540,"Salisbury, MD-DE",2000,2447,292,2739,313744,8.73004742720179
41540,"Salisbury, MD-DE",2001,2983,717,3700,319128,11.5940939058936
41540,"Salisbury, MD-DE",2002,3956,731,4687,325063,14.4187434435786
41540,"Salisbury, MD-DE",2003,4907,593,5500,332157,16.5584347161132
41540,"Salisbury, MD-DE",2004,5076,811,5887,338528,17.3899943283864
41540,"Salisbury, MD-DE",2005,4939,1656,6595,345704,19.0770138615694
41540,"Salisbury, MD-DE",2006,3544,1817,5361,353828,15.1514295081226
41540,"Salisbury, MD-DE",2007,2656,787,3443,360918,9.53956300323065
41540,"Salisbury, MD-DE",2008,1650,508,2158,366772,5.88376430043733
41540,"Salisbury, MD-DE",2009,1608,395,2003,370558,5.40536164379126
41540,"Salisbury, MD-DE",2010,1617,224,1841,374826,4.91161232145049
41540,"Salisbury, MD-DE",2011,1559,310,1869,378158,4.94237858249726
41540,"Salisbury, MD-DE",2012,1678,763,2441,381209,6.4033115692441704
41540,"Salisbury, MD-DE",2013,2203,1133,3336,384586,8.67426271367132
41540,"Salisbury, MD-DE",2014,2237,559,2796,388804,7.19128404028765
41540,"Salisbury, MD-DE",2015,2512,519,3031,393535,7.70198330516981
41540,"Salisbury, MD-DE",2016,2668,559,3227,398682,8.0941702911092
41540,"Salisbury, MD-DE",2017,3032,573,3605,404067,8.92178772332311
41540,"Salisbury, MD-DE",2018,3271,371,3642,409979,8.88338183175236
41620,"Salt Lake City, UT",1990,2273,230,2503,755696,3.31217844212488
41620,"Salt Lake City, UT",1991,3148,187,3335,773604,4.31099115309642
41620,"Salt Lake City, UT",1992,3979,241,4220,793547,5.31789547437014
41620,"Salt Lake City, UT",1993,4702,1584,6286,813693,7.72527230786058
41620,"Salt Lake City, UT",1994,4639,1246,5885,831311,7.07917975342561
41620,"Salt Lake City, UT",1995,5240,2359,7599,844590,8.9972649451213
41620,"Salt Lake City, UT",1996,6095,3128,9223,858057,10.7487031747308
41620,"Salt Lake City, UT",1997,4723,1347,6070,873407,6.9497954561848
41620,"Salt Lake City, UT",1998,5315,1664,6979,881252,7.91941465097384
41620,"Salt Lake City, UT",1999,4749,1444,6193,888453,6.97054318011195
41620,"Salt Lake City, UT",2000,4226,1058,5284,942537,5.60614596562257
41620,"Salt Lake City, UT",2001,4295,1719,6014,954081,6.30344803009388
41620,"Salt Lake City, UT",2002,4526,1686,6212,963150,6.44967035248923
41620,"Salt Lake City, UT",2003,5531,1986,7517,971454,7.73788568475708
41620,"Salt Lake City, UT",2004,5618,1342,6960,982034,7.08733098854011
41620,"Salt Lake City, UT",2005,6443,1892,8335,997221,8.35822751426213
41620,"Salt Lake City, UT",2006,5948,926,6874,1018281,6.75059241997052
41620,"Salt Lake City, UT",2007,3605,1488,5093,1037540,4.90872641054803
41620,"Salt Lake City, UT",2008,1603,2233,3836,1055462,3.63442738819588
41620,"Salt Lake City, UT",2009,1507,2803,4310,1074013,4.01298680742226
41620,"Salt Lake City, UT",2010,1795,951,2746,1091480,2.51585003847986
41620,"Salt Lake City, UT",2011,2041,1308,3349,1106739,3.02600703508235
41620,"Salt Lake City, UT",2012,2711,1053,3764,1123809,3.34932359502371
41620,"Salt Lake City, UT",2013,3280,2022,5302,1140176,4.650159273656
41620,"Salt Lake City, UT",2014,3159,2159,5318,1151703,4.61750989621456
41620,"Salt Lake City, UT",2015,3762,2993,6755,1165246,5.7970591617564
41620,"Salt Lake City, UT",2016,4351,4380,8731,1185219,7.36657107251909
41620,"Salt Lake City, UT",2017,4918,2449,7367,1205238,6.11248566673138
41620,"Salt Lake City, UT",2018,5391,3359,8750,1222540,7.1572300292833
41660,"San Angelo, TX",1990,131,0,131,98259,1.33321120711589
41660,"San Angelo, TX",1991,137,24,161,97927,1.64408181604665
41660,"San Angelo, TX",1992,197,2,199,99098,2.00811318089164
41660,"San Angelo, TX",1993,305,6,311,99644,3.12111115571434
41660,"San Angelo, TX",1994,254,8,262,100754,2.60039303650475
41660,"San Angelo, TX",1995,221,4,225,101064,2.22631203989551
41660,"San Angelo, TX",1996,252,224,476,101752,4.67804072647221
41660,"San Angelo, TX",1997,192,136,328,102262,3.20744753671941
41660,"San Angelo, TX",1998,230,270,500,102580,4.87424449210372
41660,"San Angelo, TX",1999,267,0,267,102311,2.60969006265211
41660,"San Angelo, TX",2000,239,8,247,104083,2.37310607880249
41660,"San Angelo, TX",2001,247,2,249,103923,2.39600473427441
41660,"San Angelo, TX",2002,251,0,251,104035,2.4126495890806
41660,"San Angelo, TX",2003,265,0,265,104330,2.54001725294738
41660,"San Angelo, TX",2004,231,4,235,104744,2.24356526388146
41660,"San Angelo, TX",2005,270,0,270,104974,2.57206546382914
41660,"San Angelo, TX",2006,369,120,489,106125,4.60777385159011
41660,"San Angelo, TX",2007,356,0,356,106680,3.33708286464192
41660,"San Angelo, TX",2008,259,0,259,107639,2.40619106457697
41660,"San Angelo, TX",2009,181,335,516,108879,4.73920590747527
41660,"San Angelo, TX",2010,177,0,177,110678,1.59923381340465
41660,"San Angelo, TX",2011,145,0,145,111740,1.2976552711652
41660,"San Angelo, TX",2012,229,176,405,113300,3.57458075904678
41660,"San Angelo, TX",2013,326,200,526,114676,4.58683595521295
41660,"San Angelo, TX",2014,229,400,629,116327,5.40717116404618
41660,"San Angelo, TX",2015,236,0,236,119044,1.98246026679211
41660,"San Angelo, TX",2016,172,0,172,119187,1.44311040633626
41660,"San Angelo, TX",2017,193,4,197,119200,1.65268456375839
41660,"San Angelo, TX",2018,262,0,262,119711,2.18860422183425
41700,"San Antonio-New Braunfels, TX",1990,1807,82,1889,1410639,1.33910943905563
41700,"San Antonio-New Braunfels, TX",1991,2198,58,2256,1432713,1.57463497574183
41700,"San Antonio-New Braunfels, TX",1992,3720,471,4191,1462873,2.86491035106944
41700,"San Antonio-New Braunfels, TX",1993,5102,1316,6418,1494583,4.29417436167814
41700,"San Antonio-New Braunfels, TX",1994,6547,3174,9721,1530235,6.35261904217326
41700,"San Antonio-New Braunfels, TX",1995,6638,1917,8555,1563832,5.47053647706403
41700,"San Antonio-New Braunfels, TX",1996,7185,2807,9992,1591855,6.27695361700657
41700,"San Antonio-New Braunfels, TX",1997,7101,2280,9381,1619734,5.79169172222106
41700,"San Antonio-New Braunfels, TX",1998,8899,1123,10022,1649461,6.07592419584337
41700,"San Antonio-New Braunfels, TX",1999,9085,5131,14216,1677170,8.47618309414072
41700,"San Antonio-New Braunfels, TX",2000,8789,2187,10976,1720003,6.3813842185159
41700,"San Antonio-New Braunfels, TX",2001,9529,3607,13136,1748123,7.51434538645164
41700,"San Antonio-New Braunfels, TX",2002,10484,2769,13253,1784153,7.42817460161769
41700,"San Antonio-New Braunfels, TX",2003,10976,2399,13375,1815846,7.3657127311457
41700,"San Antonio-New Braunfels, TX",2004,12634,4905,17539,1857602,9.44174263378269
41700,"San Antonio-New Braunfels, TX",2005,14706,7599,22305,1896328,11.7622056943735
41700,"San Antonio-New Braunfels, TX",2006,13841,5920,19761,1956361,10.1008965114312
41700,"San Antonio-New Braunfels, TX",2007,9350,3945,13295,2011543,6.60935411273833
41700,"San Antonio-New Braunfels, TX",2008,6010,4564,10574,2061275,5.12983468969449
41700,"San Antonio-New Braunfels, TX",2009,5486,438,5924,2105672,2.81335364672181
41700,"San Antonio-New Braunfels, TX",2010,5144,1721,6865,2153038,3.1885178060025
41700,"San Antonio-New Braunfels, TX",2011,4410,2717,7127,2193881,3.2485809394402
41700,"San Antonio-New Braunfels, TX",2012,5102,2902,8004,2237358,3.57743374104636
41700,"San Antonio-New Braunfels, TX",2013,5827,301,6128,2280585,2.68702986295183
41700,"San Antonio-New Braunfels, TX",2014,6220,4112,10332,2329756,4.43479918068673
41700,"San Antonio-New Braunfels, TX",2015,6478,1346,7824,2380630,3.28652499548439
41700,"San Antonio-New Braunfels, TX",2016,6464,5777,12241,2428326,5.04092119427128
41700,"San Antonio-New Braunfels, TX",2017,7535,4981,12516,2474274,5.0584535099993
41700,"San Antonio-New Braunfels, TX",2018,8013,3484,11497,2518036,4.56586005918899
41740,"San Diego-Carlsbad, CA",1990,6652,9080,15732,2513306,6.25948451959292
41740,"San Diego-Carlsbad, CA",1991,5365,2526,7891,2557889,3.08496576669277
41740,"San Diego-Carlsbad, CA",1992,3812,2259,6071,2601821,2.33336574652907
41740,"San Diego-Carlsbad, CA",1993,4229,1521,5750,2612401,2.20104034564372
41740,"San Diego-Carlsbad, CA",1994,5236,1707,6943,2631330,2.63858961057716
41740,"San Diego-Carlsbad, CA",1995,4765,1868,6633,2644373,2.50834507839855
41740,"San Diego-Carlsbad, CA",1996,5831,1017,6848,2676468,2.55859588083997
41740,"San Diego-Carlsbad, CA",1997,8236,2903,11139,2722036,4.09215748799795
41740,"San Diego-Carlsbad, CA",1998,9012,2879,11891,2770856,4.29145361577794
41740,"San Diego-Carlsbad, CA",1999,10070,6225,16295,2828698,5.76060081351915
41740,"San Diego-Carlsbad, CA",2000,9287,6305,15592,2827366,5.51467337444109
41740,"San Diego-Carlsbad, CA",2001,9377,6028,15405,2869672,5.36820932845287
41740,"San Diego-Carlsbad, CA",2002,8880,4804,13684,2900355,4.71804313609886
41740,"San Diego-Carlsbad, CA",2003,9758,8273,18031,2914702,6.18622418346713
41740,"San Diego-Carlsbad, CA",2004,9122,6465,15587,2930007,5.31978251246499
41740,"San Diego-Carlsbad, CA",2005,7576,6730,14306,2938375,4.86867741523801
41740,"San Diego-Carlsbad, CA",2006,4743,4448,9191,2947289,3.11845903133354
41740,"San Diego-Carlsbad, CA",2007,3422,4013,7435,2975742,2.49853649946803
41740,"San Diego-Carlsbad, CA",2008,2361,2996,5357,3022116,1.77259906634954
41740,"San Diego-Carlsbad, CA",2009,1778,1168,2946,3061203,0.962366755814626
41740,"San Diego-Carlsbad, CA",2010,2270,1224,3494,3103306,1.12589606052384
41740,"San Diego-Carlsbad, CA",2011,2245,3125,5370,3137372,1.71162361364862
41740,"San Diego-Carlsbad, CA",2012,2197,3469,5666,3175201,1.78445396055242
41740,"San Diego-Carlsbad, CA",2013,2565,5699,8264,3211248,2.573454308107
41740,"San Diego-Carlsbad, CA",2014,2487,4388,6875,3250993,2.11473848144244
41740,"San Diego-Carlsbad, CA",2015,3222,6661,9883,3284061,3.00938380864424
41740,"San Diego-Carlsbad, CA",2016,2351,8440,10791,3310280,3.25984508863299
41740,"San Diego-Carlsbad, CA",2017,4056,6385,10441,3325468,3.13970845607295
41740,"San Diego-Carlsbad, CA",2018,3489,6345,9834,3343364,2.94134889291145
41760,"Sandpoint, ID",1990,163,52,215,26760,8.03437967115097
41760,"Sandpoint, ID",1991,192,8,200,27923,7.16255416681589
41760,"Sandpoint, ID",1992,270,61,331,28905,11.4513060024217
41760,"Sandpoint, ID",1993,314,36,350,30240,11.5740740740741
41760,"Sandpoint, ID",1994,348,62,410,31838,12.8776933224449
41760,"Sandpoint, ID",1995,314,61,375,33029,11.35365890581
41760,"Sandpoint, ID",1996,112,44,156,33963,4.59323381326738
41760,"Sandpoint, ID",1997,37,26,63,34730,1.81399366541895
41760,"Sandpoint, ID",1998,68,12,80,35338,2.26385194408286
41760,"Sandpoint, ID",1999,47,26,73,35926,2.03195457328954
41760,"Sandpoint, ID",2000,19,4,23,36950,0.622462787550744
41760,"Sandpoint, ID",2001,29,7,36,36980,0.973499188750676
41760,"Sandpoint, ID",2002,25,4,29,37634,0.770579794866344
41760,"Sandpoint, ID",2003,57,24,81,38382,2.11036423323433
41760,"Sandpoint, ID",2004,73,84,157,38836,4.04264084869709
41760,"Sandpoint, ID",2005,13,0,13,39576,0.328481908227208
41760,"Sandpoint, ID",2006,9,42,51,40127,1.2709646871184
41760,"Sandpoint, ID",2007,62,0,62,40738,1.52192056556532
41760,"Sandpoint, ID",2008,7,15,22,40966,0.537030708392325
41760,"Sandpoint, ID",2009,3,0,3,40809,0.0735131956186135
41760,"Sandpoint, ID",2010,17,0,17,40908,0.415566637332551
41760,"Sandpoint, ID",2011,0,51,51,40781,1.25058237904907
41760,"Sandpoint, ID",2012,19,55,74,40347,1.83408927553474
41760,"Sandpoint, ID",2013,55,8,63,40528,1.55448085274378
41760,"Sandpoint, ID",2014,47,8,55,41289,1.33207391799269
41760,"Sandpoint, ID",2015,48,10,58,41587,1.39466660254406
41760,"Sandpoint, ID",2016,56,74,130,42333,3.07089032197104
41760,"Sandpoint, ID",2017,107,27,134,43621,3.07191490337223
41760,"Sandpoint, ID",2018,91,8,99,44727,2.21342813065933
41780,"Sandusky, OH",1990,323,243,566,76865,7.363559487413
41780,"Sandusky, OH",1991,340,67,407,76980,5.28708755520914
41780,"Sandusky, OH",1992,330,105,435,77261,5.6302662404059
41780,"Sandusky, OH",1993,276,31,307,77592,3.95659346324363
41780,"Sandusky, OH",1994,341,88,429,77793,5.51463499286568
41780,"Sandusky, OH",1995,292,67,359,78548,4.57045373529562
41780,"Sandusky, OH",1996,294,77,371,78834,4.706091280412
41780,"Sandusky, OH",1997,239,56,295,78601,3.75313291179502
41780,"Sandusky, OH",1998,237,44,281,78194,3.59362610942016
41780,"Sandusky, OH",1999,243,236,479,77656,6.16822911301123
41780,"Sandusky, OH",2000,277,32,309,79662,3.87888830308051
41780,"Sandusky, OH",2001,198,50,248,79308,3.12704897362183
41780,"Sandusky, OH",2002,191,13,204,78762,2.59008151138874
41780,"Sandusky, OH",2003,208,126,334,78673,4.24542091950224
41780,"Sandusky, OH",2004,246,110,356,78596,4.529492595043
41780,"Sandusky, OH",2005,223,200,423,78070,5.41821442295376
41780,"Sandusky, OH",2006,172,24,196,77876,2.51682161384766
41780,"Sandusky, OH",2007,103,24,127,77668,1.63516506154401
41780,"Sandusky, OH",2008,55,0,55,77573,0.709009578074846
41780,"Sandusky, OH",2009,43,4,47,77085,0.609716546669261
41780,"Sandusky, OH",2010,47,0,47,76985,0.610508540624797
41780,"Sandusky, OH",2011,48,0,48,76685,0.625937275868814
41780,"Sandusky, OH",2012,40,4,44,76429,0.575697706368002
41780,"Sandusky, OH",2013,80,0,80,76056,1.05185652676975
41780,"Sandusky, OH",2014,57,0,57,75814,0.751840029545994
41780,"Sandusky, OH",2015,77,8,85,75369,1.12778463293927
41780,"Sandusky, OH",2016,96,36,132,75023,1.75946043213415
41780,"Sandusky, OH",2017,86,10,96,74857,1.2824451955061
41780,"Sandusky, OH",2018,71,0,71,74615,0.951551296656168
41820,"Sanford, NC",1990,137,2,139,41565,3.34415974978949
41820,"Sanford, NC",1991,148,13,161,42150,3.8196915776987
41820,"Sanford, NC",1992,202,164,366,42979,8.51578677959003
41820,"Sanford, NC",1993,204,0,204,44037,4.63246815178146
41820,"Sanford, NC",1994,258,42,300,44903,6.68106808008374
41820,"Sanford, NC",1995,218,80,298,46089,6.46575104688754
41820,"Sanford, NC",1996,202,0,202,47187,4.28084006188145
41820,"Sanford, NC",1997,203,157,360,48176,7.47260046496181
41820,"Sanford, NC",1998,284,64,348,49216,7.07087126137841
41820,"Sanford, NC",1999,219,189,408,49507,8.24125881188519
41820,"Sanford, NC",2000,231,0,231,49482,4.668364253668
41820,"Sanford, NC",2001,244,0,244,49853,4.89438950514513
41820,"Sanford, NC",2002,242,132,374,49313,7.58420700423823
41820,"Sanford, NC",2003,339,0,339,49372,6.86623997407437
41820,"Sanford, NC",2004,362,40,402,49747,8.08088929985728
41820,"Sanford, NC",2005,363,194,557,51056,10.9095894703855
41820,"Sanford, NC",2006,384,168,552,52642,10.4859237870902
41820,"Sanford, NC",2007,307,0,307,54106,5.67404724060178
41820,"Sanford, NC",2008,179,0,179,55822,3.20662104546594
41820,"Sanford, NC",2009,109,0,109,57359,1.90031206959675
41820,"Sanford, NC",2010,114,0,114,57886,1.96938810765988
41820,"Sanford, NC",2011,104,0,104,58539,1.77659338218965
41820,"Sanford, NC",2012,76,0,76,59259,1.28250561096205
41820,"Sanford, NC",2013,72,0,72,59785,1.20431546374509
41820,"Sanford, NC",2014,71,0,71,59430,1.19468282012452
41820,"Sanford, NC",2015,81,0,81,59440,1.36271870794078
41820,"Sanford, NC",2016,98,0,98,59737,1.64052429817366
41820,"Sanford, NC",2017,188,0,188,60567,3.10400052834052
41820,"Sanford, NC",2018,158,0,158,61452,2.57111241294018
41860,"San Francisco-Oakland-Hayward, CA",1990,5918,3784,9702,3718380,2.60920078098527
41860,"San Francisco-Oakland-Hayward, CA",1991,4971,4073,9044,3753808,2.40928678291484
41860,"San Francisco-Oakland-Hayward, CA",1992,6299,2527,8826,3793643,2.32652360804641
41860,"San Francisco-Oakland-Hayward, CA",1993,5380,2104,7484,3822287,1.95799007243569
41860,"San Francisco-Oakland-Hayward, CA",1994,6921,2240,9161,3837232,2.38739799939123
41860,"San Francisco-Oakland-Hayward, CA",1995,6489,2107,8596,3855836,2.22934792869821
41860,"San Francisco-Oakland-Hayward, CA",1996,6999,3050,10049,3889620,2.58354286536988
41860,"San Francisco-Oakland-Hayward, CA",1997,8758,4879,13637,3946348,3.45559996229425
41860,"San Francisco-Oakland-Hayward, CA",1998,8704,6531,15235,4000012,3.80873857378428
41860,"San Francisco-Oakland-Hayward, CA",1999,10516,4686,15202,4038712,3.76407131778646
41860,"San Francisco-Oakland-Hayward, CA",2000,8917,6196,15113,4135875,3.654123976184
41860,"San Francisco-Oakland-Hayward, CA",2001,6928,4173,11101,4174788,2.6590571784723
41860,"San Francisco-Oakland-Hayward, CA",2002,8654,3887,12541,4158544,3.01571896317557
41860,"San Francisco-Oakland-Hayward, CA",2003,8683,6145,14828,4145965,3.57648943008443
41860,"San Francisco-Oakland-Hayward, CA",2004,7986,7253,15239,4133400,3.68679537426816
41860,"San Francisco-Oakland-Hayward, CA",2005,8102,6781,14883,4137858,3.59678848331673
41860,"San Francisco-Oakland-Hayward, CA",2006,5900,8583,14483,4148724,3.49095288093399
41860,"San Francisco-Oakland-Hayward, CA",2007,5055,5505,10560,4183637,2.52411956391054
41860,"San Francisco-Oakland-Hayward, CA",2008,2359,5196,7555,4243932,1.78018874948986
41860,"San Francisco-Oakland-Hayward, CA",2009,2271,1279,3550,4302830,0.825038404956738
41860,"San Francisco-Oakland-Hayward, CA",2010,2118,2503,4621,4343782,1.06381950107073
41860,"San Francisco-Oakland-Hayward, CA",2011,1923,3860,5783,4395894,1.3155458252633
41860,"San Francisco-Oakland-Hayward, CA",2012,3095,6068,9163,4456395,2.05614627967225
41860,"San Francisco-Oakland-Hayward, CA",2013,3659,7263,10922,4521312,2.41567049564374
41860,"San Francisco-Oakland-Hayward, CA",2014,3716,6285,10001,4587253,2.18017188064404
41860,"San Francisco-Oakland-Hayward, CA",2015,4804,8582,13386,4649539,2.87899510037447
41860,"San Francisco-Oakland-Hayward, CA",2016,4967,9820,14787,4689132,3.15346209063852
41860,"San Francisco-Oakland-Hayward, CA",2017,4777,12175,16952,4710693,3.59862126442967
41860,"San Francisco-Oakland-Hayward, CA",2018,4048,13373,17421,4729484,3.68348851587192
41940,"San Jose-Sunnyvale-Santa Clara, CA",1990,2009,3256,5265,1534746,3.43053508528447
41940,"San Jose-Sunnyvale-Santa Clara, CA",1991,1885,2125,4010,1548435,2.58971154746567
41940,"San Jose-Sunnyvale-Santa Clara, CA",1992,2019,1397,3416,1566526,2.18062132387206
41940,"San Jose-Sunnyvale-Santa Clara, CA",1993,2213,1653,3866,1583321,2.44170323010937
41940,"San Jose-Sunnyvale-Santa Clara, CA",1994,2606,1851,4457,1595108,2.79416816917726
41940,"San Jose-Sunnyvale-Santa Clara, CA",1995,2590,1235,3825,1613793,2.37019245962772
41940,"San Jose-Sunnyvale-Santa Clara, CA",1996,4470,3544,8014,1642234,4.87993793819882
41940,"San Jose-Sunnyvale-Santa Clara, CA",1997,4789,4059,8848,1671610,5.29310066343226
41940,"San Jose-Sunnyvale-Santa Clara, CA",1998,4445,3628,8073,1693652,4.76662265920035
41940,"San Jose-Sunnyvale-Santa Clara, CA",1999,3745,3557,7302,1706762,4.27827664314064
41940,"San Jose-Sunnyvale-Santa Clara, CA",2000,3379,3798,7177,1738728,4.12773015675827
41940,"San Jose-Sunnyvale-Santa Clara, CA",2001,1923,4378,6301,1742726,3.615599927929
41940,"San Jose-Sunnyvale-Santa Clara, CA",2002,2239,2382,4621,1724404,2.67976645844013
41940,"San Jose-Sunnyvale-Santa Clara, CA",2003,2565,4538,7103,1718790,4.13255836955067
41940,"San Jose-Sunnyvale-Santa Clara, CA",2004,2787,2705,5492,1718016,3.19671062434809
41940,"San Jose-Sunnyvale-Santa Clara, CA",2005,2416,3320,5736,1729959,3.31568551624634
41940,"San Jose-Sunnyvale-Santa Clara, CA",2006,2151,3999,6150,1745283,3.52378382187874
41940,"San Jose-Sunnyvale-Santa Clara, CA",2007,1955,2239,4194,1766098,2.37472665729761
41940,"San Jose-Sunnyvale-Santa Clara, CA",2008,958,2532,3490,1795231,1.94403951357792
41940,"San Jose-Sunnyvale-Santa Clara, CA",2009,642,452,1094,1819573,0.601239961243654
41940,"San Jose-Sunnyvale-Santa Clara, CA",2010,861,3318,4179,1841596,2.26922734410805
41940,"San Jose-Sunnyvale-Santa Clara, CA",2011,1002,2095,3097,1868148,1.65779156683518
41940,"San Jose-Sunnyvale-Santa Clara, CA",2012,1501,4031,5532,1894984,2.91928586204422
41940,"San Jose-Sunnyvale-Santa Clara, CA",2013,1870,5894,7764,1924569,4.03414998371064
41940,"San Jose-Sunnyvale-Santa Clara, CA",2014,1861,8176,10037,1950851,5.14493418513254
41940,"San Jose-Sunnyvale-Santa Clara, CA",2015,1897,3891,5788,1975724,2.92955898698401
41940,"San Jose-Sunnyvale-Santa Clara, CA",2016,2099,4068,6167,1988816,3.10083989670236
41940,"San Jose-Sunnyvale-Santa Clara, CA",2017,2592,5947,8539,1993582,4.28324493298996
41940,"San Jose-Sunnyvale-Santa Clara, CA",2018,2466,6278,8744,1999107,4.37395297000111
42020,"San Luis Obispo-Paso Robles-Arroyo Grande, CA",1990,1223,382,1605,218112,7.35860475352113
42020,"San Luis Obispo-Paso Robles-Arroyo Grande, CA",1991,989,98,1087,219069,4.96190697907965
42020,"San Luis Obispo-Paso Robles-Arroyo Grande, CA",1992,627,42,669,220347,3.03612030116135
42020,"San Luis Obispo-Paso Robles-Arroyo Grande, CA",1993,781,78,859,221193,3.88348636710927
42020,"San Luis Obispo-Paso Robles-Arroyo Grande, CA",1994,992,88,1080,223351,4.83543839069447
42020,"San Luis Obispo-Paso Robles-Arroyo Grande, CA",1995,853,63,916,225775,4.05713652973093
42020,"San Luis Obispo-Paso Robles-Arroyo Grande, CA",1996,1067,89,1156,228638,5.05602743201043
42020,"San Luis Obispo-Paso Robles-Arroyo Grande, CA",1997,1212,74,1286,231503,5.55500360686471
42020,"San Luis Obispo-Paso Robles-Arroyo Grande, CA",1998,1637,50,1687,234149,7.20481402867405
42020,"San Luis Obispo-Paso Robles-Arroyo Grande, CA",1999,1547,101,1648,236818,6.95893048670287
42020,"San Luis Obispo-Paso Robles-Arroyo Grande, CA",2000,1541,132,1673,247839,6.75035002562147
42020,"San Luis Obispo-Paso Robles-Arroyo Grande, CA",2001,1709,234,1943,251462,7.72681359410169
42020,"San Luis Obispo-Paso Robles-Arroyo Grande, CA",2002,1690,303,1993,253083,7.87488689481316
42020,"San Luis Obispo-Paso Robles-Arroyo Grande, CA",2003,1983,277,2260,254674,8.87409001311481
42020,"San Luis Obispo-Paso Robles-Arroyo Grande, CA",2004,2043,407,2450,256842,9.5389383356304691
42020,"San Luis Obispo-Paso Robles-Arroyo Grande, CA",2005,1875,441,2316,258615,8.95539701873441
42020,"San Luis Obispo-Paso Robles-Arroyo Grande, CA",2006,1388,376,1764,260498,6.77164507980867
42020,"San Luis Obispo-Paso Robles-Arroyo Grande, CA",2007,919,347,1266,262770,4.81790158693915
42020,"San Luis Obispo-Paso Robles-Arroyo Grande, CA",2008,518,156,674,266358,2.53042897153455
42020,"San Luis Obispo-Paso Robles-Arroyo Grande, CA",2009,321,73,394,268145,1.46935426728076
42020,"San Luis Obispo-Paso Robles-Arroyo Grande, CA",2010,308,160,468,269805,1.73458608995386
42020,"San Luis Obispo-Paso Robles-Arroyo Grande, CA",2011,266,40,306,271050,1.1289429994466
42020,"San Luis Obispo-Paso Robles-Arroyo Grande, CA",2012,335,82,417,274184,1.520876491699
42020,"San Luis Obispo-Paso Robles-Arroyo Grande, CA",2013,495,152,647,275751,2.34631968696396
42020,"San Luis Obispo-Paso Robles-Arroyo Grande, CA",2014,812,171,983,278296,3.53221030844856
42020,"San Luis Obispo-Paso Robles-Arroyo Grande, CA",2015,692,129,821,280171,2.93035324855178
42020,"San Luis Obispo-Paso Robles-Arroyo Grande, CA",2016,583,270,853,281958,3.02527326764979
42020,"San Luis Obispo-Paso Robles-Arroyo Grande, CA",2017,693,401,1094,282838,3.86793853725454
42020,"San Luis Obispo-Paso Robles-Arroyo Grande, CA",2018,692,358,1050,284010,3.69705292067181
42100,"Santa Cruz-Watsonville, CA",1990,405,148,553,229396,2.41067847739281
42100,"Santa Cruz-Watsonville, CA",1991,318,116,434,228834,1.89657131370338
42100,"Santa Cruz-Watsonville, CA",1992,279,350,629,230907,2.72404041453919
42100,"Santa Cruz-Watsonville, CA",1993,279,67,346,232467,1.48838329741426
42100,"Santa Cruz-Watsonville, CA",1994,424,91,515,233869,2.20208749342581
42100,"Santa Cruz-Watsonville, CA",1995,358,79,437,234553,1.8631183570451
42100,"Santa Cruz-Watsonville, CA",1996,372,135,507,235458,2.15325026119308
42100,"Santa Cruz-Watsonville, CA",1997,517,216,733,238624,3.07177819498458
42100,"Santa Cruz-Watsonville, CA",1998,378,181,559,243090,2.29955983380641
42100,"Santa Cruz-Watsonville, CA",1999,333,132,465,244848,1.8991374240345
42100,"Santa Cruz-Watsonville, CA",2000,390,155,545,255835,2.1302792815682
42100,"Santa Cruz-Watsonville, CA",2001,432,168,600,256045,2.34333808510223
42100,"Santa Cruz-Watsonville, CA",2002,412,196,608,254531,2.38870707300879
42100,"Santa Cruz-Watsonville, CA",2003,663,403,1066,253021,4.21308903213567
42100,"Santa Cruz-Watsonville, CA",2004,736,65,801,252356,3.1740874003392
42100,"Santa Cruz-Watsonville, CA",2005,673,188,861,251377,3.42513435994542
42100,"Santa Cruz-Watsonville, CA",2006,539,172,711,251616,2.82573445249905
42100,"Santa Cruz-Watsonville, CA",2007,321,521,842,253304,3.32406910273821
42100,"Santa Cruz-Watsonville, CA",2008,215,102,317,256520,1.23577108997349
42100,"Santa Cruz-Watsonville, CA",2009,132,17,149,260009,0.573057086485468
42100,"Santa Cruz-Watsonville, CA",2010,119,39,158,263167,0.60037922687875
42100,"Santa Cruz-Watsonville, CA",2011,99,109,208,264882,0.785255321237381
42100,"Santa Cruz-Watsonville, CA",2012,169,68,237,266416,0.889586211038376
42100,"Santa Cruz-Watsonville, CA",2013,173,121,294,268940,1.09318063508589
42100,"Santa Cruz-Watsonville, CA",2014,172,119,291,271035,1.07366207316398
42100,"Santa Cruz-Watsonville, CA",2015,202,133,335,273730,1.22383370474555
42100,"Santa Cruz-Watsonville, CA",2016,223,266,489,274702,1.78011081098791
42100,"Santa Cruz-Watsonville, CA",2017,218,189,407,275105,1.47943512477054
42100,"Santa Cruz-Watsonville, CA",2018,238,188,426,274255,1.55329893712056
42140,"Santa Fe, NM",1990,327,156,483,99504,4.85407621804149
42140,"Santa Fe, NM",1991,291,13,304,102109,2.97721062785847
42140,"Santa Fe, NM",1992,389,12,401,105235,3.81051931391647
42140,"Santa Fe, NM",1993,321,126,447,108740,4.11072282508736
42140,"Santa Fe, NM",1994,411,104,515,112339,4.58433847550717
42140,"Santa Fe, NM",1995,244,40,284,116405,2.43975774236502
42140,"Santa Fe, NM",1996,331,0,331,118534,2.79244773651442
42140,"Santa Fe, NM",1997,360,189,549,121208,4.52940399973599
42140,"Santa Fe, NM",1998,412,19,431,122544,3.51710406058232
42140,"Santa Fe, NM",1999,378,403,781,124088,6.29392044355619
42140,"Santa Fe, NM",2000,354,41,395,129713,3.04518436856753
42140,"Santa Fe, NM",2001,472,65,537,131057,4.09745377965313
42140,"Santa Fe, NM",2002,582,22,604,133555,4.52248137471454
42140,"Santa Fe, NM",2003,561,0,561,135213,4.14900934081782
42140,"Santa Fe, NM",2004,561,0,561,136391,4.11317462295899
42140,"Santa Fe, NM",2005,580,0,580,137610,4.21480997020565
42140,"Santa Fe, NM",2006,417,0,417,138786,3.0046258268125
42140,"Santa Fe, NM",2007,277,0,277,140210,1.97560801654661
42140,"Santa Fe, NM",2008,140,0,140,141704,0.98797493366454
42140,"Santa Fe, NM",2009,102,0,102,143205,0.712265633183199
42140,"Santa Fe, NM",2010,96,0,96,144528,0.66423115244105
42140,"Santa Fe, NM",2011,94,0,94,145837,0.644555222611546
42140,"Santa Fe, NM",2012,130,0,130,146722,0.886029361649923
42140,"Santa Fe, NM",2013,159,24,183,147487,1.24078732362852
42140,"Santa Fe, NM",2014,161,0,161,147819,1.08916986314344
42140,"Santa Fe, NM",2015,110,0,110,148206,0.742210166929814
42140,"Santa Fe, NM",2016,117,0,117,148888,0.78582558701843
42140,"Santa Fe, NM",2017,221,0,221,149617,1.47710487444609
42140,"Santa Fe, NM",2018,243,30,273,150056,1.81932078690622
42200,"Santa Maria-Santa Barbara, CA",1990,886,393,1279,370422,3.45281867707642
42200,"Santa Maria-Santa Barbara, CA",1991,752,369,1121,374183,2.99586031433817
42200,"Santa Maria-Santa Barbara, CA",1992,549,363,912,376681,2.42114680591801
42200,"Santa Maria-Santa Barbara, CA",1993,477,96,573,378149,1.51527572464822
42200,"Santa Maria-Santa Barbara, CA",1994,562,143,705,381700,1.84700026198585
42200,"Santa Maria-Santa Barbara, CA",1995,605,188,793,381466,2.07882222793119
42200,"Santa Maria-Santa Barbara, CA",1996,693,87,780,382389,2.03980763044962
42200,"Santa Maria-Santa Barbara, CA",1997,544,337,881,386931,2.2768917455567
42200,"Santa Maria-Santa Barbara, CA",1998,902,112,1014,389747,2.60168776154788
42200,"Santa Maria-Santa Barbara, CA",1999,623,187,810,391292,2.07006532206127
42200,"Santa Maria-Santa Barbara, CA",2000,759,108,867,399990,2.16755418885472
42200,"Santa Maria-Santa Barbara, CA",2001,915,111,1026,403164,2.54487007768551
42200,"Santa Maria-Santa Barbara, CA",2002,953,743,1696,405178,4.18581462961957
42200,"Santa Maria-Santa Barbara, CA",2003,1085,376,1461,406810,3.59135714461296
42200,"Santa Maria-Santa Barbara, CA",2004,950,549,1499,407284,3.68047848675617
42200,"Santa Maria-Santa Barbara, CA",2005,763,287,1050,408079,2.57303120229171
42200,"Santa Maria-Santa Barbara, CA",2006,690,183,873,408085,2.13926020314395
42200,"Santa Maria-Santa Barbara, CA",2007,470,241,711,411243,1.72890480810616
42200,"Santa Maria-Santa Barbara, CA",2008,222,183,405,415859,0.973887784080662
42200,"Santa Maria-Santa Barbara, CA",2009,186,40,226,420356,0.53763952459344
42200,"Santa Maria-Santa Barbara, CA",2010,229,171,400,424235,0.942873643145898
42200,"Santa Maria-Santa Barbara, CA",2011,134,97,231,425481,0.542914959774937
42200,"Santa Maria-Santa Barbara, CA",2012,255,206,461,429825,1.07252951782702
42200,"Santa Maria-Santa Barbara, CA",2013,370,35,405,434823,0.93141347168848
42200,"Santa Maria-Santa Barbara, CA",2014,372,383,755,439358,1.7184164166807
42200,"Santa Maria-Santa Barbara, CA",2015,411,671,1082,442522,2.44507617700363
42200,"Santa Maria-Santa Barbara, CA",2016,455,387,842,444675,1.89351773767358
42200,"Santa Maria-Santa Barbara, CA",2017,832,448,1280,445606,2.87249274022343
42200,"Santa Maria-Santa Barbara, CA",2018,631,297,928,446527,2.07826178484168
42220,"Santa Rosa, CA",1990,2662,983,3645,390163,9.34224926505076
42220,"Santa Rosa, CA",1991,2046,156,2202,396247,5.55713986478131
42220,"Santa Rosa, CA",1992,1817,159,1976,402054,4.91476269356853
42220,"Santa Rosa, CA",1993,1686,252,1938,406165,4.77145987468147
42220,"Santa Rosa, CA",1994,2177,334,2511,410174,6.12179221501119
42220,"Santa Rosa, CA",1995,1608,322,1930,414810,4.65273257636026
42220,"Santa Rosa, CA",1996,1412,75,1487,419389,3.54563424410273
42220,"Santa Rosa, CA",1997,1785,176,1961,426503,4.59785745938481
42220,"Santa Rosa, CA",1998,2098,964,3062,433585,7.06205242340026
42220,"Santa Rosa, CA",1999,2348,688,3036,439412,6.90923324806787
42220,"Santa Rosa, CA",2000,2013,492,2505,460421,5.44067277556845
42220,"Santa Rosa, CA",2001,1717,866,2583,465293,5.55134076807517
42220,"Santa Rosa, CA",2002,1350,578,1928,465298,4.14358110286311
42220,"Santa Rosa, CA",2003,1503,749,2252,466489,4.82755220380331
42220,"Santa Rosa, CA",2004,1342,587,1929,466809,4.13231107369395
42220,"Santa Rosa, CA",2005,1598,1221,2819,465938,6.05016118024287
42220,"Santa Rosa, CA",2006,1357,555,1912,465188,4.11016621237005
42220,"Santa Rosa, CA",2007,910,521,1431,467356,3.06190569929561
42220,"Santa Rosa, CA",2008,544,68,612,473091,1.29362004350114
42220,"Santa Rosa, CA",2009,371,71,442,479479,0.921833907220129
42220,"Santa Rosa, CA",2010,287,190,477,484776,0.983959601960493
42220,"Santa Rosa, CA",2011,449,183,632,487423,1.29661505509588
42220,"Santa Rosa, CA",2012,312,248,560,490071,1.14269156918079
42220,"Santa Rosa, CA",2013,453,593,1046,494243,2.11636785953468
42220,"Santa Rosa, CA",2014,419,244,663,498803,1.32918206185608
42220,"Santa Rosa, CA",2015,431,190,621,501346,1.23866551244051
42220,"Santa Rosa, CA",2016,621,298,919,503249,1.82613378268014
42220,"Santa Rosa, CA",2017,840,338,1178,503246,2.34080350365428
42220,"Santa Rosa, CA",2018,3169,110,3279,499942,6.55876081625469
42300,"Sault Ste. Marie, MI",1990,121,23,144,34771,4.14138218630468
42300,"Sault Ste. Marie, MI",1991,159,0,159,35320,4.50169875424689
42300,"Sault Ste. Marie, MI",1992,167,0,167,35546,4.69813762448658
42300,"Sault Ste. Marie, MI",1993,185,16,201,36065,5.57327048384861
42300,"Sault Ste. Marie, MI",1994,242,30,272,36498,7.45246314866568
42300,"Sault Ste. Marie, MI",1995,242,14,256,36794,6.95765613958798
42300,"Sault Ste. Marie, MI",1996,211,28,239,37345,6.39978578122908
42300,"Sault Ste. Marie, MI",1997,213,28,241,37753,6.38359865441157
42300,"Sault Ste. Marie, MI",1998,234,12,246,37895,6.49162158596121
42300,"Sault Ste. Marie, MI",1999,247,0,247,37739,6.54495349638305
42300,"Sault Ste. Marie, MI",2000,199,0,199,38593,5.15637550851191
42300,"Sault Ste. Marie, MI",2001,220,26,246,38518,6.38662443532894
42300,"Sault Ste. Marie, MI",2002,155,16,171,38748,4.41313100030969
42300,"Sault Ste. Marie, MI",2003,145,44,189,38789,4.87251540385161
42300,"Sault Ste. Marie, MI",2004,132,218,350,38803,9.01992114011803
42300,"Sault Ste. Marie, MI",2005,89,26,115,38990,2.94947422416004
42300,"Sault Ste. Marie, MI",2006,92,0,92,39051,2.3558935750685
42300,"Sault Ste. Marie, MI",2007,74,0,74,39314,1.88228112122908
42300,"Sault Ste. Marie, MI",2008,45,0,45,39247,1.14658445231483
42300,"Sault Ste. Marie, MI",2009,49,24,73,39174,1.86348088017563
42300,"Sault Ste. Marie, MI",2010,45,15,60,38611,1.55396130636347
42300,"Sault Ste. Marie, MI",2011,43,0,43,38877,1.10605242174036
42300,"Sault Ste. Marie, MI",2012,39,0,39,38981,1.00048741694672
42300,"Sault Ste. Marie, MI",2013,50,0,50,38560,1.29668049792531
42300,"Sault Ste. Marie, MI",2014,38,0,38,38242,0.993671879085822
42300,"Sault Ste. Marie, MI",2015,48,0,48,37980,1.26382306477093
42300,"Sault Ste. Marie, MI",2016,50,0,50,37718,1.32562702158121
42300,"Sault Ste. Marie, MI",2017,38,0,38,37714,1.00758339078326
42300,"Sault Ste. Marie, MI",2018,31,0,31,37517,0.826292080923315
42340,"Savannah, GA",1990,1178,312,1490,259049,5.75180757308463
42340,"Savannah, GA",1991,1117,79,1196,262131,4.56260419408616
42340,"Savannah, GA",1992,1538,149,1687,266846,6.32199845603831
42340,"Savannah, GA",1993,1805,526,2331,271453,8.58712189587148
42340,"Savannah, GA",1994,1635,342,1977,275738,7.16984963987553
42340,"Savannah, GA",1995,1510,553,2063,278904,7.39681037202765
42340,"Savannah, GA",1996,1621,521,2142,280906,7.62532662171687
42340,"Savannah, GA",1997,1575,111,1686,283797,5.94086618251778
42340,"Savannah, GA",1998,1863,1200,3063,285208,10.7395304479538
42340,"Savannah, GA",1999,1941,534,2475,288100,8.59076709475876
42340,"Savannah, GA",2000,1976,732,2708,293721,9.21963359787009
42340,"Savannah, GA",2001,1821,701,2522,297133,8.48778156583079
42340,"Savannah, GA",2002,1980,711,2691,301644,8.92111230457095
42340,"Savannah, GA",2003,2297,229,2526,304585,8.29325147331615
42340,"Savannah, GA",2004,2671,411,3082,310553,9.92423193464562
42340,"Savannah, GA",2005,3422,724,4146,314528,13.1816563231254
42340,"Savannah, GA",2006,4193,666,4859,322065,15.0870165960288
42340,"Savannah, GA",2007,2794,904,3698,329943,11.2079965327344
42340,"Savannah, GA",2008,1560,543,2103,335185,6.27414711278846
42340,"Savannah, GA",2009,1241,364,1605,344017,4.66546711354381
42340,"Savannah, GA",2010,1020,281,1301,348635,3.73169647338907
42340,"Savannah, GA",2011,1049,576,1625,355547,4.57042247579082
42340,"Savannah, GA",2012,1263,277,1540,361723,4.25740138172027
42340,"Savannah, GA",2013,1517,233,1750,365094,4.79328611261757
42340,"Savannah, GA",2014,1857,354,2211,371283,5.95502621989156
42340,"Savannah, GA",2015,2357,50,2407,377837,6.37047192307794
42340,"Savannah, GA",2016,1769,202,1971,383161,5.14405171716328
42340,"Savannah, GA",2017,1898,220,2118,386337,5.48226030641642
42340,"Savannah, GA",2018,2080,1078,3158,389494,8.1079554498914
42380,"Sayre, PA",1990,93,8,101,61062,1.65405653270446
42380,"Sayre, PA",1991,145,6,151,61349,2.46132781300429
42380,"Sayre, PA",1992,167,4,171,61706,2.7712053933167
42380,"Sayre, PA",1993,169,30,199,61887,3.21553799667135
42380,"Sayre, PA",1994,173,4,177,61876,2.86055982933609
42380,"Sayre, PA",1995,126,4,130,62067,2.09451077061885
42380,"Sayre, PA",1996,133,3,136,62319,2.18231999871628
42380,"Sayre, PA",1997,110,0,110,62355,1.76409269505252
42380,"Sayre, PA",1998,130,0,130,62424,2.08253235934897
42380,"Sayre, PA",1999,158,0,158,62115,2.54366900104645
42380,"Sayre, PA",2000,159,0,159,62756,2.53362228312831
42380,"Sayre, PA",2001,160,2,162,62616,2.58719816021464
42380,"Sayre, PA",2002,145,0,145,62585,2.31684908524407
42380,"Sayre, PA",2003,175,5,180,62388,2.88517022504328
42380,"Sayre, PA",2004,165,4,169,62386,2.70894110858205
42380,"Sayre, PA",2005,104,0,104,62501,1.66397337642598
42380,"Sayre, PA",2006,104,0,104,62345,1.66813697970968
42380,"Sayre, PA",2007,122,0,122,62343,1.95691577242032
42380,"Sayre, PA",2008,92,0,92,62318,1.47629898263744
42380,"Sayre, PA",2009,56,0,56,62418,0.897177096350412
42380,"Sayre, PA",2010,171,4,175,62736,2.78946697271104
42380,"Sayre, PA",2011,87,0,87,63106,1.3786327765981
42380,"Sayre, PA",2012,125,0,125,63002,1.98406399796832
42380,"Sayre, PA",2013,121,0,121,62512,1.935628359355
42380,"Sayre, PA",2014,77,0,77,61955,1.24283754337826
42380,"Sayre, PA",2015,83,38,121,61648,1.96275629379704
42380,"Sayre, PA",2016,62,40,102,61098,1.669449081803
42380,"Sayre, PA",2017,53,0,53,60988,0.869023414442185
42380,"Sayre, PA",2018,56,0,56,60833,0.920552989331448
42420,"Scottsbluff, NE",1990,17,67,84,35973,2.33508464681845
42420,"Scottsbluff, NE",1991,33,94,127,36198,3.50848113155423
42420,"Scottsbluff, NE",1992,38,2,40,36517,1.09538023386368
42420,"Scottsbluff, NE",1993,52,12,64,36599,1.7486816579688
42420,"Scottsbluff, NE",1994,78,29,107,36669,2.91799612751916
42420,"Scottsbluff, NE",1995,51,18,69,36687,1.88077520647641
42420,"Scottsbluff, NE",1996,57,6,63,36472,1.72735248958105
42420,"Scottsbluff, NE",1997,89,24,113,36326,3.1107195947806
42420,"Scottsbluff, NE",1998,78,64,142,36035,3.94061329263216
42420,"Scottsbluff, NE",1999,73,18,91,36120,2.51937984496124
42420,"Scottsbluff, NE",2000,66,4,70,37012,1.89127850426889
42420,"Scottsbluff, NE",2001,63,63,126,36561,3.44629523262493
42420,"Scottsbluff, NE",2002,66,33,99,36572,2.7069889532976
42420,"Scottsbluff, NE",2003,51,2,53,36468,1.45332894592519
42420,"Scottsbluff, NE",2004,44,10,54,37716,1.43175310213172
42420,"Scottsbluff, NE",2005,47,0,47,37714,1.24622156228456
42420,"Scottsbluff, NE",2006,47,4,51,37632,1.35522959183673
42420,"Scottsbluff, NE",2007,43,6,49,37742,1.29828837899422
42420,"Scottsbluff, NE",2008,21,0,21,37896,0.554148195060165
42420,"Scottsbluff, NE",2009,13,12,25,38001,0.657877424278309
42420,"Scottsbluff, NE",2010,17,6,23,38368,0.599457881567973
42420,"Scottsbluff, NE",2011,27,8,35,38271,0.914530584515691
42420,"Scottsbluff, NE",2012,17,2,19,38225,0.497056899934598
42420,"Scottsbluff, NE",2013,25,6,31,38180,0.811943425877423
42420,"Scottsbluff, NE",2014,22,10,32,37756,0.847547409683229
42420,"Scottsbluff, NE",2015,16,0,16,37506,0.426598410920919
42420,"Scottsbluff, NE",2016,18,12,30,37668,0.796431984708506
42420,"Scottsbluff, NE",2017,19,2,21,37414,0.561287218688192
42420,"Scottsbluff, NE",2018,14,0,14,37176,0.376587045405638
42460,"Scottsboro, AL",1990,51,0,51,47902,1.06467370882218
42460,"Scottsboro, AL",1991,45,0,45,48364,0.930444131999008
42460,"Scottsboro, AL",1992,124,0,124,48826,2.53963052472044
42460,"Scottsboro, AL",1993,70,0,70,49292,1.42010873975493
42460,"Scottsboro, AL",1994,73,0,73,49423,1.4770451004593
42460,"Scottsboro, AL",1995,69,0,69,49939,1.38168565650093
42460,"Scottsboro, AL",1996,80,0,80,50653,1.57937338361005
42460,"Scottsboro, AL",1997,81,0,81,50703,1.59753860718301
42460,"Scottsboro, AL",1998,70,0,70,51340,1.36345929100117
42460,"Scottsboro, AL",1999,58,0,58,51588,1.12429247111731
42460,"Scottsboro, AL",2000,47,56,103,53979,1.90814946553289
42460,"Scottsboro, AL",2001,43,0,43,53997,0.796340537437265
42460,"Scottsboro, AL",2002,44,16,60,53758,1.1161129506306
42460,"Scottsboro, AL",2003,61,0,61,53711,1.13570776935823
42460,"Scottsboro, AL",2004,59,0,59,53525,1.10228865016347
42460,"Scottsboro, AL",2005,83,0,83,53332,1.55628890722268
42460,"Scottsboro, AL",2006,85,0,85,53483,1.58929005478376
42460,"Scottsboro, AL",2007,77,0,77,53333,1.4437590234939
42460,"Scottsboro, AL",2008,63,0,63,53525,1.17702008407286
42460,"Scottsboro, AL",2009,40,0,40,53461,0.748208974766652
42460,"Scottsboro, AL",2010,18,0,18,53183,0.338454017261155
42460,"Scottsboro, AL",2011,37,0,37,53209,0.6953710838392
42460,"Scottsboro, AL",2012,17,0,17,53077,0.320289390884941
42460,"Scottsboro, AL",2013,34,0,34,52958,0.642018203104347
42460,"Scottsboro, AL",2014,39,0,39,52562,0.741980898748145
42460,"Scottsboro, AL",2015,40,0,40,52218,0.766019380290321
42460,"Scottsboro, AL",2016,36,0,36,52048,0.69166922840455
42460,"Scottsboro, AL",2017,14,0,14,51907,0.269713140809525
42460,"Scottsboro, AL",2018,37,0,37,51736,0.715169321169012
42540,"Scranton--Wilkes-Barre--Hazleton, PA",1990,1438,462,1900,575640,3.30067403238135
42540,"Scranton--Wilkes-Barre--Hazleton, PA",1991,1481,142,1623,575954,2.81793337662383
42540,"Scranton--Wilkes-Barre--Hazleton, PA",1992,1584,108,1692,575540,2.93984779511415
42540,"Scranton--Wilkes-Barre--Hazleton, PA",1993,1349,52,1401,574470,2.43876964854562
42540,"Scranton--Wilkes-Barre--Hazleton, PA",1994,1284,54,1338,571164,2.34258461667752
42540,"Scranton--Wilkes-Barre--Hazleton, PA",1995,1063,96,1159,567608,2.04190215782723
42540,"Scranton--Wilkes-Barre--Hazleton, PA",1996,1085,109,1194,562826,2.12143717596557
42540,"Scranton--Wilkes-Barre--Hazleton, PA",1997,1097,201,1298,556685,2.33165973575721
42540,"Scranton--Wilkes-Barre--Hazleton, PA",1998,1044,114,1158,551887,2.09825562116883
42540,"Scranton--Wilkes-Barre--Hazleton, PA",1999,1031,116,1147,547231,2.09600698790821
42540,"Scranton--Wilkes-Barre--Hazleton, PA",2000,1036,185,1221,559879,2.18082835755583
42540,"Scranton--Wilkes-Barre--Hazleton, PA",2001,1073,105,1178,557476,2.11309545164276
42540,"Scranton--Wilkes-Barre--Hazleton, PA",2002,1266,255,1521,555702,2.73707850610579
42540,"Scranton--Wilkes-Barre--Hazleton, PA",2003,1341,189,1530,555483,2.75435971937935
42540,"Scranton--Wilkes-Barre--Hazleton, PA",2004,1470,128,1598,555495,2.87671356177823
42540,"Scranton--Wilkes-Barre--Hazleton, PA",2005,1298,84,1382,556652,2.48270014299778
42540,"Scranton--Wilkes-Barre--Hazleton, PA",2006,1340,134,1474,557626,2.64334876781212
42540,"Scranton--Wilkes-Barre--Hazleton, PA",2007,1265,151,1416,560032,2.5284269470316
42540,"Scranton--Wilkes-Barre--Hazleton, PA",2008,657,43,700,561548,1.24655416812098
42540,"Scranton--Wilkes-Barre--Hazleton, PA",2009,647,61,708,562933,1.25769851829614
42540,"Scranton--Wilkes-Barre--Hazleton, PA",2010,665,22,687,563757,1.21861014586072
42540,"Scranton--Wilkes-Barre--Hazleton, PA",2011,411,28,439,563635,0.778872852111739
42540,"Scranton--Wilkes-Barre--Hazleton, PA",2012,450,20,470,563697,0.833781269015091
42540,"Scranton--Wilkes-Barre--Hazleton, PA",2013,429,87,516,561516,0.91894086722373
42540,"Scranton--Wilkes-Barre--Hazleton, PA",2014,2113,188,2301,560175,4.1076449323872
42540,"Scranton--Wilkes-Barre--Hazleton, PA",2015,800,31,831,557690,1.49007513134537
42540,"Scranton--Wilkes-Barre--Hazleton, PA",2016,846,172,1018,555633,1.83214459904289
42540,"Scranton--Wilkes-Barre--Hazleton, PA",2017,425,155,580,555645,1.04383194305717
42540,"Scranton--Wilkes-Barre--Hazleton, PA",2018,487,66,553,555485,0.995526431856846
42620,"Searcy, AR",1990,108,40,148,54906,2.69551597275343
42620,"Searcy, AR",1991,113,21,134,55924,2.39610900507832
42620,"Searcy, AR",1992,124,16,140,56894,2.46071642000914
42620,"Searcy, AR",1993,152,2,154,58043,2.65320538221663
42620,"Searcy, AR",1994,160,10,170,59239,2.86973108931616
42620,"Searcy, AR",1995,150,12,162,60662,2.67053509610629
42620,"Searcy, AR",1996,154,49,203,62180,3.26471534255388
42620,"Searcy, AR",1997,164,24,188,63251,2.97228502316169
42620,"Searcy, AR",1998,113,244,357,64814,5.50806924429907
42620,"Searcy, AR",1999,158,269,427,65263,6.54275776473653
42620,"Searcy, AR",2000,96,26,122,67382,1.81057255646909
42620,"Searcy, AR",2001,135,39,174,68273,2.54859168338875
42620,"Searcy, AR",2002,133,39,172,68796,2.50014535728821
42620,"Searcy, AR",2003,185,248,433,69389,6.24018216143769
42620,"Searcy, AR",2004,175,30,205,70403,2.91180773546582
42620,"Searcy, AR",2005,209,94,303,71355,4.24637376497793
42620,"Searcy, AR",2006,166,82,248,72728,3.409965900341
42620,"Searcy, AR",2007,157,17,174,73573,2.36499802916831
42620,"Searcy, AR",2008,156,477,633,74848,8.45713980333476
42620,"Searcy, AR",2009,117,34,151,76284,1.97944523097897
42620,"Searcy, AR",2010,121,30,151,77348,1.95221595904225
42620,"Searcy, AR",2011,120,80,200,78065,2.56196759110997
42620,"Searcy, AR",2012,133,111,244,78629,3.10318076027929
42620,"Searcy, AR",2013,110,124,234,78553,2.97888050106298
42620,"Searcy, AR",2014,97,19,116,78459,1.47847920569979
42620,"Searcy, AR",2015,76,6,82,78925,1.03896103896104
42620,"Searcy, AR",2016,100,16,116,78967,1.46896804994491
42620,"Searcy, AR",2017,98,2,100,78941,1.26676885268745
42620,"Searcy, AR",2018,90,4,94,78727,1.19399951731934
42660,"Seattle-Tacoma-Bellevue, WA",1990,14172,14544,28716,2577168,11.1424633551247
42660,"Seattle-Tacoma-Bellevue, WA",1991,9856,4754,14610,2622369,5.57129831842887
42660,"Seattle-Tacoma-Bellevue, WA",1992,12560,6193,18753,2675556,7.00901046361952
42660,"Seattle-Tacoma-Bellevue, WA",1993,12603,5397,18000,2717934,6.62267737185671
42660,"Seattle-Tacoma-Bellevue, WA",1994,13259,5349,18608,2744662,6.77970547921748
42660,"Seattle-Tacoma-Bellevue, WA",1995,11567,5845,17412,2777826,6.26821118385385
42660,"Seattle-Tacoma-Bellevue, WA",1996,12235,7623,19858,2812466,7.06070757833161
42660,"Seattle-Tacoma-Bellevue, WA",1997,13512,8770,22282,2865861,7.77497582750873
42660,"Seattle-Tacoma-Bellevue, WA",1998,14107,13108,27215,2918516,9.32494459512985
42660,"Seattle-Tacoma-Bellevue, WA",1999,13578,11163,24741,2951595,8.38224756445244
42660,"Seattle-Tacoma-Bellevue, WA",2000,12057,10468,22525,3052187,7.37995411159277
42660,"Seattle-Tacoma-Bellevue, WA",2001,12246,8851,21097,3092927,6.82104685949588
42660,"Seattle-Tacoma-Bellevue, WA",2002,14406,6585,20991,3118302,6.73154813100206
42660,"Seattle-Tacoma-Bellevue, WA",2003,15003,5598,20601,3133021,6.57544267976499
42660,"Seattle-Tacoma-Bellevue, WA",2004,16334,7801,24135,3158967,7.64015578510317
42660,"Seattle-Tacoma-Bellevue, WA",2005,17565,7954,25519,3198265,7.97901362144788
42660,"Seattle-Tacoma-Bellevue, WA",2006,15211,10532,25743,3257081,7.90370273260014
42660,"Seattle-Tacoma-Bellevue, WA",2007,12395,13008,25403,3304467,7.68747274522639
42660,"Seattle-Tacoma-Bellevue, WA",2008,6674,8838,15512,3355042,4.62348906511454
42660,"Seattle-Tacoma-Bellevue, WA",2009,5036,2383,7419,3414797,2.17260352518759
42660,"Seattle-Tacoma-Bellevue, WA",2010,6139,3901,10040,3449275,2.91075660827275
42660,"Seattle-Tacoma-Bellevue, WA",2011,6078,5152,11230,3499104,3.20939303318792
42660,"Seattle-Tacoma-Bellevue, WA",2012,8047,9619,17666,3554484,4.97006035193857
42660,"Seattle-Tacoma-Bellevue, WA",2013,8773,10744,19517,3610838,5.40511648542527
42660,"Seattle-Tacoma-Bellevue, WA",2014,8665,13288,21953,3672067,5.97837675619753
42660,"Seattle-Tacoma-Bellevue, WA",2015,8646,16362,25008,3738316,6.68964314413228
42660,"Seattle-Tacoma-Bellevue, WA",2016,9425,16064,25489,3814369,6.68236345251338
42660,"Seattle-Tacoma-Bellevue, WA",2017,9997,17337,27334,3884469,7.03674041419818
42660,"Seattle-Tacoma-Bellevue, WA",2018,9134,19052,28186,3939363,7.15496388629329
42680,"Sebastian-Vero Beach, FL",1990,1040,226,1266,90854,13.9344442732296
42680,"Sebastian-Vero Beach, FL",1991,799,201,1000,92261,10.8388159677437
42680,"Sebastian-Vero Beach, FL",1992,732,144,876,93577,9.36127467219509
42680,"Sebastian-Vero Beach, FL",1993,859,95,954,93997,10.1492600827686
42680,"Sebastian-Vero Beach, FL",1994,1040,158,1198,95109,12.5960739782776
42680,"Sebastian-Vero Beach, FL",1995,782,331,1113,95976,11.5966491622906
42680,"Sebastian-Vero Beach, FL",1996,902,99,1001,96423,10.3813405515282
42680,"Sebastian-Vero Beach, FL",1997,909,163,1072,97818,10.9591281768182
42680,"Sebastian-Vero Beach, FL",1998,1050,594,1644,99135,16.5834468149493
42680,"Sebastian-Vero Beach, FL",1999,1103,215,1318,100107,13.1659124736532
42680,"Sebastian-Vero Beach, FL",2000,1214,845,2059,113323,18.1693036718054
42680,"Sebastian-Vero Beach, FL",2001,1218,626,1844,115456,15.9714523281596
42680,"Sebastian-Vero Beach, FL",2002,1442,452,1894,118144,16.0312838569881
42680,"Sebastian-Vero Beach, FL",2003,1778,652,2430,120450,20.1743462017435
42680,"Sebastian-Vero Beach, FL",2004,3646,539,4185,125001,33.4797321621427
42680,"Sebastian-Vero Beach, FL",2005,3657,162,3819,127955,29.8464303856825
42680,"Sebastian-Vero Beach, FL",2006,2839,304,3143,131463,23.9078676129405
42680,"Sebastian-Vero Beach, FL",2007,1130,127,1257,134564,9.3412799857317
42680,"Sebastian-Vero Beach, FL",2008,619,40,659,136277,4.8357389728274
42680,"Sebastian-Vero Beach, FL",2009,275,52,327,137016,2.38658258889473
42680,"Sebastian-Vero Beach, FL",2010,307,0,307,138272,2.22026151353853
42680,"Sebastian-Vero Beach, FL",2011,320,52,372,139100,2.67433501078361
42680,"Sebastian-Vero Beach, FL",2012,369,0,369,140485,2.62661494109691
42680,"Sebastian-Vero Beach, FL",2013,546,5,551,141913,3.88266050326609
42680,"Sebastian-Vero Beach, FL",2014,707,0,707,144469,4.89378344143034
42680,"Sebastian-Vero Beach, FL",2015,849,24,873,147478,5.91952698029537
42680,"Sebastian-Vero Beach, FL",2016,970,48,1018,151248,6.73066751295885
42680,"Sebastian-Vero Beach, FL",2017,1112,9,1121,154314,7.26440893243646
42680,"Sebastian-Vero Beach, FL",2018,1312,60,1372,157413,8.7159256224073
42700,"Sebring, FL",1990,686,161,847,68961,12.2823044909442
42700,"Sebring, FL",1991,561,147,708,70190,10.0869069668044
42700,"Sebring, FL",1992,514,192,706,71169,9.92004945973668
42700,"Sebring, FL",1993,590,147,737,72418,10.1770278107653
42700,"Sebring, FL",1994,679,105,784,73527,10.6627497381914
42700,"Sebring, FL",1995,537,92,629,74257,8.47058189800288
42700,"Sebring, FL",1996,551,36,587,74811,7.8464396946973
42700,"Sebring, FL",1997,521,82,603,75064,8.03314504955771
42700,"Sebring, FL",1998,480,66,546,74935,7.28631480616534
42700,"Sebring, FL",1999,641,26,667,74651,8.93491044996048
42700,"Sebring, FL",2000,428,22,450,87417,5.14774014207763
42700,"Sebring, FL",2001,522,40,562,88510,6.34956502090159
42700,"Sebring, FL",2002,519,14,533,89939,5.92623889525123
42700,"Sebring, FL",2003,680,51,731,90943,8.03800182531916
42700,"Sebring, FL",2004,904,55,959,93079,10.3030758817778
42700,"Sebring, FL",2005,1192,86,1278,95614,13.3662434371536
42700,"Sebring, FL",2006,1415,125,1540,97788,15.7483535812165
42700,"Sebring, FL",2007,918,212,1130,99023,11.4114902598386
42700,"Sebring, FL",2008,161,6,167,99568,1.67724570143018
42700,"Sebring, FL",2009,60,54,114,98956,1.15202716358786
42700,"Sebring, FL",2010,73,81,154,98634,1.56132773688586
42700,"Sebring, FL",2011,75,2,77,98477,0.781908465936208
42700,"Sebring, FL",2012,32,0,32,98222,0.325792592290933
42700,"Sebring, FL",2013,58,4,62,98088,0.632085474268004
42700,"Sebring, FL",2014,92,0,92,98606,0.933006105105166
42700,"Sebring, FL",2015,156,6,162,100222,1.61641156632276
42700,"Sebring, FL",2016,122,6,128,102191,1.2525564873619
42700,"Sebring, FL",2017,175,6,181,104060,1.7393811262733
42700,"Sebring, FL",2018,211,60,271,105424,2.57057216573076
42740,"Sedalia, MO",1990,26,70,96,35494,2.70468248154618
42740,"Sedalia, MO",1991,31,58,89,35575,2.50175685172171
42740,"Sedalia, MO",1992,25,2,27,35619,0.758022403773267
42740,"Sedalia, MO",1993,39,0,39,35928,1.08550434201737
42740,"Sedalia, MO",1994,26,20,46,36595,1.25700232272168
42740,"Sedalia, MO",1995,36,40,76,36783,2.06617187287606
42740,"Sedalia, MO",1996,21,2,23,36720,0.626361655773421
42740,"Sedalia, MO",1997,13,22,35,36862,0.94948727687049
42740,"Sedalia, MO",1998,14,52,66,37080,1.77993527508091
42740,"Sedalia, MO",1999,26,0,26,37127,0.700298973792658
42740,"Sedalia, MO",2000,14,2,16,39486,0.405206908777795
42740,"Sedalia, MO",2001,22,8,30,39577,0.75801601940521
42740,"Sedalia, MO",2002,19,4,23,39543,0.581645297524214
42740,"Sedalia, MO",2003,12,42,54,39669,1.36126446343492
42740,"Sedalia, MO",2004,48,28,76,39883,1.90557380337487
42740,"Sedalia, MO",2005,42,20,62,40455,1.53256704980843
42740,"Sedalia, MO",2006,40,14,54,40937,1.31910008061167
42740,"Sedalia, MO",2007,3,36,39,41239,0.945706733916923
42740,"Sedalia, MO",2008,4,23,27,41565,0.649584987369181
42740,"Sedalia, MO",2009,5,21,26,41907,0.620421409311094
42740,"Sedalia, MO",2010,2,26,28,42263,0.662518041785959
42740,"Sedalia, MO",2011,2,27,29,42142,0.688149589483176
42740,"Sedalia, MO",2012,0,32,32,42297,0.756554838404615
42740,"Sedalia, MO",2013,16,2,18,42194,0.426600938522065
42740,"Sedalia, MO",2014,14,4,18,42198,0.426560500497654
42740,"Sedalia, MO",2015,3,18,21,42323,0.496184107931857
42740,"Sedalia, MO",2016,15,0,15,42289,0.35470216841259
42740,"Sedalia, MO",2017,12,4,16,42504,0.376435159043855
42740,"Sedalia, MO",2018,0,14,14,42542,0.329086549762588
42780,"Selinsgrove, PA",1990,81,4,85,36809,2.3092178543291
42780,"Selinsgrove, PA",1991,141,0,141,37047,3.80597619240424
42780,"Selinsgrove, PA",1992,132,28,160,37301,4.28942923782204
42780,"Selinsgrove, PA",1993,126,24,150,37386,4.01219707912053
42780,"Selinsgrove, PA",1994,130,23,153,37534,4.07630415090318
42780,"Selinsgrove, PA",1995,125,0,125,37702,3.3154739801602
42780,"Selinsgrove, PA",1996,119,16,135,38139,3.53968378824825
42780,"Selinsgrove, PA",1997,94,8,102,38211,2.66938839601162
42780,"Selinsgrove, PA",1998,117,6,123,37970,3.23939952594153
42780,"Selinsgrove, PA",1999,107,0,107,37863,2.82597786757521
42780,"Selinsgrove, PA",2000,110,11,121,37502,3.22649458695536
42780,"Selinsgrove, PA",2001,132,4,136,37955,3.58319062047161
42780,"Selinsgrove, PA",2002,105,5,110,38104,2.88683602771363
42780,"Selinsgrove, PA",2003,170,12,182,38319,4.74960202510504
42780,"Selinsgrove, PA",2004,116,10,126,38519,3.27111295724188
42780,"Selinsgrove, PA",2005,120,0,120,38448,3.1210986267166
42780,"Selinsgrove, PA",2006,128,2,130,38946,3.33795511734196
42780,"Selinsgrove, PA",2007,92,0,92,39295,2.34126479195826
42780,"Selinsgrove, PA",2008,86,0,86,39481,2.17826296193106
42780,"Selinsgrove, PA",2009,59,4,63,39550,1.5929203539823
42780,"Selinsgrove, PA",2010,75,14,89,39707,2.24141838970459
42780,"Selinsgrove, PA",2011,57,4,61,39777,1.53354953867813
42780,"Selinsgrove, PA",2012,64,0,64,39878,1.60489492953508
42780,"Selinsgrove, PA",2013,46,2,48,40120,1.19641076769691
42780,"Selinsgrove, PA",2014,49,2,51,40232,1.26764764366673
42780,"Selinsgrove, PA",2015,67,12,79,40523,1.94951015472695
42780,"Selinsgrove, PA",2016,67,12,79,40452,1.95293186987046
42780,"Selinsgrove, PA",2017,84,0,84,40585,2.06973019588518
42780,"Selinsgrove, PA",2018,36,0,36,40540,0.888011840157869
42820,"Selma, AL",1990,5,6,11,48015,0.229095074455899
42820,"Selma, AL",1991,15,17,32,47857,0.668658712414067
42820,"Selma, AL",1992,18,15,33,47940,0.688360450563204
42820,"Selma, AL",1993,18,46,64,48002,1.3332777800925
42820,"Selma, AL",1994,21,27,48,47806,1.00405806802493
42820,"Selma, AL",1995,19,38,57,47707,1.19479321692833
42820,"Selma, AL",1996,14,10,24,47349,0.506874485205601
42820,"Selma, AL",1997,23,0,23,47107,0.48825015390494
42820,"Selma, AL",1998,9,6,15,46768,0.320732124529593
42820,"Selma, AL",1999,10,48,58,46728,1.241225817497
42820,"Selma, AL",2000,9,56,65,46198,1.4069873154682
42820,"Selma, AL",2001,5,0,5,46132,0.108384635394087
42820,"Selma, AL",2002,4,0,4,45377,0.0881503845560526
42820,"Selma, AL",2003,3,58,61,45170,1.35045384104494
42820,"Selma, AL",2004,4,0,4,44795,0.0892956803214644
42820,"Selma, AL",2005,4,0,4,44434,0.0900211549714183
42820,"Selma, AL",2006,4,0,4,44323,0.0902465988313065
42820,"Selma, AL",2007,5,0,5,44194,0.113137529981445
42820,"Selma, AL",2008,2,0,2,44265,0.0451824240370496
42820,"Selma, AL",2009,2,0,2,43759,0.0457048835668091
42820,"Selma, AL",2010,0,36,36,43860,0.820793433652531
42820,"Selma, AL",2011,76,0,76,43256,1.75698169040133
42820,"Selma, AL",2012,11,0,11,42795,0.257039373758617
42820,"Selma, AL",2013,7,56,63,41983,1.50060738870495
42820,"Selma, AL",2014,17,0,17,41562,0.40902747702228
42820,"Selma, AL",2015,18,0,18,40948,0.439581908762333
42820,"Selma, AL",2016,25,0,25,40092,0.623565798663075
42820,"Selma, AL",2017,23,0,23,39235,0.586211290939212
42820,"Selma, AL",2018,28,0,28,38310,0.730879665883581
42860,"Seneca, SC",1990,396,60,456,57688,7.9045902094023
42860,"Seneca, SC",1991,400,79,479,58203,8.22981633249145
42860,"Seneca, SC",1992,387,17,404,58764,6.87495745694643
42860,"Seneca, SC",1993,421,19,440,59659,7.37524933371327
42860,"Seneca, SC",1994,426,18,444,60444,7.34564224736947
42860,"Seneca, SC",1995,405,92,497,61463,8.08616566064136
42860,"Seneca, SC",1996,478,34,512,62531,8.18793878236395
42860,"Seneca, SC",1997,536,129,665,63389,10.490779157267
42860,"Seneca, SC",1998,624,16,640,64122,9.98097376875331
42860,"Seneca, SC",1999,644,148,792,65063,12.1728171157186
42860,"Seneca, SC",2000,473,0,473,66434,7.11984827046392
42860,"Seneca, SC",2001,490,0,490,67170,7.29492332886705
42860,"Seneca, SC",2002,520,51,571,68194,8.37317066017538
42860,"Seneca, SC",2003,626,279,905,68900,13.1349782293179
42860,"Seneca, SC",2004,711,128,839,69615,12.0520002872944
42860,"Seneca, SC",2005,830,31,861,70581,12.1987503719131
42860,"Seneca, SC",2006,849,2,851,71490,11.9037627640229
42860,"Seneca, SC",2007,975,157,1132,72407,15.6338475561755
42860,"Seneca, SC",2008,642,383,1025,73089,14.0239981392549
42860,"Seneca, SC",2009,255,15,270,73829,3.65709951374121
42860,"Seneca, SC",2010,186,0,186,74341,2.50198410029459
42860,"Seneca, SC",2011,143,26,169,74237,2.2764928539677
42860,"Seneca, SC",2012,177,0,177,74534,2.37475514530281
42860,"Seneca, SC",2013,279,48,327,74924,4.36442261491645
42860,"Seneca, SC",2014,243,0,243,75211,3.23091037215301
42860,"Seneca, SC",2015,256,0,256,75888,3.37339236769977
42860,"Seneca, SC",2016,387,0,387,76568,5.05433079093094
42860,"Seneca, SC",2017,444,50,494,77437,6.37937936645273
42860,"Seneca, SC",2018,437,0,437,78374,5.57582871870773
42900,"Seneca Falls, NY",1990,85,4,89,33696,2.64126305792972
42900,"Seneca Falls, NY",1991,94,18,112,33699,3.32354075788599
42900,"Seneca Falls, NY",1992,99,17,116,33395,3.47357388830663
42900,"Seneca Falls, NY",1993,88,16,104,32697,3.18071994372572
42900,"Seneca Falls, NY",1994,91,13,104,32476,3.2023648232541
42900,"Seneca Falls, NY",1995,85,4,89,32420,2.7452190006169
42900,"Seneca Falls, NY",1996,83,7,90,33161,2.71403154307771
42900,"Seneca Falls, NY",1997,77,7,84,32972,2.54761615916535
42900,"Seneca Falls, NY",1998,90,19,109,32743,3.32895580734814
42900,"Seneca Falls, NY",1999,63,7,70,32737,2.13825335247579
42900,"Seneca Falls, NY",2000,46,0,46,33343,1.37959991602435
42900,"Seneca Falls, NY",2001,45,4,49,34764,1.40950408468531
42900,"Seneca Falls, NY",2002,28,4,32,35046,0.913085658848371
42900,"Seneca Falls, NY",2003,33,2,35,35212,0.993979325230035
42900,"Seneca Falls, NY",2004,40,2,42,35312,1.18939737199819
42900,"Seneca Falls, NY",2005,36,2,38,35177,1.08025130056571
42900,"Seneca Falls, NY",2006,31,2,33,35223,0.936887828975385
42900,"Seneca Falls, NY",2007,68,0,68,35469,1.91716710366799
42900,"Seneca Falls, NY",2008,40,0,40,35370,1.13090189426067
42900,"Seneca Falls, NY",2009,34,40,74,35286,2.09714901093918
42900,"Seneca Falls, NY",2010,35,33,68,35261,1.92847622018661
42900,"Seneca Falls, NY",2011,26,43,69,35314,1.95389930339242
42900,"Seneca Falls, NY",2012,26,64,90,35338,2.54683343709321
42900,"Seneca Falls, NY",2013,36,0,36,35227,1.02194339569081
42900,"Seneca Falls, NY",2014,26,2,28,34887,0.802591223091696
42900,"Seneca Falls, NY",2015,27,0,27,34814,0.775550066065376
42900,"Seneca Falls, NY",2016,73,2,75,34731,2.15945409000605
42900,"Seneca Falls, NY",2017,24,2,26,34327,0.757421271885105
42900,"Seneca Falls, NY",2018,50,0,50,34300,1.45772594752187
42940,"Sevierville, TN",1990,109,154,263,51377,5.11902213052533
42940,"Sevierville, TN",1991,105,33,138,53072,2.60024118179077
42940,"Sevierville, TN",1992,99,128,227,54555,4.16093850242874
42940,"Sevierville, TN",1993,116,59,175,56356,3.1052594222443
42940,"Sevierville, TN",1994,123,80,203,58188,3.48869182649343
42940,"Sevierville, TN",1995,129,261,390,59425,6.56289440471182
42940,"Sevierville, TN",1996,160,274,434,61353,7.07381872117093
42940,"Sevierville, TN",1997,174,77,251,62769,3.99878921123485
42940,"Sevierville, TN",1998,198,198,396,64310,6.15767376768776
42940,"Sevierville, TN",1999,251,236,487,65796,7.40166575475713
42940,"Sevierville, TN",2000,218,267,485,71776,6.75713330361124
42940,"Sevierville, TN",2001,253,202,455,73563,6.18517461223713
42940,"Sevierville, TN",2002,310,295,605,75035,8.06290397814353
42940,"Sevierville, TN",2003,422,158,580,76616,7.57022031951551
42940,"Sevierville, TN",2004,391,179,570,78610,7.25098587965908
42940,"Sevierville, TN",2005,455,383,838,81275,10.3106736388803
42940,"Sevierville, TN",2006,258,578,836,84098,9.94078337178054
42940,"Sevierville, TN",2007,249,271,520,86284,6.02660980019471
42940,"Sevierville, TN",2008,142,207,349,87983,3.96667538047123
42940,"Sevierville, TN",2009,61,80,141,89096,1.58256262907426
42940,"Sevierville, TN",2010,66,54,120,89921,1.33450473193136
42940,"Sevierville, TN",2011,51,147,198,91101,2.17341192742121
42940,"Sevierville, TN",2012,64,91,155,92219,1.68078161767098
42940,"Sevierville, TN",2013,87,7,94,93314,1.00735152281544
42940,"Sevierville, TN",2014,54,6,60,94512,0.634840020314881
42940,"Sevierville, TN",2015,315,4,319,95386,3.34430629232801
42940,"Sevierville, TN",2016,461,10,471,96370,4.88741309536163
42940,"Sevierville, TN",2017,671,130,801,97277,8.2342177493138191
42940,"Sevierville, TN",2018,647,393,1040,97892,10.6239529277163
42980,"Seymour, IN",1990,87,93,180,37844,4.75636824859951
42980,"Seymour, IN",1991,98,54,152,38333,3.96525187175541
42980,"Seymour, IN",1992,132,9,141,38610,3.65190365190365
42980,"Seymour, IN",1993,162,8,170,39097,4.34815970534824
42980,"Seymour, IN",1994,158,32,190,39416,4.82037751167039
42980,"Seymour, IN",1995,172,63,235,40290,5.83271283196823
42980,"Seymour, IN",1996,209,190,399,40502,9.85136536467335
42980,"Seymour, IN",1997,176,95,271,40952,6.61750341863645
42980,"Seymour, IN",1998,142,20,162,41032,3.94813803860402
42980,"Seymour, IN",1999,176,105,281,41354,6.79498960197321
42980,"Seymour, IN",2000,156,47,203,41428,4.90006758713913
42980,"Seymour, IN",2001,154,26,180,41343,4.35382047746898
42980,"Seymour, IN",2002,135,20,155,41335,3.7498487964195
42980,"Seymour, IN",2003,174,8,182,41403,4.39581672825641
42980,"Seymour, IN",2004,173,2,175,41417,4.2253181060917004
42980,"Seymour, IN",2005,171,4,175,41683,4.19835424513591
42980,"Seymour, IN",2006,143,15,158,41725,3.7866986219293
42980,"Seymour, IN",2007,145,0,145,41693,3.4778020291176
42980,"Seymour, IN",2008,66,84,150,41705,3.5966910442393
42980,"Seymour, IN",2009,59,21,80,41798,1.91396717546294
42980,"Seymour, IN",2010,69,42,111,42586,2.60649039590476
42980,"Seymour, IN",2011,67,47,114,42912,2.65659955257271
42980,"Seymour, IN",2012,49,71,120,42984,2.79173646007817
42980,"Seymour, IN",2013,75,95,170,43436,3.9138042176996
42980,"Seymour, IN",2014,61,117,178,43703,4.07294693728119
42980,"Seymour, IN",2015,73,115,188,43886,4.28382627717267
42980,"Seymour, IN",2016,66,125,191,44004,4.34051449868194
42980,"Seymour, IN",2017,69,113,182,43987,4.13758610498556
42980,"Seymour, IN",2018,66,102,168,44111,3.80857382512299
43020,"Shawano, WI",1990,122,8,130,41282,3.14907223487234
43020,"Shawano, WI",1991,121,8,129,41425,3.11406155703078
43020,"Shawano, WI",1992,174,28,202,41729,4.84075822569436
43020,"Shawano, WI",1993,200,40,240,42097,5.70111884457325
43020,"Shawano, WI",1994,220,53,273,42428,6.43443009333459
43020,"Shawano, WI",1995,166,42,208,42957,4.84205135367926
43020,"Shawano, WI",1996,192,146,338,43225,7.81954887218045
43020,"Shawano, WI",1997,199,0,199,43465,4.57839641090533
43020,"Shawano, WI",1998,228,20,248,43771,5.66585181969797
43020,"Shawano, WI",1999,250,10,260,44148,5.88928150765607
43020,"Shawano, WI",2000,226,18,244,45366,5.37847727372922
43020,"Shawano, WI",2001,247,16,263,45399,5.79307914271239
43020,"Shawano, WI",2002,234,94,328,45515,7.20641546742832
43020,"Shawano, WI",2003,277,43,320,45561,7.02355084392353
43020,"Shawano, WI",2004,250,28,278,45679,6.08594759079665
43020,"Shawano, WI",2005,199,209,408,45790,8.91024241100677
43020,"Shawano, WI",2006,170,31,201,45951,4.374224717634
43020,"Shawano, WI",2007,118,12,130,46122,2.81861150860761
43020,"Shawano, WI",2008,88,50,138,46108,2.9929730198664
43020,"Shawano, WI",2009,54,0,54,46080,1.171875
43020,"Shawano, WI",2010,68,0,68,46207,1.47163849633172
43020,"Shawano, WI",2011,55,2,57,46034,1.23821523221966
43020,"Shawano, WI",2012,57,0,57,45865,1.24277771721356
43020,"Shawano, WI",2013,49,20,69,45790,1.5068792312732
43020,"Shawano, WI",2014,58,0,58,45851,1.26496695819066
43020,"Shawano, WI",2015,57,0,57,45587,1.25035646127185
43020,"Shawano, WI",2016,74,0,74,45518,1.62573048024957
43020,"Shawano, WI",2017,80,0,80,45524,1.75731482295053
43020,"Shawano, WI",2018,76,2,78,45454,1.71602059224711
43060,"Shawnee, OK",1990,43,32,75,58776,1.27603103307472
43060,"Shawnee, OK",1991,42,0,42,58834,0.71387293061835
43060,"Shawnee, OK",1992,53,0,53,59370,0.89270675425299
43060,"Shawnee, OK",1993,78,2,80,60183,1.32927903228486
43060,"Shawnee, OK",1994,79,8,87,60202,1.44513471313245
43060,"Shawnee, OK",1995,57,33,90,60901,1.47780824617001
43060,"Shawnee, OK",1996,63,4,67,61674,1.08635729805104
43060,"Shawnee, OK",1997,90,244,334,61493,5.43151252988145
43060,"Shawnee, OK",1998,118,64,182,62603,2.90720891970033
43060,"Shawnee, OK",1999,107,0,107,63512,1.68472099760675
43060,"Shawnee, OK",2000,100,0,100,65647,1.52329885600256
43060,"Shawnee, OK",2001,107,0,107,66222,1.61577723415179
43060,"Shawnee, OK",2002,90,0,90,66469,1.35401465344747
43060,"Shawnee, OK",2003,98,80,178,67201,2.64877010758768
43060,"Shawnee, OK",2004,129,18,147,67072,2.19167461832061
43060,"Shawnee, OK",2005,207,140,347,67264,5.1587773549001
43060,"Shawnee, OK",2006,156,2,158,67696,2.33396360198535
43060,"Shawnee, OK",2007,173,52,225,68698,3.27520451832659
43060,"Shawnee, OK",2008,179,9,188,68752,2.73446590644636
43060,"Shawnee, OK",2009,139,11,150,69002,2.17385003333237
43060,"Shawnee, OK",2010,113,6,119,69633,1.70895983226344
43060,"Shawnee, OK",2011,70,153,223,70045,3.18366764222999
43060,"Shawnee, OK",2012,82,61,143,70514,2.02796607765834
43060,"Shawnee, OK",2013,102,32,134,70907,1.88979931459517
43060,"Shawnee, OK",2014,83,0,83,71539,1.16020632102769
43060,"Shawnee, OK",2015,63,0,63,71495,0.881180502133016
43060,"Shawnee, OK",2016,101,20,121,72041,1.67959911716939
43060,"Shawnee, OK",2017,88,12,100,72248,1.38412135976082
43060,"Shawnee, OK",2018,69,19,88,72679,1.21080367093658
43100,"Sheboygan, WI",1990,265,61,326,104085,3.13205553153673
43100,"Sheboygan, WI",1991,293,108,401,104451,3.83912073603891
43100,"Sheboygan, WI",1992,359,166,525,105149,4.99291481611808
43100,"Sheboygan, WI",1993,443,206,649,106032,6.12079372264977
43100,"Sheboygan, WI",1994,463,249,712,107172,6.64352629418132
43100,"Sheboygan, WI",1995,440,293,733,108521,6.75445305516905
43100,"Sheboygan, WI",1996,458,262,720,109355,6.58406108545563
43100,"Sheboygan, WI",1997,377,188,565,109926,5.1398213343522
43100,"Sheboygan, WI",1998,440,254,694,110138,6.30118578510596
43100,"Sheboygan, WI",1999,385,212,597,110033,5.4256450337626
43100,"Sheboygan, WI",2000,361,314,675,112739,5.9872803555114
43100,"Sheboygan, WI",2001,386,239,625,113023,5.52984790706316
43100,"Sheboygan, WI",2002,405,275,680,113251,6.00436199238859
43100,"Sheboygan, WI",2003,475,124,599,113433,5.28065025169042
43100,"Sheboygan, WI",2004,439,218,657,113832,5.77166350411132
43100,"Sheboygan, WI",2005,371,135,506,114454,4.4209900920894
43100,"Sheboygan, WI",2006,277,199,476,114775,4.14724460901764
43100,"Sheboygan, WI",2007,196,193,389,115178,3.37738109708451
43100,"Sheboygan, WI",2008,115,88,203,115652,1.75526579739218
43100,"Sheboygan, WI",2009,77,82,159,115562,1.37588480642426
43100,"Sheboygan, WI",2010,65,4,69,115521,0.59729399849378
43100,"Sheboygan, WI",2011,51,22,73,115197,0.63369705808311
43100,"Sheboygan, WI",2012,61,2,63,114767,0.548938283652966
43100,"Sheboygan, WI",2013,93,6,99,114704,0.86309108662296
43100,"Sheboygan, WI",2014,87,24,111,114998,0.965234177985704
43100,"Sheboygan, WI",2015,101,22,123,115239,1.06734699190378
43100,"Sheboygan, WI",2016,164,143,307,115099,2.6672690466468
43100,"Sheboygan, WI",2017,154,236,390,115235,3.38438842365601
43100,"Sheboygan, WI",2018,177,14,191,115456,1.65430986696231
43140,"Shelby, NC",1990,411,96,507,85188,5.95154247077053
43140,"Shelby, NC",1991,366,48,414,85994,4.81428936902575
43140,"Shelby, NC",1992,386,88,474,87093,5.44245806207158
43140,"Shelby, NC",1993,379,20,399,87929,4.53775204994939
43140,"Shelby, NC",1994,359,80,439,88630,4.95317612546542
43140,"Shelby, NC",1995,382,24,406,90010,4.51060993222975
43140,"Shelby, NC",1996,378,38,416,91160,4.56340500219394
43140,"Shelby, NC",1997,303,121,424,91992,4.60909644316897
43140,"Shelby, NC",1998,384,163,547,93045,5.87887581277876
43140,"Shelby, NC",1999,367,41,408,93959,4.34231952234485
43140,"Shelby, NC",2000,352,18,370,96357,3.83988708656351
43140,"Shelby, NC",2001,330,19,349,96861,3.60310135142111
43140,"Shelby, NC",2002,316,214,530,97068,5.46008983393085
43140,"Shelby, NC",2003,377,25,402,97241,4.13405867895229
43140,"Shelby, NC",2004,370,102,472,97134,4.85926658018819
43140,"Shelby, NC",2005,378,114,492,96844,5.08033538474247
43140,"Shelby, NC",2006,319,2,321,96990,3.30961954840705
43140,"Shelby, NC",2007,290,2,292,97524,2.99413477708051
43140,"Shelby, NC",2008,180,0,180,98155,1.83383424176048
43140,"Shelby, NC",2009,115,97,212,98211,2.15861767011842
43140,"Shelby, NC",2010,80,12,92,97919,0.939552078758974
43140,"Shelby, NC",2011,95,42,137,97431,1.40612330777679
43140,"Shelby, NC",2012,90,15,105,97314,1.07898144151921
43140,"Shelby, NC",2013,100,2,102,96874,1.05291409459711
43140,"Shelby, NC",2014,68,60,128,97018,1.31934280236657
43140,"Shelby, NC",2015,58,2,60,96885,0.619290911905868
43140,"Shelby, NC",2016,122,0,122,97017,1.25751157013719
43140,"Shelby, NC",2017,170,4,174,97228,1.78960793187148
43140,"Shelby, NC",2018,165,4,169,97645,1.73075938348098
43180,"Shelbyville, TN",1990,50,2,52,30537,1.70285227756492
43180,"Shelbyville, TN",1991,21,0,21,31058,0.676154291969863
43180,"Shelbyville, TN",1992,32,2,34,31761,1.07049526148421
43180,"Shelbyville, TN",1993,42,0,42,32150,1.30637636080871
43180,"Shelbyville, TN",1994,56,0,56,32433,1.72663645052878
43180,"Shelbyville, TN",1995,49,0,49,33187,1.47648175490403
43180,"Shelbyville, TN",1996,68,0,68,33858,2.00838797330025
43180,"Shelbyville, TN",1997,85,0,85,34188,2.48625248625249
43180,"Shelbyville, TN",1998,31,0,31,34522,0.897978100921152
43180,"Shelbyville, TN",1999,64,0,64,34937,1.83186879239774
43180,"Shelbyville, TN",2000,61,0,61,37806,1.61350050256573
43180,"Shelbyville, TN",2001,47,147,194,38414,5.05024209923465
43180,"Shelbyville, TN",2002,210,34,244,38960,6.26283367556468
43180,"Shelbyville, TN",2003,117,42,159,39697,4.00534045393858
43180,"Shelbyville, TN",2004,584,0,584,40558,14.3991321071059
43180,"Shelbyville, TN",2005,459,0,459,41616,11.0294117647059
43180,"Shelbyville, TN",2006,374,0,374,42780,8.74240299205236
43180,"Shelbyville, TN",2007,222,0,222,43678,5.08265030450112
43180,"Shelbyville, TN",2008,180,3,183,44395,4.12208582047528
43180,"Shelbyville, TN",2009,120,76,196,44845,4.37060987847029
43180,"Shelbyville, TN",2010,69,58,127,45077,2.8174013354926
43180,"Shelbyville, TN",2011,50,8,58,45240,1.28205128205128
43180,"Shelbyville, TN",2012,66,0,66,45271,1.45788694749398
43180,"Shelbyville, TN",2013,71,2,73,45613,1.60042093262886
43180,"Shelbyville, TN",2014,107,64,171,46288,3.69426201175251
43180,"Shelbyville, TN",2015,135,26,161,46922,3.43122629043945
43180,"Shelbyville, TN",2016,189,2,191,47402,4.02936584954221
43180,"Shelbyville, TN",2017,233,4,237,48138,4.92334538202667
43180,"Shelbyville, TN",2018,256,2,258,49038,5.2612259880093
43220,"Shelton, WA",1990,455,10,465,38717,12.010228065191
43220,"Shelton, WA",1991,446,33,479,40692,11.7713555490023
43220,"Shelton, WA",1992,496,16,512,42502,12.0464919297915
43220,"Shelton, WA",1993,523,8,531,44131,12.0323582062496
43220,"Shelton, WA",1994,473,25,498,45783,10.8773999082629
43220,"Shelton, WA",1995,375,37,412,47281,8.71385968993888
43220,"Shelton, WA",1996,397,20,417,48374,8.62033323686278
43220,"Shelton, WA",1997,367,24,391,49563,7.88894941791256
43220,"Shelton, WA",1998,385,44,429,49879,8.60081396980693
43220,"Shelton, WA",1999,364,16,380,50364,7.54507187673735
43220,"Shelton, WA",2000,364,40,404,49631,8.14007374423243
43220,"Shelton, WA",2001,373,20,393,50298,7.8134319456042
43220,"Shelton, WA",2002,413,16,429,51215,8.37645221126623
43220,"Shelton, WA",2003,460,22,482,52351,9.20708295925579
43220,"Shelton, WA",2004,508,34,542,53819,10.0707928426764
43220,"Shelton, WA",2005,601,32,633,55198,11.4678068045944
43220,"Shelton, WA",2006,516,34,550,56872,9.67083978055985
43220,"Shelton, WA",2007,411,24,435,58679,7.41321426745514
43220,"Shelton, WA",2008,236,14,250,59785,4.18165091578155
43220,"Shelton, WA",2009,149,11,160,60333,2.65194835330582
43220,"Shelton, WA",2010,140,0,140,60735,2.30509590845476
43220,"Shelton, WA",2011,134,0,134,60870,2.20141284705109
43220,"Shelton, WA",2012,121,0,121,60681,1.99403437649347
43220,"Shelton, WA",2013,120,15,135,60472,2.23243815319487
43220,"Shelton, WA",2014,108,0,108,60615,1.78173719376392
43220,"Shelton, WA",2015,111,0,111,61033,1.81868825061852
43220,"Shelton, WA",2016,166,0,166,62179,2.66971163897779
43220,"Shelton, WA",2017,208,4,212,63801,3.322831930534
43220,"Shelton, WA",2018,266,10,276,65507,4.21329018272856
43260,"Sheridan, WY",1990,10,0,10,23563,0.424394177311887
43260,"Sheridan, WY",1991,84,0,84,23571,3.56370115820288
43260,"Sheridan, WY",1992,84,0,84,23954,3.50672121566335
43260,"Sheridan, WY",1993,96,2,98,24380,4.01968826907301
43260,"Sheridan, WY",1994,128,30,158,24715,6.39287881853126
43260,"Sheridan, WY",1995,98,22,120,24986,4.80268950612343
43260,"Sheridan, WY",1996,140,32,172,25193,6.82729329575676
43260,"Sheridan, WY",1997,95,12,107,25150,4.2544731610338
43260,"Sheridan, WY",1998,95,11,106,25162,4.21270169302917
43260,"Sheridan, WY",1999,83,7,90,25119,3.58294518093873
43260,"Sheridan, WY",2000,95,4,99,26584,3.72404453806801
43260,"Sheridan, WY",2001,90,12,102,26623,3.83127371070127
43260,"Sheridan, WY",2002,106,6,112,26839,4.17303178210813
43260,"Sheridan, WY",2003,215,72,287,26938,10.6540945875715
43260,"Sheridan, WY",2004,184,16,200,26942,7.42335387127904
43260,"Sheridan, WY",2005,171,4,175,27075,6.46352723915051
43260,"Sheridan, WY",2006,367,6,373,27422,13.6022171978703
43260,"Sheridan, WY",2007,328,11,339,27845,12.1745376189621
43260,"Sheridan, WY",2008,212,18,230,28465,8.0800983664149
43260,"Sheridan, WY",2009,86,0,86,29017,2.96377985318951
43260,"Sheridan, WY",2010,117,4,121,29144,4.15179796870711
43260,"Sheridan, WY",2011,101,57,158,29244,5.40281767200109
43260,"Sheridan, WY",2012,138,8,146,29518,4.94613456196219
43260,"Sheridan, WY",2013,138,2,140,29728,4.70936490850377
43260,"Sheridan, WY",2014,107,10,117,29848,3.9198606271777
43260,"Sheridan, WY",2015,120,13,133,29886,4.45024426152714
43260,"Sheridan, WY",2016,125,23,148,29963,4.93942529119247
43260,"Sheridan, WY",2017,126,35,161,30132,5.34315677684853
43260,"Sheridan, WY",2018,150,27,177,30233,5.85452981841035
43300,"Sherman-Denison, TX",1990,59,2,61,95004,0.642078228285125
43300,"Sherman-Denison, TX",1991,49,7,56,95594,0.585810824947172
43300,"Sherman-Denison, TX",1992,90,9,99,95319,1.03861769426872
43300,"Sherman-Denison, TX",1993,107,2,109,95943,1.13609122082903
43300,"Sherman-Denison, TX",1994,115,6,121,96833,1.24957400886062
43300,"Sherman-Denison, TX",1995,133,76,209,97811,2.13677398247641
43300,"Sherman-Denison, TX",1996,186,24,210,99909,2.10191274059394
43300,"Sherman-Denison, TX",1997,134,472,606,101482,5.97150233538953
43300,"Sherman-Denison, TX",1998,220,173,393,102815,3.82239945533239
43300,"Sherman-Denison, TX",1999,215,42,257,104378,2.46220467914695
43300,"Sherman-Denison, TX",2000,171,29,200,110939,1.80279252562219
43300,"Sherman-Denison, TX",2001,247,22,269,112330,2.39472981394107
43300,"Sherman-Denison, TX",2002,383,16,399,113239,3.52352104840205
43300,"Sherman-Denison, TX",2003,313,24,337,114421,2.94526354427946
43300,"Sherman-Denison, TX",2004,411,110,521,114998,4.53051357414912
43300,"Sherman-Denison, TX",2005,423,321,744,115666,6.43231373091488
43300,"Sherman-Denison, TX",2006,355,90,445,117174,3.7977708365337
43300,"Sherman-Denison, TX",2007,266,252,518,118331,4.37755110664154
43300,"Sherman-Denison, TX",2008,185,18,203,118834,1.70826531127455
43300,"Sherman-Denison, TX",2009,108,5,113,120069,0.941125519492958
43300,"Sherman-Denison, TX",2010,75,252,327,121030,2.70180946872676
43300,"Sherman-Denison, TX",2011,62,14,76,121417,0.625942001531911
43300,"Sherman-Denison, TX",2012,70,6,76,121854,0.623697211416942
43300,"Sherman-Denison, TX",2013,172,191,363,122371,2.96638909545562
43300,"Sherman-Denison, TX",2014,203,68,271,123615,2.19229057962221
43300,"Sherman-Denison, TX",2015,322,18,340,125647,2.70599377621431
43300,"Sherman-Denison, TX",2016,374,356,730,128331,5.68841511404104
43300,"Sherman-Denison, TX",2017,666,177,843,131214,6.42461932415748
43300,"Sherman-Denison, TX",2018,531,226,757,133991,5.64963318431835
43320,"Show Low, AZ",1990,190,60,250,77972,3.20627917714051
43320,"Show Low, AZ",1991,169,0,169,78964,2.14021579453928
43320,"Show Low, AZ",1992,185,0,185,80824,2.28892408195585
43320,"Show Low, AZ",1993,175,44,219,84357,2.5961093922259
43320,"Show Low, AZ",1994,284,36,320,86379,3.70460412831823
43320,"Show Low, AZ",1995,342,5,347,89659,3.87021938678772
43320,"Show Low, AZ",1996,468,22,490,92146,5.31764808022052
43320,"Show Low, AZ",1997,438,30,468,94697,4.94207841853491
43320,"Show Low, AZ",1998,585,34,619,96905,6.38769929312213
43320,"Show Low, AZ",1999,562,43,605,98470,6.14400324972073
43320,"Show Low, AZ",2000,555,29,584,97689,5.97815516588357
43320,"Show Low, AZ",2001,652,7,659,97849,6.73486698893193
43320,"Show Low, AZ",2002,654,20,674,100123,6.73171998441916
43320,"Show Low, AZ",2003,784,88,872,101529,8.58867909661279
43320,"Show Low, AZ",2004,914,36,950,102774,9.24358300737541
43320,"Show Low, AZ",2005,1216,319,1535,104184,14.7335483375566
43320,"Show Low, AZ",2006,1129,108,1237,105624,11.7113534802696
43320,"Show Low, AZ",2007,796,176,972,106927,9.09031395250966
43320,"Show Low, AZ",2008,414,0,414,107626,3.84665415420066
43320,"Show Low, AZ",2009,135,0,135,107571,1.25498507962183
43320,"Show Low, AZ",2010,109,31,140,107696,1.29995543009954
43320,"Show Low, AZ",2011,96,4,100,107545,0.929843321400344
43320,"Show Low, AZ",2012,91,2,93,107314,0.866615725813967
43320,"Show Low, AZ",2013,144,0,144,107145,1.34397312053759
43320,"Show Low, AZ",2014,183,8,191,107724,1.77304964539007
43320,"Show Low, AZ",2015,165,12,177,107688,1.64363717405839
43320,"Show Low, AZ",2016,219,2,221,108523,2.03643467283433
43320,"Show Low, AZ",2017,315,46,361,109144,3.30755698893205
43320,"Show Low, AZ",2018,331,37,368,110445,3.33197519127167
43340,"Shreveport-Bossier City, LA",1990,309,23,332,400864,0.828211064101541
43340,"Shreveport-Bossier City, LA",1991,505,47,552,398273,1.38598398585895
43340,"Shreveport-Bossier City, LA",1992,800,63,863,399368,2.16091424450632
43340,"Shreveport-Bossier City, LA",1993,1035,14,1049,401011,2.61588834221505
43340,"Shreveport-Bossier City, LA",1994,1135,120,1255,401779,3.12360775451181
43340,"Shreveport-Bossier City, LA",1995,1054,95,1149,403438,2.84802125729356
43340,"Shreveport-Bossier City, LA",1996,1132,234,1366,403769,3.38312252798011
43340,"Shreveport-Bossier City, LA",1997,847,4,851,404916,2.10167046992463
43340,"Shreveport-Bossier City, LA",1998,886,0,886,402405,2.20176190653695
43340,"Shreveport-Bossier City, LA",1999,1063,48,1111,402560,2.75983704292528
43340,"Shreveport-Bossier City, LA",2000,960,60,1020,417850,2.44106736867297
43340,"Shreveport-Bossier City, LA",2001,1071,80,1151,417622,2.75608085780922
43340,"Shreveport-Bossier City, LA",2002,1219,224,1443,417953,3.45254131445402
43340,"Shreveport-Bossier City, LA",2003,1657,609,2266,418234,5.41801957755706
43340,"Shreveport-Bossier City, LA",2004,1661,330,1991,421695,4.72142188074319
43340,"Shreveport-Bossier City, LA",2005,1847,750,2597,424302,6.12064048720015
43340,"Shreveport-Bossier City, LA",2006,1822,72,1894,430852,4.39594106560954
43340,"Shreveport-Bossier City, LA",2007,1472,124,1596,431496,3.69875966405251
43340,"Shreveport-Bossier City, LA",2008,1021,491,1512,433607,3.48702857656818
43340,"Shreveport-Bossier City, LA",2009,1098,252,1350,435976,3.09650072481054
43340,"Shreveport-Bossier City, LA",2010,1165,192,1357,441133,3.07616977192819
43340,"Shreveport-Bossier City, LA",2011,1158,264,1422,445089,3.1948666446486
43340,"Shreveport-Bossier City, LA",2012,1196,396,1592,448329,3.55096368961187
43340,"Shreveport-Bossier City, LA",2013,1202,418,1620,446890,3.62505314506926
43340,"Shreveport-Bossier City, LA",2014,1242,477,1719,444829,3.86440632242952
43340,"Shreveport-Bossier City, LA",2015,1023,84,1107,444104,2.49265937708285
43340,"Shreveport-Bossier City, LA",2016,984,202,1186,441793,2.68451514623364
43340,"Shreveport-Bossier City, LA",2017,1125,0,1125,439631,2.55896422226822
43340,"Shreveport-Bossier City, LA",2018,1219,0,1219,436341,2.79368658915848
43380,"Sidney, OH",1990,231,110,341,45048,7.56970342745516
43380,"Sidney, OH",1991,174,38,212,45612,4.64789967552398
43380,"Sidney, OH",1992,205,39,244,45867,5.31972878104084
43380,"Sidney, OH",1993,258,46,304,46281,6.56857025561245
43380,"Sidney, OH",1994,216,16,232,46508,4.98838909434936
43380,"Sidney, OH",1995,197,48,245,46887,5.22532898244716
43380,"Sidney, OH",1996,263,43,306,46907,6.52354659219306
43380,"Sidney, OH",1997,281,36,317,47263,6.70714935573281
43380,"Sidney, OH",1998,219,27,246,47511,5.17774831091747
43380,"Sidney, OH",1999,231,40,271,47820,5.66708490171476
43380,"Sidney, OH",2000,186,24,210,48360,4.3424317617866
43380,"Sidney, OH",2001,196,20,216,48662,4.43878180099462
43380,"Sidney, OH",2002,188,17,205,48671,4.21195373014732
43380,"Sidney, OH",2003,188,16,204,48766,4.18324242299963
43380,"Sidney, OH",2004,184,34,218,48791,4.46803713799676
43380,"Sidney, OH",2005,215,80,295,49044,6.01500693255036
43380,"Sidney, OH",2006,190,32,222,49099,4.52147701582517
43380,"Sidney, OH",2007,159,69,228,49284,4.6262478694911104
43380,"Sidney, OH",2008,121,23,144,49454,2.91179682128847
43380,"Sidney, OH",2009,82,0,82,49540,1.65522809850626
43380,"Sidney, OH",2010,96,2,98,49312,1.98734587929916
43380,"Sidney, OH",2011,78,0,78,49216,1.58485045513654
43380,"Sidney, OH",2012,94,2,96,49119,1.95443718316741
43380,"Sidney, OH",2013,45,0,45,49163,0.915322498627016
43380,"Sidney, OH",2014,39,2,41,48954,0.837520938023451
43380,"Sidney, OH",2015,59,2,61,48980,1.24540628828093
43380,"Sidney, OH",2016,53,0,53,48719,1.0878712617254
43380,"Sidney, OH",2017,81,0,81,48703,1.66314190090959
43380,"Sidney, OH",2018,53,0,53,48627,1.0899294630555
43420,"Sierra Vista-Douglas, AZ",1990,240,72,312,97822,3.18946658215943
43420,"Sierra Vista-Douglas, AZ",1991,312,0,312,98574,3.16513482256985
43420,"Sierra Vista-Douglas, AZ",1992,538,57,595,100561,5.91680671433259
43420,"Sierra Vista-Douglas, AZ",1993,528,8,536,103081,5.19979433649266
43420,"Sierra Vista-Douglas, AZ",1994,694,38,732,107517,6.80822567593962
43420,"Sierra Vista-Douglas, AZ",1995,561,35,596,110191,5.40879019157644
43420,"Sierra Vista-Douglas, AZ",1996,580,51,631,110151,5.72849996822544
43420,"Sierra Vista-Douglas, AZ",1997,544,71,615,111693,5.50616421799038
43420,"Sierra Vista-Douglas, AZ",1998,563,24,587,112406,5.22214116684163
43420,"Sierra Vista-Douglas, AZ",1999,624,36,660,112394,5.87219958360767
43420,"Sierra Vista-Douglas, AZ",2000,686,0,686,118132,5.80706328513866
43420,"Sierra Vista-Douglas, AZ",2001,613,6,619,118798,5.21052542972104
43420,"Sierra Vista-Douglas, AZ",2002,681,93,774,119847,6.45823424866705
43420,"Sierra Vista-Douglas, AZ",2003,826,4,830,120638,6.88008753460767
43420,"Sierra Vista-Douglas, AZ",2004,931,25,956,123234,7.75759936381194
43420,"Sierra Vista-Douglas, AZ",2005,1265,116,1381,125786,10.9789642726536
43420,"Sierra Vista-Douglas, AZ",2006,1032,69,1101,127241,8.65287132292264
43420,"Sierra Vista-Douglas, AZ",2007,483,5,488,128206,3.80637411665601
43420,"Sierra Vista-Douglas, AZ",2008,417,55,472,129023,3.65826248033296
43420,"Sierra Vista-Douglas, AZ",2009,372,96,468,130081,3.59775831981611
43420,"Sierra Vista-Douglas, AZ",2010,347,0,347,131822,2.63233754608487
43420,"Sierra Vista-Douglas, AZ",2011,319,0,319,133111,2.39649615734237
43420,"Sierra Vista-Douglas, AZ",2012,278,88,366,132026,2.77218123702907
43420,"Sierra Vista-Douglas, AZ",2013,172,28,200,129608,1.54311462255416
43420,"Sierra Vista-Douglas, AZ",2014,179,82,261,127352,2.04943777875495
43420,"Sierra Vista-Douglas, AZ",2015,139,76,215,126502,1.6995778722866
43420,"Sierra Vista-Douglas, AZ",2016,149,0,149,125782,1.18458920990285
43420,"Sierra Vista-Douglas, AZ",2017,192,10,202,124990,1.61612929034323
43420,"Sierra Vista-Douglas, AZ",2018,212,15,227,126770,1.7906444742447
43460,"Sikeston, MO",1990,40,46,86,39427,2.18124635402136
43460,"Sikeston, MO",1991,41,29,70,39260,1.78298522669384
43460,"Sikeston, MO",1992,34,14,48,39523,1.2144827062723
43460,"Sikeston, MO",1993,37,16,53,39888,1.32872041716807
43460,"Sikeston, MO",1994,64,32,96,39945,2.40330454374765
43460,"Sikeston, MO",1995,46,4,50,40229,1.24288448631584
43460,"Sikeston, MO",1996,65,26,91,40173,2.26520299703781
43460,"Sikeston, MO",1997,50,2,52,40351,1.28869173006865
43460,"Sikeston, MO",1998,69,10,79,40291,1.96073564815964
43460,"Sikeston, MO",1999,61,16,77,40563,1.89828168527969
43460,"Sikeston, MO",2000,53,6,59,40371,1.46144509672785
43460,"Sikeston, MO",2001,62,58,120,40206,2.98462915982689
43460,"Sikeston, MO",2002,109,0,109,39885,2.73285696377084
43460,"Sikeston, MO",2003,80,21,101,39850,2.534504391468
43460,"Sikeston, MO",2004,78,10,88,39704,2.21640137013903
43460,"Sikeston, MO",2005,76,6,82,39719,2.06450313452
43460,"Sikeston, MO",2006,84,0,84,39626,2.11982031999192
43460,"Sikeston, MO",2007,75,6,81,39509,2.05016578501101
43460,"Sikeston, MO",2008,28,8,36,39293,0.91619372407299
43460,"Sikeston, MO",2009,20,6,26,39185,0.663519203776955
43460,"Sikeston, MO",2010,28,0,28,39249,0.713393971820938
43460,"Sikeston, MO",2011,36,16,52,39133,1.32880177855007
43460,"Sikeston, MO",2012,45,20,65,39150,1.6602809706258
43460,"Sikeston, MO",2013,42,32,74,39195,1.88799591784666
43460,"Sikeston, MO",2014,39,32,71,38859,1.82711855683368
43460,"Sikeston, MO",2015,46,18,64,38999,1.64106771968512
43460,"Sikeston, MO",2016,34,10,44,38761,1.13516163153685
43460,"Sikeston, MO",2017,45,9,54,38566,1.40019706477208
43460,"Sikeston, MO",2018,50,2,52,38458,1.35212439544438
43500,"Silver City, NM",2013,2,0,2,29096,0.0687379708551004
43500,"Silver City, NM",2014,4,0,4,28863,0.138585732598829
43500,"Silver City, NM",2015,15,0,15,28361,0.528895313987518
43500,"Silver City, NM",2016,7,0,7,28043,0.249616660129087
43500,"Silver City, NM",2017,11,0,11,27692,0.397226635851509
43500,"Silver City, NM",2018,9,0,9,27346,0.329115775616178
43580,"Sioux City, IA-NE-SD",1990,293,80,373,154966,2.40697959552418
43580,"Sioux City, IA-NE-SD",1991,316,207,523,156144,3.34947228199611
43580,"Sioux City, IA-NE-SD",1992,415,177,592,157415,3.76075977511673
43580,"Sioux City, IA-NE-SD",1993,397,388,785,159197,4.93099744341916
43580,"Sioux City, IA-NE-SD",1994,450,865,1315,160735,8.18116776059974
43580,"Sioux City, IA-NE-SD",1995,430,358,788,162121,4.86056710728407
43580,"Sioux City, IA-NE-SD",1996,533,280,813,163541,4.97123045597129
43580,"Sioux City, IA-NE-SD",1997,448,453,901,163448,5.51245656110812
43580,"Sioux City, IA-NE-SD",1998,419,60,479,163494,2.92977112309932
43580,"Sioux City, IA-NE-SD",1999,461,85,546,164196,3.32529416063729
43580,"Sioux City, IA-NE-SD",2000,419,44,463,167762,2.75986218571548
43580,"Sioux City, IA-NE-SD",2001,442,80,522,167040,3.125
43580,"Sioux City, IA-NE-SD",2002,459,46,505,166544,3.03223172254779
43580,"Sioux City, IA-NE-SD",2003,426,134,560,166232,3.36878579334905
43580,"Sioux City, IA-NE-SD",2004,434,119,553,166178,3.32775698347555
43580,"Sioux City, IA-NE-SD",2005,394,34,428,164840,2.59645717058966
43580,"Sioux City, IA-NE-SD",2006,365,34,399,165345,2.41313616982673
43580,"Sioux City, IA-NE-SD",2007,293,65,358,165607,2.16174437070897
43580,"Sioux City, IA-NE-SD",2008,214,8,222,166196,1.3357722207514
43580,"Sioux City, IA-NE-SD",2009,213,30,243,167549,1.45032199535658
43580,"Sioux City, IA-NE-SD",2010,253,66,319,168873,1.88899350399413
43580,"Sioux City, IA-NE-SD",2011,203,16,219,168969,1.29609573353692
43580,"Sioux City, IA-NE-SD",2012,271,32,303,168552,1.79766481560587
43580,"Sioux City, IA-NE-SD",2013,348,97,445,168565,2.63993118381633
43580,"Sioux City, IA-NE-SD",2014,301,107,408,168531,2.42091959342792
43580,"Sioux City, IA-NE-SD",2015,349,161,510,168643,3.0241397508346
43580,"Sioux City, IA-NE-SD",2016,391,143,534,168947,3.16075455616258
43580,"Sioux City, IA-NE-SD",2017,383,90,473,168218,2.81182750954119
43580,"Sioux City, IA-NE-SD",2018,327,141,468,169045,2.76849359637966
43620,"Sioux Falls, SD",1990,539,202,741,154048,4.81018903199003
43620,"Sioux Falls, SD",1991,728,581,1309,156419,8.36854857785819
43620,"Sioux Falls, SD",1992,895,283,1178,159815,7.37102274504896
43620,"Sioux Falls, SD",1993,902,684,1586,162704,9.74776280853574
43620,"Sioux Falls, SD",1994,958,864,1822,166136,10.9669186690422
43620,"Sioux Falls, SD",1995,880,690,1570,168370,9.32470155015739
43620,"Sioux Falls, SD",1996,1071,528,1599,171130,9.34377373926255
43620,"Sioux Falls, SD",1997,1177,235,1412,172419,8.18935268154902
43620,"Sioux Falls, SD",1998,1399,307,1706,175083,9.74395001227989
43620,"Sioux Falls, SD",1999,1476,406,1882,178665,10.5336803514958
43620,"Sioux Falls, SD",2000,1614,761,2375,188310,12.6121820402528
43620,"Sioux Falls, SD",2001,1661,734,2395,191693,12.4939356158024
43620,"Sioux Falls, SD",2002,1624,433,2057,194442,10.578990135876
43620,"Sioux Falls, SD",2003,1935,585,2520,197813,12.7393042924378
43620,"Sioux Falls, SD",2004,1909,539,2448,202328,12.0991657111225
43620,"Sioux Falls, SD",2005,1869,426,2295,206605,11.108153239273
43620,"Sioux Falls, SD",2006,1646,677,2323,211576,10.9795061821757
43620,"Sioux Falls, SD",2007,1517,865,2382,216943,10.9798426314746
43620,"Sioux Falls, SD",2008,940,926,1866,221887,8.40968601134812
43620,"Sioux Falls, SD",2009,962,615,1577,225913,6.98056331419617
43620,"Sioux Falls, SD",2010,755,326,1081,229098,4.71850474469441
43620,"Sioux Falls, SD",2011,716,413,1129,232128,4.8636958919217
43620,"Sioux Falls, SD",2012,1104,483,1587,237027,6.69543976002734
43620,"Sioux Falls, SD",2013,1330,1079,2409,241777,9.96372690537148
43620,"Sioux Falls, SD",2014,1134,1196,2330,246146,9.46592672641441
43620,"Sioux Falls, SD",2015,1069,857,1926,250053,7.70236709817519
43620,"Sioux Falls, SD",2016,1431,1653,3084,254820,12.1026607016718
43620,"Sioux Falls, SD",2017,1533,1381,2914,260521,11.1852787299296
43620,"Sioux Falls, SD",2018,1380,1008,2388,265653,8.98917008277716
43660,"Snyder, TX",1990,3,0,3,18610,0.16120365394949
43660,"Snyder, TX",1991,3,0,3,18430,0.162778079218665
43660,"Snyder, TX",1992,2,0,2,18706,0.106917566556185
43660,"Snyder, TX",1993,4,0,4,18218,0.219563069491712
43660,"Snyder, TX",1994,5,0,5,18136,0.275694750771945
43660,"Snyder, TX",1995,5,0,5,18224,0.274363476733977
43660,"Snyder, TX",1996,4,0,4,18263,0.219022066473197
43660,"Snyder, TX",1997,5,0,5,18128,0.275816416593116
43660,"Snyder, TX",1998,5,0,5,18034,0.277254075634912
43660,"Snyder, TX",1999,5,40,45,17647,2.55000850002833
43660,"Snyder, TX",2000,8,0,8,16251,0.49227739831395
43660,"Snyder, TX",2001,1,0,1,15838,0.0631392852632908
43660,"Snyder, TX",2002,2,0,2,15982,0.125140783381304
43660,"Snyder, TX",2003,1,0,1,15931,0.0627706986378758
43660,"Snyder, TX",2004,4,0,4,16118,0.248169748107706
43660,"Snyder, TX",2005,7,0,7,16085,0.435188063413118
43660,"Snyder, TX",2006,10,0,10,16232,0.616067028092656
43660,"Snyder, TX",2007,4,0,4,16431,0.243442273750837
43660,"Snyder, TX",2008,8,0,8,16478,0.485495812598616
43660,"Snyder, TX",2009,3,0,3,16806,0.178507675830061
43660,"Snyder, TX",2010,50,34,84,16929,4.9618996987418
43660,"Snyder, TX",2011,49,40,89,16861,5.27845323527667
43660,"Snyder, TX",2012,51,40,91,17124,5.31417893015651
43660,"Snyder, TX",2013,4,2,6,17276,0.347302616346376
43660,"Snyder, TX",2014,8,0,8,17380,0.46029919447641
43660,"Snyder, TX",2015,6,0,6,17566,0.341568939997723
43660,"Snyder, TX",2016,8,0,8,17381,0.460272711581612
43660,"Snyder, TX",2017,8,0,8,17004,0.470477534697718
43660,"Snyder, TX",2018,12,0,12,16866,0.711490572749911
43700,"Somerset, KY",1990,22,76,98,49651,1.97377696320316
43700,"Somerset, KY",1991,13,13,26,50342,0.516467363235469
43700,"Somerset, KY",1992,20,34,54,51353,1.05154518723346
43700,"Somerset, KY",1993,29,63,92,52111,1.76546218648654
43700,"Somerset, KY",1994,31,109,140,53288,2.62723314817595
43700,"Somerset, KY",1995,29,78,107,54260,1.97198673055658
43700,"Somerset, KY",1996,35,38,73,55054,1.32597086496894
43700,"Somerset, KY",1997,15,122,137,55779,2.45612147940981
43700,"Somerset, KY",1998,28,36,64,56262,1.13753510362234
43700,"Somerset, KY",1999,57,44,101,57003,1.77183657000509
43700,"Somerset, KY",2000,30,4,34,56428,0.602537747217693
43700,"Somerset, KY",2001,43,2,45,56911,0.79070829892288
43700,"Somerset, KY",2002,54,0,54,57545,0.938396037883396
43700,"Somerset, KY",2003,29,0,29,58232,0.49800796812749
43700,"Somerset, KY",2004,70,0,70,59175,1.18293198141107
43700,"Somerset, KY",2005,29,0,29,59950,0.483736447039199
43700,"Somerset, KY",2006,25,0,25,60752,0.411509086120622
43700,"Somerset, KY",2007,15,12,27,61440,0.439453125
43700,"Somerset, KY",2008,4,4,8,62270,0.128472779829774
43700,"Somerset, KY",2009,7,12,19,62711,0.302977149144488
43700,"Somerset, KY",2010,7,0,7,63190,0.110777021680646
43700,"Somerset, KY",2011,9,2,11,63510,0.173201070697528
43700,"Somerset, KY",2012,11,4,15,63523,0.236134943248902
43700,"Somerset, KY",2013,14,0,14,63793,0.219459815340241
43700,"Somerset, KY",2014,13,2,15,63862,0.234881463154928
43700,"Somerset, KY",2015,12,2,14,63858,0.219236430830906
43700,"Somerset, KY",2016,28,4,32,64025,0.499804763764155
43700,"Somerset, KY",2017,31,0,31,64357,0.481688083658343
43700,"Somerset, KY",2018,34,0,34,64623,0.526128468192439
43740,"Somerset, PA",1990,158,24,182,78210,2.32706814985296
43740,"Somerset, PA",1991,180,66,246,78662,3.12730416211131
43740,"Somerset, PA",1992,177,40,217,78663,2.75860315523181
43740,"Somerset, PA",1993,186,14,200,78820,2.53742704897234
43740,"Somerset, PA",1994,191,14,205,78910,2.5978963375998
43740,"Somerset, PA",1995,167,76,243,79448,3.05860437015406
43740,"Somerset, PA",1996,204,93,297,79624,3.73003114638802
43740,"Somerset, PA",1997,221,18,239,79700,2.99874529485571
43740,"Somerset, PA",1998,193,40,233,79362,2.93591391345984
43740,"Somerset, PA",1999,217,12,229,79291,2.88809574857172
43740,"Somerset, PA",2000,210,30,240,80034,2.9987255416448
43740,"Somerset, PA",2001,203,31,234,79523,2.94254492411001
43740,"Somerset, PA",2002,184,40,224,79621,2.81332814207307
43740,"Somerset, PA",2003,208,22,230,79754,2.88386789377335
43740,"Somerset, PA",2004,223,10,233,79402,2.93443490088411
43740,"Somerset, PA",2005,131,10,141,79015,1.78447130291717
43740,"Somerset, PA",2006,98,16,114,78834,1.4460765659487
43740,"Somerset, PA",2007,155,4,159,78490,2.02573576251752
43740,"Somerset, PA",2008,123,83,206,78120,2.63696876600102
43740,"Somerset, PA",2009,67,63,130,78025,1.66613264979173
43740,"Somerset, PA",2010,108,4,112,77763,1.44027365199388
43740,"Somerset, PA",2011,46,0,46,77275,0.595276609511485
43740,"Somerset, PA",2012,46,4,50,77012,0.649249467615437
43740,"Somerset, PA",2013,69,0,69,76588,0.900924426803155
43740,"Somerset, PA",2014,55,2,57,76151,0.748512823206524
43740,"Somerset, PA",2015,104,0,104,75396,1.37938352167224
43740,"Somerset, PA",2016,63,0,63,74892,0.841211344335844
43740,"Somerset, PA",2017,67,4,71,74356,0.95486578083813
43740,"Somerset, PA",2018,94,0,94,73952,1.27109476417135
43760,"Sonora, CA",1990,705,143,848,48833,17.3653062478242
43760,"Sonora, CA",1991,398,163,561,49975,11.2256128064032
43760,"Sonora, CA",1992,357,6,363,50693,7.16075197759059
43760,"Sonora, CA",1993,247,4,251,51608,4.86358704076887
43760,"Sonora, CA",1994,222,8,230,51850,4.43587270973963
43760,"Sonora, CA",1995,182,3,185,51544,3.58916653732733
43760,"Sonora, CA",1996,157,0,157,52152,3.0104310477067
43760,"Sonora, CA",1997,168,82,250,52304,4.77974915876415
43760,"Sonora, CA",1998,263,150,413,52671,7.84112699588009
43760,"Sonora, CA",1999,198,0,198,53373,3.70974088022034
43760,"Sonora, CA",2000,275,4,279,54658,5.10446778147755
43760,"Sonora, CA",2001,253,0,253,55253,4.5789368903046
43760,"Sonora, CA",2002,366,4,370,55850,6.62488809310654
43760,"Sonora, CA",2003,356,2,358,56513,6.33482561534514
43760,"Sonora, CA",2004,372,28,400,56602,7.066888095827
43760,"Sonora, CA",2005,384,0,384,56788,6.76199197013454
43760,"Sonora, CA",2006,222,0,222,56680,3.9167254763585
43760,"Sonora, CA",2007,146,3,149,56339,2.64470437884947
43760,"Sonora, CA",2008,106,0,106,56320,1.88210227272727
43760,"Sonora, CA",2009,52,0,52,55845,0.93114871519384
43760,"Sonora, CA",2010,57,0,57,55191,1.03277708322009
43760,"Sonora, CA",2011,46,0,46,54825,0.839033287733698
43760,"Sonora, CA",2012,37,0,37,54218,0.682430189236047
43760,"Sonora, CA",2013,34,0,34,54000,0.62962962962963
43760,"Sonora, CA",2014,51,4,55,53828,1.02177305491566
43760,"Sonora, CA",2015,49,0,49,53550,0.915032679738562
43760,"Sonora, CA",2016,41,0,41,53704,0.76344406375689
43760,"Sonora, CA",2017,68,6,74,54039,1.3693813727123
43760,"Sonora, CA",2018,68,0,68,54539,1.24681420634775
43780,"South Bend-Mishawaka, IN-MI",1990,946,721,1667,297006,5.61268122529511
43780,"South Bend-Mishawaka, IN-MI",1991,957,53,1010,297811,3.39141267448147
43780,"South Bend-Mishawaka, IN-MI",1992,1253,257,1510,299260,5.04577958965448
43780,"South Bend-Mishawaka, IN-MI",1993,1248,473,1721,302297,5.69307667624885
43780,"South Bend-Mishawaka, IN-MI",1994,1277,385,1662,304047,5.46626015056883
43780,"South Bend-Mishawaka, IN-MI",1995,1107,280,1387,306130,4.5307549080456
43780,"South Bend-Mishawaka, IN-MI",1996,1290,286,1576,307405,5.12678713748963
43780,"South Bend-Mishawaka, IN-MI",1997,1219,205,1424,308093,4.62198102520992
43780,"South Bend-Mishawaka, IN-MI",1998,1203,314,1517,308315,4.92029255793588
43780,"South Bend-Mishawaka, IN-MI",1999,1274,452,1726,308794,5.58948684236093
43780,"South Bend-Mishawaka, IN-MI",2000,1203,784,1987,316991,6.26831676609115
43780,"South Bend-Mishawaka, IN-MI",2001,1071,168,1239,316897,3.90978772282477
43780,"South Bend-Mishawaka, IN-MI",2002,1015,398,1413,316678,4.46194557247425
43780,"South Bend-Mishawaka, IN-MI",2003,1197,169,1366,316545,4.31534221042822
43780,"South Bend-Mishawaka, IN-MI",2004,1117,244,1361,316831,4.29566551252876
43780,"South Bend-Mishawaka, IN-MI",2005,1108,274,1382,317221,4.35658421100747
43780,"South Bend-Mishawaka, IN-MI",2006,725,574,1299,317778,4.08775937918925
43780,"South Bend-Mishawaka, IN-MI",2007,718,532,1250,318668,3.92257772980029
43780,"South Bend-Mishawaka, IN-MI",2008,400,430,830,319966,2.59402561522162
43780,"South Bend-Mishawaka, IN-MI",2009,299,49,348,319189,1.09026313563437
43780,"South Bend-Mishawaka, IN-MI",2010,238,145,383,319054,1.20042375271898
43780,"South Bend-Mishawaka, IN-MI",2011,238,229,467,318893,1.46444105075997
43780,"South Bend-Mishawaka, IN-MI",2012,219,423,642,318296,2.01699047427552
43780,"South Bend-Mishawaka, IN-MI",2013,268,232,500,318565,1.56953839875693
43780,"South Bend-Mishawaka, IN-MI",2014,342,170,512,319315,1.60343234736859
43780,"South Bend-Mishawaka, IN-MI",2015,380,144,524,319543,1.63984189921231
43780,"South Bend-Mishawaka, IN-MI",2016,337,68,405,320772,1.26257902809472
43780,"South Bend-Mishawaka, IN-MI",2017,479,480,959,321447,2.9833845081770898
43780,"South Bend-Mishawaka, IN-MI",2018,419,319,738,322424,2.28891149542218
43900,"Spartanburg, SC",1990,925,41,966,257844,3.74645134267231
43900,"Spartanburg, SC",1991,914,68,982,260959,3.76304323667703
43900,"Spartanburg, SC",1992,1150,105,1255,263213,4.76800158046905
43900,"Spartanburg, SC",1993,1220,69,1289,265062,4.86301318182161
43900,"Spartanburg, SC",1994,1433,21,1454,267720,5.43104736291648
43900,"Spartanburg, SC",1995,1311,191,1502,270665,5.54929525428112
43900,"Spartanburg, SC",1996,1445,338,1783,273451,6.52036379461037
43900,"Spartanburg, SC",1997,1466,455,1921,275699,6.96774380755824
43900,"Spartanburg, SC",1998,1644,194,1838,277789,6.61653269207924
43900,"Spartanburg, SC",1999,1752,364,2116,280040,7.5560634195115
43900,"Spartanburg, SC",2000,1562,52,1614,284414,5.67482613373463
43900,"Spartanburg, SC",2001,1436,176,1612,286282,5.63081157739571
43900,"Spartanburg, SC",2002,1574,454,2028,288166,7.03761026630484
43900,"Spartanburg, SC",2003,1836,292,2128,289742,7.34446507582608
43900,"Spartanburg, SC",2004,1990,312,2302,291107,7.90774526205141
43900,"Spartanburg, SC",2005,2164,8,2172,293722,7.39474741422161
43900,"Spartanburg, SC",2006,2191,0,2191,298146,7.34874859967935
43900,"Spartanburg, SC",2007,1678,0,1678,303275,5.53293215728299
43900,"Spartanburg, SC",2008,1106,0,1106,308845,3.58108436270621
43900,"Spartanburg, SC",2009,624,28,652,312435,2.08683406148479
43900,"Spartanburg, SC",2010,579,0,579,313677,1.84584779885041
43900,"Spartanburg, SC",2011,549,0,549,314768,1.74414171707416
43900,"Spartanburg, SC",2012,743,0,743,316415,2.34818197620214
43900,"Spartanburg, SC",2013,969,244,1213,318481,3.80870444390717
43900,"Spartanburg, SC",2014,1084,20,1104,320994,3.43931662274061
43900,"Spartanburg, SC",2015,1418,0,1418,324316,4.37227888849147
43900,"Spartanburg, SC",2016,1921,0,1921,328459,5.84852295111414
43900,"Spartanburg, SC",2017,2316,0,2316,334130,6.93143387304343
43900,"Spartanburg, SC",2018,2685,0,2685,341298,7.86702529754057
43940,"Spearfish, SD",1990,77,103,180,20694,8.69817338358945
43940,"Spearfish, SD",1991,86,13,99,21120,4.6875
43940,"Spearfish, SD",1992,136,166,302,21428,14.0937091655777
43940,"Spearfish, SD",1993,135,84,219,21835,10.029768719945
43940,"Spearfish, SD",1994,136,50,186,22152,8.39653304442037
43940,"Spearfish, SD",1995,128,36,164,22402,7.32077493080975
43940,"Spearfish, SD",1996,104,34,138,22352,6.17394416607015
43940,"Spearfish, SD",1997,83,2,85,22198,3.82917379944139
43940,"Spearfish, SD",1998,71,0,71,21937,3.23654100378356
43940,"Spearfish, SD",1999,83,4,87,21357,4.07360584351735
43940,"Spearfish, SD",2000,110,26,136,21763,6.24913844598631
43940,"Spearfish, SD",2001,133,0,133,21738,6.11831815254393
43940,"Spearfish, SD",2002,189,16,205,21763,9.41965721637642
43940,"Spearfish, SD",2003,209,37,246,22135,11.1136209622769
43940,"Spearfish, SD",2004,269,52,321,22610,14.1972578505086
43940,"Spearfish, SD",2005,254,33,287,22889,12.538774083621
43940,"Spearfish, SD",2006,246,20,266,23172,11.4793716554462
43940,"Spearfish, SD",2007,179,4,183,23543,7.77301108609778
43940,"Spearfish, SD",2008,177,4,181,23659,7.65036561139524
43940,"Spearfish, SD",2009,134,14,148,23781,6.22345569992851
43940,"Spearfish, SD",2010,147,15,162,24205,6.69283205949184
43940,"Spearfish, SD",2011,88,20,108,24326,4.4396941544027
43940,"Spearfish, SD",2012,137,68,205,24400,8.4016393442623
43940,"Spearfish, SD",2013,147,49,196,24937,7.85980671291655
43940,"Spearfish, SD",2014,152,68,220,24729,8.89643738121234
43940,"Spearfish, SD",2015,184,14,198,24825,7.97583081570997
43940,"Spearfish, SD",2016,160,34,194,25271,7.67678366507063
43940,"Spearfish, SD",2017,191,2,193,25606,7.53729594626259
43940,"Spearfish, SD",2018,159,49,208,25741,8.0804941532963
43980,"Spencer, IA",1990,18,29,47,17652,2.66258780874688
43980,"Spencer, IA",1991,19,0,19,17626,1.0779530239419
43980,"Spencer, IA",1992,24,0,24,17744,1.35256988277728
43980,"Spencer, IA",1993,22,24,46,17669,2.60342973569529
43980,"Spencer, IA",1994,35,2,37,17655,2.09572359105069
43980,"Spencer, IA",1995,30,2,32,17527,1.82575455012267
43980,"Spencer, IA",1996,26,3,29,17542,1.65317523657508
43980,"Spencer, IA",1997,25,3,28,17593,1.59154209060422
43980,"Spencer, IA",1998,34,16,50,17473,2.86155783208379
43980,"Spencer, IA",1999,33,49,82,17254,4.75252115451489
43980,"Spencer, IA",2000,45,0,45,17360,2.59216589861751
43980,"Spencer, IA",2001,42,29,71,17256,4.11451089476124
43980,"Spencer, IA",2002,40,6,46,17086,2.69226267119279
43980,"Spencer, IA",2003,34,2,36,16985,2.11951722107742
43980,"Spencer, IA",2004,42,28,70,16960,4.12735849056604
43980,"Spencer, IA",2005,34,2,36,16848,2.13675213675214
43980,"Spencer, IA",2006,32,2,34,16812,2.0223649773971
43980,"Spencer, IA",2007,20,0,20,16725,1.19581464872945
43980,"Spencer, IA",2008,20,4,24,16697,1.43738396119063
43980,"Spencer, IA",2009,21,0,21,16708,1.25688293033277
43980,"Spencer, IA",2010,16,0,16,16635,0.961827472197175
43980,"Spencer, IA",2011,7,0,7,16595,0.42181379933715
43980,"Spencer, IA",2012,31,8,39,16539,2.35806276074732
43980,"Spencer, IA",2013,48,0,48,16440,2.91970802919708
43980,"Spencer, IA",2014,12,2,14,16485,0.849256900212314
43980,"Spencer, IA",2015,38,30,68,16497,4.12196156877008
43980,"Spencer, IA",2016,16,69,85,16296,5.21600392734413
43980,"Spencer, IA",2017,38,0,38,16153,2.35250417879032
43980,"Spencer, IA",2018,15,0,15,16134,0.929713648196355
44020,"Spirit Lake, IA",1990,73,12,85,14934,5.69171019150931
44020,"Spirit Lake, IA",1991,72,20,92,15191,6.05621749720229
44020,"Spirit Lake, IA",1992,99,77,176,15237,11.5508302159218
44020,"Spirit Lake, IA",1993,102,122,224,15377,14.5672107693308
44020,"Spirit Lake, IA",1994,81,32,113,15398,7.338615404598
44020,"Spirit Lake, IA",1995,85,38,123,15582,7.89372352714671
44020,"Spirit Lake, IA",1996,143,39,182,15760,11.5482233502538
44020,"Spirit Lake, IA",1997,87,42,129,16049,8.0378839803103
44020,"Spirit Lake, IA",1998,93,79,172,16205,10.6140080222154
44020,"Spirit Lake, IA",1999,144,10,154,16299,9.44843241916682
44020,"Spirit Lake, IA",2000,110,28,138,16460,8.38396111786148
44020,"Spirit Lake, IA",2001,152,22,174,16477,10.5601747891
44020,"Spirit Lake, IA",2002,141,62,203,16351,12.4151428047214
44020,"Spirit Lake, IA",2003,175,40,215,16339,13.1587000428423
44020,"Spirit Lake, IA",2004,209,73,282,16506,17.0846964740095
44020,"Spirit Lake, IA",2005,173,172,345,16644,20.7281903388609
44020,"Spirit Lake, IA",2006,150,98,248,16667,14.8797024059519
44020,"Spirit Lake, IA",2007,116,20,136,16634,8.17602500901767
44020,"Spirit Lake, IA",2008,90,13,103,16690,6.17136009586579
44020,"Spirit Lake, IA",2009,60,33,93,16666,5.58022320892836
44020,"Spirit Lake, IA",2010,82,10,92,16670,5.51889622075585
44020,"Spirit Lake, IA",2011,128,0,128,16858,7.59283426266461
44020,"Spirit Lake, IA",2012,103,2,105,16925,6.20384047267356
44020,"Spirit Lake, IA",2013,106,40,146,16878,8.65031401824861
44020,"Spirit Lake, IA",2014,115,19,134,16840,7.95724465558195
44020,"Spirit Lake, IA",2015,119,43,162,17005,9.52660982064099
44020,"Spirit Lake, IA",2016,231,131,362,17110,21.1572180011689
44020,"Spirit Lake, IA",2017,197,42,239,17173,13.9171955977406
44020,"Spirit Lake, IA",2018,102,79,181,17153,10.5520900134087
44060,"Spokane-Spokane Valley, WA",1990,1514,472,1986,402920,4.92901816737814
44060,"Spokane-Spokane Valley, WA",1991,1809,881,2690,412988,6.51350644570787
44060,"Spokane-Spokane Valley, WA",1992,2228,873,3101,424576,7.30375716008441
44060,"Spokane-Spokane Valley, WA",1993,2502,1158,3660,435554,8.40309123552992
44060,"Spokane-Spokane Valley, WA",1994,2339,1287,3626,442638,8.19179555302527
44060,"Spokane-Spokane Valley, WA",1995,1741,1284,3025,449708,6.72658702980601
44060,"Spokane-Spokane Valley, WA",1996,1778,1859,3637,453921,8.01240744534842
44060,"Spokane-Spokane Valley, WA",1997,1510,561,2071,456086,4.54081028577944
44060,"Spokane-Spokane Valley, WA",1998,1838,949,2787,459270,6.06832582141224
44060,"Spokane-Spokane Valley, WA",1999,1782,691,2473,461051,5.36383176698456
44060,"Spokane-Spokane Valley, WA",2000,1506,810,2316,470685,4.92048822460881
44060,"Spokane-Spokane Valley, WA",2001,1666,748,2414,474933,5.08282220860627
44060,"Spokane-Spokane Valley, WA",2002,1811,585,2396,479375,4.99817470664928
44060,"Spokane-Spokane Valley, WA",2003,2096,664,2760,483328,5.71040783898305
44060,"Spokane-Spokane Valley, WA",2004,2356,1820,4176,488534,8.5480232696189
44060,"Spokane-Spokane Valley, WA",2005,3864,843,4707,494408,9.52047701493503
44060,"Spokane-Spokane Valley, WA",2006,2980,1121,4101,502564,8.16015472656219
44060,"Spokane-Spokane Valley, WA",2007,2522,654,3176,512037,6.20267675968729
44060,"Spokane-Spokane Valley, WA",2008,1413,1247,2660,518646,5.12873906286754
44060,"Spokane-Spokane Valley, WA",2009,967,979,1946,524826,3.70789556919817
44060,"Spokane-Spokane Valley, WA",2010,1057,676,1733,528502,3.27907936015379
44060,"Spokane-Spokane Valley, WA",2011,840,1047,1887,529791,3.56178191022498
44060,"Spokane-Spokane Valley, WA",2012,1066,394,1460,531925,2.74474784979085
44060,"Spokane-Spokane Valley, WA",2013,1402,353,1755,534514,3.28335646961539
44060,"Spokane-Spokane Valley, WA",2014,1135,825,1960,539313,3.63425320732117
44060,"Spokane-Spokane Valley, WA",2015,1461,1277,2738,545380,5.02035278154681
44060,"Spokane-Spokane Valley, WA",2016,1819,1945,3764,554398,6.78934628191299
44060,"Spokane-Spokane Valley, WA",2017,1785,1856,3641,563958,6.45615453633072
44060,"Spokane-Spokane Valley, WA",2018,1944,1230,3174,573493,5.53450521627988
44100,"Springfield, IL",1990,624,644,1268,189885,6.67772599204782
44100,"Springfield, IL",1991,737,283,1020,192883,5.2881798810678
44100,"Springfield, IL",1992,1077,316,1393,196217,7.0992829367486
44100,"Springfield, IL",1993,1129,279,1408,199424,7.06033376123235
44100,"Springfield, IL",1994,1093,456,1549,202338,7.65550712174678
44100,"Springfield, IL",1995,918,283,1201,203095,5.91348876141707
44100,"Springfield, IL",1996,922,209,1131,203915,5.54642865900007
44100,"Springfield, IL",1997,812,121,933,203967,4.5742693671035
44100,"Springfield, IL",1998,848,105,953,204096,4.66937127626215
44100,"Springfield, IL",1999,843,303,1146,204013,5.61728909432242
44100,"Springfield, IL",2000,759,170,929,201628,4.60749499077509
44100,"Springfield, IL",2001,806,113,919,202427,4.53990821382523
44100,"Springfield, IL",2002,674,256,930,203281,4.57494797841412
44100,"Springfield, IL",2003,712,363,1075,203901,5.27216639447575
44100,"Springfield, IL",2004,705,284,989,204526,4.83557102764441
44100,"Springfield, IL",2005,729,271,1000,204988,4.87833434152243
44100,"Springfield, IL",2006,634,219,853,205887,4.14304934260055
44100,"Springfield, IL",2007,459,149,608,206771,2.94045103036693
44100,"Springfield, IL",2008,284,321,605,207874,2.91041688715279
44100,"Springfield, IL",2009,313,79,392,208900,1.8764959310675
44100,"Springfield, IL",2010,286,113,399,210463,1.8958201679155
44100,"Springfield, IL",2011,269,122,391,211713,1.84683982561298
44100,"Springfield, IL",2012,248,65,313,212080,1.47585816672954
44100,"Springfield, IL",2013,276,64,340,211702,1.60603111921475
44100,"Springfield, IL",2014,300,155,455,211685,2.14942012896521
44100,"Springfield, IL",2015,289,94,383,211239,1.81311216205341
44100,"Springfield, IL",2016,274,152,426,210403,2.02468595980095
44100,"Springfield, IL",2017,210,112,322,209175,1.53938090115932
44100,"Springfield, IL",2018,193,313,506,207636,2.43695698241153
44140,"Springfield, MA",1990,1054,660,1714,603229,2.84137533175626
44140,"Springfield, MA",1991,951,269,1220,600211,2.03261852915058
44140,"Springfield, MA",1992,1192,142,1334,597635,2.23213165226267
44140,"Springfield, MA",1993,1209,225,1434,596069,2.40576174905925
44140,"Springfield, MA",1994,1206,145,1351,595103,2.27019524351247
44140,"Springfield, MA",1995,1093,226,1319,592821,2.22495491893843
44140,"Springfield, MA",1996,1042,124,1166,590163,1.97572535045403
44140,"Springfield, MA",1997,951,168,1119,589410,1.8985086781697
44140,"Springfield, MA",1998,1142,180,1322,588452,2.24657236274157
44140,"Springfield, MA",1999,1140,138,1278,587702,2.17457146649152
44140,"Springfield, MA",2000,1021,99,1120,608897,1.83939155555045
44140,"Springfield, MA",2001,1034,110,1144,609075,1.87825801420186
44140,"Springfield, MA",2002,1239,172,1411,612241,2.30464800625897
44140,"Springfield, MA",2003,1197,222,1419,615294,2.30621459009839
44140,"Springfield, MA",2004,1300,144,1444,615860,2.34468872795765
44140,"Springfield, MA",2005,1156,249,1405,616530,2.27888342821923
44140,"Springfield, MA",2006,1025,423,1448,617576,2.34465069886135
44140,"Springfield, MA",2007,878,190,1068,618276,1.72738388680783
44140,"Springfield, MA",2008,496,226,722,619668,1.16514004273256
44140,"Springfield, MA",2009,469,97,566,620687,0.911892789763601
44140,"Springfield, MA",2010,507,68,575,623576,0.922100914724107
44140,"Springfield, MA",2011,377,76,453,626264,0.72333712300244
44140,"Springfield, MA",2012,426,83,509,627367,0.81132734109381
44140,"Springfield, MA",2013,408,79,487,628626,0.774705468752486
44140,"Springfield, MA",2014,420,86,506,630431,0.802625505408205
44140,"Springfield, MA",2015,405,53,458,629998,0.726986434877571
44140,"Springfield, MA",2016,535,50,585,629678,0.929046274445034
44140,"Springfield, MA",2017,441,80,521,629506,0.827633096427993
44140,"Springfield, MA",2018,492,167,659,631761,1.04311598848299
44180,"Springfield, MO",1990,1079,393,1472,287285,5.12383173503664
44180,"Springfield, MO",1991,1081,449,1530,292309,5.23418711021556
44180,"Springfield, MO",1992,1666,658,2324,298179,7.7939761016034
44180,"Springfield, MO",1993,2102,579,2681,305059,8.78846387092333
44180,"Springfield, MO",1994,2150,1749,3899,312378,12.4816728450787
44180,"Springfield, MO",1995,1723,870,2593,318403,8.14376748962792
44180,"Springfield, MO",1996,1961,374,2335,322025,7.25098982998214
44180,"Springfield, MO",1997,1990,551,2541,326450,7.78373410935825
44180,"Springfield, MO",1998,2075,487,2562,330296,7.75667885775183
44180,"Springfield, MO",1999,2140,483,2623,333785,7.85835193313061
44180,"Springfield, MO",2000,1888,736,2624,354169,7.40889236494442
44180,"Springfield, MO",2001,2109,424,2533,359413,7.0476026187144
44180,"Springfield, MO",2002,2508,1134,3642,364621,9.98845376431966
44180,"Springfield, MO",2003,2572,883,3455,371009,9.31244255530189
44180,"Springfield, MO",2004,3399,890,4289,394660,10.8675822226727
44180,"Springfield, MO",2005,3723,1392,5115,402883,12.695993625941
44180,"Springfield, MO",2006,3089,1669,4758,413765,11.4992809928341
44180,"Springfield, MO",2007,1869,1581,3450,423127,8.15358036712382
44180,"Springfield, MO",2008,990,1203,2193,429289,5.10844675731267
44180,"Springfield, MO",2009,693,503,1196,434220,2.75436414720649
44180,"Springfield, MO",2010,904,434,1338,437297,3.05970541759948
44180,"Springfield, MO",2011,700,604,1304,440329,2.96142202762026
44180,"Springfield, MO",2012,906,660,1566,444253,3.52501840167652
44180,"Springfield, MO",2013,1098,877,1975,448361,4.40493263241004
44180,"Springfield, MO",2014,1116,989,2105,451500,4.66223698781838
44180,"Springfield, MO",2015,1256,967,2223,455512,4.8802226944625
44180,"Springfield, MO",2016,1280,697,1977,457881,4.3177157383687
44180,"Springfield, MO",2017,1352,552,1904,462300,4.11853774605235
44180,"Springfield, MO",2018,1333,620,1953,466978,4.18220986855912
44220,"Springfield, OH",1990,353,90,443,147582,3.00172107709612
44220,"Springfield, OH",1991,374,108,482,147678,3.26385785289617
44220,"Springfield, OH",1992,368,318,686,147459,4.65214059501285
44220,"Springfield, OH",1993,421,132,553,147263,3.75518629934199
44220,"Springfield, OH",1994,405,54,459,147123,3.11983850247752
44220,"Springfield, OH",1995,396,16,412,147004,2.80264482599113
44220,"Springfield, OH",1996,422,80,502,146778,3.42013108231479
44220,"Springfield, OH",1997,313,20,333,145882,2.28266681290358
44220,"Springfield, OH",1998,480,44,524,145307,3.60615799651772
44220,"Springfield, OH",1999,409,40,449,144677,3.10346495987614
44220,"Springfield, OH",2000,274,10,284,144605,1.96397081705335
44220,"Springfield, OH",2001,271,4,275,143803,1.91233840740457
44220,"Springfield, OH",2002,270,22,292,143229,2.03869328138855
44220,"Springfield, OH",2003,244,29,273,141758,1.92581723782785
44220,"Springfield, OH",2004,258,0,258,141380,1.82486914697977
44220,"Springfield, OH",2005,247,40,287,141367,2.03017677392885
44220,"Springfield, OH",2006,190,10,200,140668,1.4217874712088
44220,"Springfield, OH",2007,191,204,395,139829,2.82487895930029
44220,"Springfield, OH",2008,74,30,104,139404,0.746033112392758
44220,"Springfield, OH",2009,69,0,69,138778,0.497196962054504
44220,"Springfield, OH",2010,53,4,57,138274,0.412225002531206
44220,"Springfield, OH",2011,52,90,142,137793,1.03053130420268
44220,"Springfield, OH",2012,39,76,115,137166,0.838400186635172
44220,"Springfield, OH",2013,34,38,72,136636,0.526947510173014
44220,"Springfield, OH",2014,49,4,53,136316,0.388802488335925
44220,"Springfield, OH",2015,61,2,63,135740,0.464122587299249
44220,"Springfield, OH",2016,55,0,55,134701,0.408311742303324
44220,"Springfield, OH",2017,69,52,121,134649,0.898632741423999
44220,"Springfield, OH",2018,68,0,68,134585,0.505256900843333
44260,"Starkville, MS",1990,47,181,228,38404,5.93688157483595
44260,"Starkville, MS",1991,44,70,114,38236,2.98148341876765
44260,"Starkville, MS",1992,53,38,91,38086,2.3893294123825
44260,"Starkville, MS",1993,44,76,120,37987,3.15897543896596
44260,"Starkville, MS",1994,48,185,233,38437,6.06186747144678
44260,"Starkville, MS",1995,95,163,258,38888,6.6344373585682
44260,"Starkville, MS",1996,65,146,211,39141,5.39076671520912
44260,"Starkville, MS",1997,67,179,246,39695,6.19725406222446
44260,"Starkville, MS",1998,116,268,384,39307,9.7692522960287
44260,"Starkville, MS",1999,126,282,408,39243,10.396758657595
44260,"Starkville, MS",2000,102,254,356,43122,8.25564676963035
44260,"Starkville, MS",2001,65,241,306,43186,7.08562960218589
44260,"Starkville, MS",2002,91,240,331,43036,7.6912352449112404
44260,"Starkville, MS",2003,151,28,179,43188,4.14466981568954
44260,"Starkville, MS",2004,97,83,180,43382,4.1491862984648
44260,"Starkville, MS",2005,96,499,595,43985,13.5273388655223
44260,"Starkville, MS",2006,68,4,72,45052,1.59815324513895
44260,"Starkville, MS",2007,61,562,623,46032,13.5340632603406
44260,"Starkville, MS",2008,86,32,118,46470,2.53927264902087
44260,"Starkville, MS",2009,50,45,95,47400,2.0042194092827
44260,"Starkville, MS",2010,39,44,83,47737,1.7386932568029
44260,"Starkville, MS",2011,36,0,36,47770,0.75361105296211
44260,"Starkville, MS",2012,121,43,164,48835,3.35824715880004
44260,"Starkville, MS",2013,57,33,90,49121,1.83221025630586
44260,"Starkville, MS",2014,47,210,257,49081,5.23624213035594
44260,"Starkville, MS",2015,72,180,252,49516,5.08926407625818
44260,"Starkville, MS",2016,79,8,87,49532,1.75644028103045
44260,"Starkville, MS",2017,72,10,82,49675,1.65072974333166
44260,"Starkville, MS",2018,59,60,119,49599,2.3992419202
44300,"State College, PA",1990,408,399,807,125157,6.44790143579664
44300,"State College, PA",1991,433,19,452,126145,3.58317808870744
44300,"State College, PA",1992,533,82,615,127203,4.83479163227282
44300,"State College, PA",1993,506,96,602,128937,4.66894685001202
44300,"State College, PA",1994,481,60,541,129542,4.17625171758966
44300,"State College, PA",1995,460,412,872,130328,6.69081087717144
44300,"State College, PA",1996,495,21,516,132142,3.90489019388234
44300,"State College, PA",1997,527,152,679,132569,5.12186106857561
44300,"State College, PA",1998,599,88,687,132072,5.2017081591859
44300,"State College, PA",1999,647,190,837,132409,6.32132256870757
44300,"State College, PA",2000,554,99,653,135965,4.80270657889898
44300,"State College, PA",2001,734,44,778,137620,5.65324807440779
44300,"State College, PA",2002,877,118,995,140821,7.06570752941678
44300,"State College, PA",2003,742,280,1022,142926,7.15055343324518
44300,"State College, PA",2004,654,40,694,144238,4.81149211719519
44300,"State College, PA",2005,663,38,701,145543,4.81644599877699
44300,"State College, PA",2006,624,54,678,148734,4.55847351647908
44300,"State College, PA",2007,475,159,634,149498,4.24085940949043
44300,"State College, PA",2008,375,81,456,151645,3.00702298130502
44300,"State College, PA",2009,275,63,338,153052,2.20839975955884
44300,"State College, PA",2010,347,79,426,154218,2.76232346418706
44300,"State College, PA",2011,207,52,259,155042,1.6705150862347
44300,"State College, PA",2012,489,373,862,155815,5.53220164939191
44300,"State College, PA",2013,428,349,777,158227,4.91066632117148
44300,"State College, PA",2014,365,146,511,159655,3.20065140459115
44300,"State College, PA",2015,314,75,389,160442,2.42455217461762
44300,"State College, PA",2016,326,67,393,162062,2.42499784033271
44300,"State College, PA",2017,319,148,467,162250,2.87827426810478
44300,"State College, PA",2018,265,63,328,162805,2.01468013881638
44340,"Statesboro, GA",1990,177,177,354,43317,8.17231110187686
44340,"Statesboro, GA",1991,192,113,305,44196,6.90107702054485
44340,"Statesboro, GA",1992,269,156,425,45352,9.37114129476098
44340,"Statesboro, GA",1993,247,255,502,46535,10.7875792414312
44340,"Statesboro, GA",1994,296,90,386,47670,8.09733585063982
44340,"Statesboro, GA",1995,249,143,392,48373,8.10369420957973
44340,"Statesboro, GA",1996,252,159,411,49243,8.34636395020612
44340,"Statesboro, GA",1997,262,102,364,49883,7.29707515586472
44340,"Statesboro, GA",1998,262,170,432,50573,8.5421074486386
44340,"Statesboro, GA",1999,233,212,445,50899,8.74280437729621
44340,"Statesboro, GA",2000,256,270,526,56146,9.36843230149966
44340,"Statesboro, GA",2001,328,302,630,56808,11.0899873257288
44340,"Statesboro, GA",2002,343,278,621,57361,10.8261710918568
44340,"Statesboro, GA",2003,450,6,456,59314,7.68789830394173
44340,"Statesboro, GA",2004,547,19,566,60832,9.30431351920042
44340,"Statesboro, GA",2005,525,18,543,63048,8.61248572516178
44340,"Statesboro, GA",2006,867,48,915,64304,14.2292858920129
44340,"Statesboro, GA",2007,800,30,830,65768,12.6201192069091
44340,"Statesboro, GA",2008,328,54,382,67092,5.69367435759852
44340,"Statesboro, GA",2009,171,60,231,68598,3.36744511501793
44340,"Statesboro, GA",2010,143,64,207,70562,2.93359031773476
44340,"Statesboro, GA",2011,149,377,526,72637,7.24148849759764
44340,"Statesboro, GA",2012,130,291,421,73112,5.7582886530255
44340,"Statesboro, GA",2013,170,25,195,71833,2.71462976626342
44340,"Statesboro, GA",2014,208,313,521,72671,7.16929724374234
44340,"Statesboro, GA",2015,232,42,274,73152,3.74562554680665
44340,"Statesboro, GA",2016,327,18,345,74708,4.6179793328693
44340,"Statesboro, GA",2017,357,0,357,76084,4.69218232479891
44340,"Statesboro, GA",2018,459,15,474,77296,6.13227075139723
44420,"Staunton-Waynesboro, VA",1990,654,163,817,98019,8.33511870147624
44420,"Staunton-Waynesboro, VA",1991,546,41,587,98716,5.94635114874995
44420,"Staunton-Waynesboro, VA",1992,599,60,659,99348,6.63324878205902
44420,"Staunton-Waynesboro, VA",1993,609,18,627,100106,6.26336083751224
44420,"Staunton-Waynesboro, VA",1994,634,36,670,100855,6.64320063457439
44420,"Staunton-Waynesboro, VA",1995,559,18,577,101919,5.66135852981289
44420,"Staunton-Waynesboro, VA",1996,526,54,580,102832,5.64026762097402
44420,"Staunton-Waynesboro, VA",1997,485,61,546,103444,5.27821816635088
44420,"Staunton-Waynesboro, VA",1998,573,190,763,103948,7.34020856582137
44420,"Staunton-Waynesboro, VA",1999,594,53,647,104799,6.17372303170832
44420,"Staunton-Waynesboro, VA",2000,576,56,632,109129,5.79131120050582
44420,"Staunton-Waynesboro, VA",2001,583,60,643,109602,5.86668126494042
44420,"Staunton-Waynesboro, VA",2002,633,28,661,110436,5.98536709044152
44420,"Staunton-Waynesboro, VA",2003,696,73,769,111549,6.89383141041157
44420,"Staunton-Waynesboro, VA",2004,771,333,1104,112751,9.79148743691852
44420,"Staunton-Waynesboro, VA",2005,724,146,870,114085,7.62589297453653
44420,"Staunton-Waynesboro, VA",2006,602,98,700,116262,6.02088386575149
44420,"Staunton-Waynesboro, VA",2007,512,129,641,117708,5.44567913820641
44420,"Staunton-Waynesboro, VA",2008,324,122,446,118420,3.76625570005067
44420,"Staunton-Waynesboro, VA",2009,236,17,253,118593,2.13334682485476
44420,"Staunton-Waynesboro, VA",2010,186,190,376,118311,3.17806459247238
44420,"Staunton-Waynesboro, VA",2011,180,98,278,118760,2.34085550690468
44420,"Staunton-Waynesboro, VA",2012,240,2,242,118455,2.04296990418302
44420,"Staunton-Waynesboro, VA",2013,253,238,491,119116,4.12203230464421
44420,"Staunton-Waynesboro, VA",2014,249,354,603,119479,5.04691200964186
44420,"Staunton-Waynesboro, VA",2015,287,0,287,120070,2.39027234113434
44420,"Staunton-Waynesboro, VA",2016,237,65,302,120857,2.4988209205921
44420,"Staunton-Waynesboro, VA",2017,281,26,307,121984,2.51672350472193
44420,"Staunton-Waynesboro, VA",2018,232,85,317,123007,2.57708910874991
44460,"Steamboat Springs, CO",1990,129,58,187,14211,13.1588206319049
44460,"Steamboat Springs, CO",1991,104,26,130,14663,8.86585282684307
44460,"Steamboat Springs, CO",1992,186,37,223,15047,14.8202299461687
44460,"Steamboat Springs, CO",1993,220,67,287,15588,18.4115986656402
44460,"Steamboat Springs, CO",1994,271,177,448,16134,27.7674476261312
44460,"Steamboat Springs, CO",1995,251,192,443,16601,26.6851394494308
44460,"Steamboat Springs, CO",1996,235,111,346,16982,20.3745141914969
44460,"Steamboat Springs, CO",1997,181,118,299,17306,17.2772448861666
44460,"Steamboat Springs, CO",1998,264,244,508,17491,29.0435080898748
44460,"Steamboat Springs, CO",1999,301,179,480,17899,26.8171406223811
44460,"Steamboat Springs, CO",2000,292,235,527,19815,26.5960131213727
44460,"Steamboat Springs, CO",2001,186,97,283,20210,14.0029688273132
44460,"Steamboat Springs, CO",2002,182,46,228,20469,11.1387952513557
44460,"Steamboat Springs, CO",2003,305,16,321,20893,15.3639975111281
44460,"Steamboat Springs, CO",2004,327,29,356,21162,16.8226065589264
44460,"Steamboat Springs, CO",2005,353,124,477,21398,22.2918029722404
44460,"Steamboat Springs, CO",2006,315,112,427,21859,19.5342879363191
44460,"Steamboat Springs, CO",2007,279,319,598,22491,26.588413143035
44460,"Steamboat Springs, CO",2008,173,219,392,23135,16.9440242057489
44460,"Steamboat Springs, CO",2009,70,0,70,23688,2.95508274231678
44460,"Steamboat Springs, CO",2010,27,0,27,23448,1.15148413510747
44460,"Steamboat Springs, CO",2011,40,2,42,23264,1.80536451169188
44460,"Steamboat Springs, CO",2012,54,0,54,23285,2.31908954262401
44460,"Steamboat Springs, CO",2013,40,20,60,23612,2.54108080636964
44460,"Steamboat Springs, CO",2014,74,58,132,24083,5.48104472034215
44460,"Steamboat Springs, CO",2015,102,0,102,24422,4.17656211612481
44460,"Steamboat Springs, CO",2016,115,48,163,24787,6.57602775648525
44460,"Steamboat Springs, CO",2017,115,0,115,25346,4.53720508166969
44460,"Steamboat Springs, CO",2018,154,16,170,25733,6.60630319045583
44500,"Stephenville, TX",1990,10,7,17,28056,0.605930995152552
44500,"Stephenville, TX",1991,19,0,19,28347,0.670264931033266
44500,"Stephenville, TX",1992,30,2,32,28547,1.12095841944863
44500,"Stephenville, TX",1993,31,0,31,29064,1.06661161574456
44500,"Stephenville, TX",1994,53,0,53,29882,1.77364299578341
44500,"Stephenville, TX",1995,49,8,57,30371,1.87679035922426
44500,"Stephenville, TX",1996,41,14,55,30746,1.78885058218955
44500,"Stephenville, TX",1997,37,0,37,31340,1.18059987236758
44500,"Stephenville, TX",1998,20,0,20,31269,0.639611116441204
44500,"Stephenville, TX",1999,27,0,27,31375,0.860557768924303
44500,"Stephenville, TX",2000,23,0,23,33057,0.695767916023838
44500,"Stephenville, TX",2001,22,0,22,33045,0.665758813738841
44500,"Stephenville, TX",2002,33,76,109,33619,3.24221422409947
44500,"Stephenville, TX",2003,111,18,129,34131,3.77955524303419
44500,"Stephenville, TX",2004,46,193,239,34887,6.85068936853269
44500,"Stephenville, TX",2005,45,22,67,35336,1.89608331446683
44500,"Stephenville, TX",2006,28,16,44,36355,1.21028744326778
44500,"Stephenville, TX",2007,66,40,106,36678,2.89001581329407
44500,"Stephenville, TX",2008,42,222,264,37137,7.10881331286857
44500,"Stephenville, TX",2009,31,22,53,37594,1.40979943608023
44500,"Stephenville, TX",2010,45,0,45,37917,1.18680275338239
44500,"Stephenville, TX",2011,36,12,48,38927,1.23307729853315
44500,"Stephenville, TX",2012,46,8,54,39414,1.37007154818085
44500,"Stephenville, TX",2013,26,333,359,39899,8.99771924108374
44500,"Stephenville, TX",2014,42,43,85,40532,2.09710845751505
44500,"Stephenville, TX",2015,30,188,218,41195,5.29190435732492
44500,"Stephenville, TX",2016,36,185,221,41376,5.34126063418407
44500,"Stephenville, TX",2017,38,173,211,41862,5.04037074196168
44500,"Stephenville, TX",2018,42,157,199,42446,4.68830985251849
44540,"Sterling, CO",1990,12,0,12,17510,0.685322672758424
44540,"Sterling, CO",1991,10,0,10,17324,0.577233895174325
44540,"Sterling, CO",1992,8,0,8,17303,0.462347569785586
44540,"Sterling, CO",1993,12,0,12,17396,0.689813750287422
44540,"Sterling, CO",1994,36,0,36,17572,2.04871386296381
44540,"Sterling, CO",1995,53,32,85,17847,4.76270521656301
44540,"Sterling, CO",1996,47,54,101,18040,5.59866962305987
44540,"Sterling, CO",1997,60,47,107,18104,5.91029606716748
44540,"Sterling, CO",1998,37,100,137,17918,7.64594262752539
44540,"Sterling, CO",1999,49,6,55,17906,3.07159611303474
44540,"Sterling, CO",2000,69,4,73,20699,3.52674042224262
44540,"Sterling, CO",2001,61,2,63,21459,2.93583111980987
44540,"Sterling, CO",2002,36,2,38,21548,1.7635047336179701
44540,"Sterling, CO",2003,42,12,54,21825,2.47422680412371
44540,"Sterling, CO",2004,46,0,46,21795,2.11057582014223
44540,"Sterling, CO",2005,52,4,56,21694,2.58135890107864
44540,"Sterling, CO",2006,39,3,42,21911,1.91684542010862
44540,"Sterling, CO",2007,20,0,20,22163,0.902404909082705
44540,"Sterling, CO",2008,11,0,11,22128,0.497107736804049
44540,"Sterling, CO",2009,15,0,15,22451,0.668121687229967
44540,"Sterling, CO",2010,13,2,15,22033,0.680796986338674
44540,"Sterling, CO",2011,13,0,13,21869,0.59444876308930406
44540,"Sterling, CO",2012,10,0,10,21661,0.461659203176215
44540,"Sterling, CO",2013,21,0,21,21469,0.97815454841865
44540,"Sterling, CO",2014,19,0,19,21748,0.8736435534302
44540,"Sterling, CO",2015,27,0,27,21771,1.24018189334436
44540,"Sterling, CO",2016,14,0,14,21733,0.644181659227902
44540,"Sterling, CO",2017,11,0,11,21665,0.507731363951073
44540,"Sterling, CO",2018,20,0,20,21528,0.929022668153103
44580,"Sterling, IL",1990,82,12,94,60130,1.56327956095127
44580,"Sterling, IL",1991,86,16,102,60453,1.6872611781053
44580,"Sterling, IL",1992,115,16,131,60499,2.16532504669499
44580,"Sterling, IL",1993,106,50,156,60323,2.5860782786002
44580,"Sterling, IL",1994,133,17,150,60342,2.48583076464154
44580,"Sterling, IL",1995,145,36,181,60282,3.00255465976577
44580,"Sterling, IL",1996,143,38,181,60306,3.0013597320333
44580,"Sterling, IL",1997,134,175,309,60107,5.14083218260768
44580,"Sterling, IL",1998,161,16,177,59868,2.95650430948086
44580,"Sterling, IL",1999,119,58,177,59707,2.96447652704038
44580,"Sterling, IL",2000,126,10,136,60615,2.24366905881383
44580,"Sterling, IL",2001,117,22,139,60511,2.29710300606501
44580,"Sterling, IL",2002,112,24,136,60022,2.2658358601846
44580,"Sterling, IL",2003,90,19,109,59489,1.83227151238044
44580,"Sterling, IL",2004,117,64,181,59352,3.04960237228737
44580,"Sterling, IL",2005,136,30,166,59094,2.80908383253799
44580,"Sterling, IL",2006,90,5,95,59033,1.60926939169617
44580,"Sterling, IL",2007,85,6,91,58819,1.54711912817287
44580,"Sterling, IL",2008,53,0,53,58784,0.901605879150789
44580,"Sterling, IL",2009,47,2,49,58667,0.835222527144732
44580,"Sterling, IL",2010,50,0,50,58478,0.855022401586922
44580,"Sterling, IL",2011,45,0,45,58272,0.772240527182867
44580,"Sterling, IL",2012,42,0,42,57760,0.727146814404432
44580,"Sterling, IL",2013,82,48,130,57462,2.26236469318854
44580,"Sterling, IL",2014,19,0,19,57019,0.333222259246918
44580,"Sterling, IL",2015,27,0,27,56914,0.474399971887409
44580,"Sterling, IL",2016,18,0,18,56472,0.318742031449214
44580,"Sterling, IL",2017,27,40,67,55947,1.19756197830089
44580,"Sterling, IL",2018,28,0,28,55626,0.503361737317082
44620,"Stevens Point, WI",1990,235,135,370,61526,6.01371777785001
44620,"Stevens Point, WI",1991,266,178,444,62339,7.12234716630039
44620,"Stevens Point, WI",1992,382,197,579,62821,9.21666321771382
44620,"Stevens Point, WI",1993,367,177,544,63277,8.59712059674131
44620,"Stevens Point, WI",1994,331,118,449,63700,7.04866562009419
44620,"Stevens Point, WI",1995,313,218,531,64444,8.23971199801378
44620,"Stevens Point, WI",1996,276,131,407,64405,6.31938514090521
44620,"Stevens Point, WI",1997,287,155,442,64450,6.85802948021722
44620,"Stevens Point, WI",1998,316,91,407,64608,6.29952947003467
44620,"Stevens Point, WI",1999,285,88,373,64678,5.76703052042426
44620,"Stevens Point, WI",2000,299,169,468,67250,6.95910780669145
44620,"Stevens Point, WI",2001,286,85,371,67422,5.50265491975913
44620,"Stevens Point, WI",2002,310,322,632,67644,9.34303116314825
44620,"Stevens Point, WI",2003,322,95,417,67728,6.15698086463501
44620,"Stevens Point, WI",2004,314,107,421,67789,6.21044712268952
44620,"Stevens Point, WI",2005,303,74,377,68045,5.54045117201852
44620,"Stevens Point, WI",2006,256,67,323,68481,4.71663673135614
44620,"Stevens Point, WI",2007,226,184,410,69133,5.93059754386472
44620,"Stevens Point, WI",2008,148,337,485,69641,6.96428827845666
44620,"Stevens Point, WI",2009,137,50,187,69876,2.67616921403629
44620,"Stevens Point, WI",2010,123,15,138,70025,1.97072474116387
44620,"Stevens Point, WI",2011,83,48,131,70078,1.86934558634664
44620,"Stevens Point, WI",2012,103,34,137,70414,1.9456358110603
44620,"Stevens Point, WI",2013,114,42,156,70513,2.2123580049069
44620,"Stevens Point, WI",2014,104,18,122,70521,1.72998114036954
44620,"Stevens Point, WI",2015,129,120,249,70497,3.53206519426359
44620,"Stevens Point, WI",2016,138,60,198,70425,2.81150159744409
44620,"Stevens Point, WI",2017,145,84,229,70608,3.24325855427147
44620,"Stevens Point, WI",2018,147,14,161,70942,2.26945955851259
44660,"Stillwater, OK",1990,50,0,50,61454,0.813616688905523
44660,"Stillwater, OK",1991,48,0,48,61579,0.77948651325939
44660,"Stillwater, OK",1992,99,0,99,62487,1.58432954054443
44660,"Stillwater, OK",1993,107,38,145,63245,2.29267135741956
44660,"Stillwater, OK",1994,105,53,158,63393,2.49238874954648
44660,"Stillwater, OK",1995,117,52,169,63882,2.64550264550265
44660,"Stillwater, OK",1996,126,71,197,64061,3.07519395576091
44660,"Stillwater, OK",1997,123,81,204,65025,3.13725490196078
44660,"Stillwater, OK",1998,134,84,218,65355,3.3356284905516
44660,"Stillwater, OK",1999,143,81,224,66351,3.37598529034981
44660,"Stillwater, OK",2000,136,84,220,68350,3.21872713972202
44660,"Stillwater, OK",2001,139,57,196,70132,2.79472993783152
44660,"Stillwater, OK",2002,149,18,167,70708,2.36182610171409
44660,"Stillwater, OK",2003,168,26,194,71879,2.69898023066542
44660,"Stillwater, OK",2004,294,663,957,72244,13.2467748186701
44660,"Stillwater, OK",2005,230,108,338,72578,4.65705861280278
44660,"Stillwater, OK",2006,247,97,344,74964,4.58886932394216
44660,"Stillwater, OK",2007,186,202,388,74164,5.23164877838304
44660,"Stillwater, OK",2008,125,226,351,75000,4.68
44660,"Stillwater, OK",2009,79,14,93,76859,1.2100079366112
44660,"Stillwater, OK",2010,102,6,108,77399,1.39536686520498
44660,"Stillwater, OK",2011,73,218,291,78223,3.72013346458203
44660,"Stillwater, OK",2012,90,163,253,78724,3.2137594634419
44660,"Stillwater, OK",2013,314,429,743,79703,9.3221083271646
44660,"Stillwater, OK",2014,92,211,303,80531,3.76252623213421
44660,"Stillwater, OK",2015,132,368,500,81324,6.14824652009247
44660,"Stillwater, OK",2016,129,229,358,81799,4.37658162080221
44660,"Stillwater, OK",2017,97,335,432,81867,5.27685147861776
44660,"Stillwater, OK",2018,78,51,129,82040,1.57240370550951
44700,"Stockton-Lodi, CA",1990,2958,229,3187,484371,6.57966723854236
44700,"Stockton-Lodi, CA",1991,1912,237,2149,493913,4.35096869286696
44700,"Stockton-Lodi, CA",1992,2508,253,2761,502504,5.49448362600099
44700,"Stockton-Lodi, CA",1993,2572,83,2655,509647,5.20948813590583
44700,"Stockton-Lodi, CA",1994,2248,51,2299,516537,4.45079442518155
44700,"Stockton-Lodi, CA",1995,2178,122,2300,523336,4.39488206429521
44700,"Stockton-Lodi, CA",1996,2117,220,2337,531196,4.39950602037666
44700,"Stockton-Lodi, CA",1997,2229,309,2538,539618,4.70332716847844
44700,"Stockton-Lodi, CA",1998,3275,59,3334,549190,6.07075875380105
44700,"Stockton-Lodi, CA",1999,4189,14,4203,562688,7.46950352593267
44700,"Stockton-Lodi, CA",2000,5350,42,5392,567885,9.4948801253775
44700,"Stockton-Lodi, CA",2001,4005,334,4339,591207,7.33922297943022
44700,"Stockton-Lodi, CA",2002,5654,489,6143,609041,10.0863488664967
44700,"Stockton-Lodi, CA",2003,6935,106,7041,626778,11.2336425337201
44700,"Stockton-Lodi, CA",2004,6229,495,6724,642898,10.458890834938
44700,"Stockton-Lodi, CA",2005,5684,185,5869,656985,8.93323287441875
44700,"Stockton-Lodi, CA",2006,3461,191,3652,662812,5.50985799894993
44700,"Stockton-Lodi, CA",2007,2201,225,2426,668080,3.63130164052209
44700,"Stockton-Lodi, CA",2008,765,54,819,671692,1.21930884988953
44700,"Stockton-Lodi, CA",2009,792,0,792,677736,1.1685966216934
44700,"Stockton-Lodi, CA",2010,801,12,813,687156,1.18313745350401
44700,"Stockton-Lodi, CA",2011,781,152,933,694388,1.3436292101822
44700,"Stockton-Lodi, CA",2012,1006,0,1006,699782,1.43759056391848
44700,"Stockton-Lodi, CA",2013,1062,72,1134,702387,1.61449457350435
44700,"Stockton-Lodi, CA",2014,1245,20,1265,711771,1.77725701103304
44700,"Stockton-Lodi, CA",2015,1708,723,2431,721929,3.36736715106333
44700,"Stockton-Lodi, CA",2016,1862,136,1998,732185,2.72881853629889
44700,"Stockton-Lodi, CA",2017,2107,672,2779,742516,3.74268029241121
44700,"Stockton-Lodi, CA",2018,2920,360,3280,752660,4.35787739483964
44740,"Storm Lake, IA",1990,24,12,36,19965,1.80315552216379
44740,"Storm Lake, IA",1991,18,2,20,19942,1.00290843445993
44740,"Storm Lake, IA",1992,31,2,33,20056,1.64539289988033
44740,"Storm Lake, IA",1993,22,0,22,20223,1.08787024674875
44740,"Storm Lake, IA",1994,19,8,27,20037,1.34750711184309
44740,"Storm Lake, IA",1995,18,52,70,19933,3.5117644107761
44740,"Storm Lake, IA",1996,13,82,95,19833,4.78999647052892
44740,"Storm Lake, IA",1997,23,82,105,19651,5.34323952979492
44740,"Storm Lake, IA",1998,17,12,29,19427,1.49276779739538
44740,"Storm Lake, IA",1999,13,56,69,19521,3.53465498693714
44740,"Storm Lake, IA",2000,20,2,22,20361,1.08049702863317
44740,"Storm Lake, IA",2001,17,0,17,20241,0.839879452596216
44740,"Storm Lake, IA",2002,7,2,9,20233,0.444817871793604
44740,"Storm Lake, IA",2003,9,42,51,20141,2.53214835410357
44740,"Storm Lake, IA",2004,15,10,25,20000,1.25
44740,"Storm Lake, IA",2005,17,0,17,19970,0.85127691537306
44740,"Storm Lake, IA",2006,22,0,22,19909,1.10502787683962
44740,"Storm Lake, IA",2007,24,77,101,19798,5.10152540660673
44740,"Storm Lake, IA",2008,15,3,18,19855,0.906572651725006
44740,"Storm Lake, IA",2009,10,0,10,20004,0.499900019996001
44740,"Storm Lake, IA",2010,8,4,12,20355,0.589535740604274
44740,"Storm Lake, IA",2011,15,0,15,20311,0.738516075033233
44740,"Storm Lake, IA",2012,13,2,15,20564,0.729430071970434
44740,"Storm Lake, IA",2013,56,34,90,20663,4.35561147945603
44740,"Storm Lake, IA",2014,8,0,8,20622,0.387935214819125
44740,"Storm Lake, IA",2015,7,0,7,20381,0.343457141455277
44740,"Storm Lake, IA",2016,5,0,5,20322,0.246038775711052
44740,"Storm Lake, IA",2017,12,0,12,20102,0.596955526813252
44740,"Storm Lake, IA",2018,19,0,19,19874,0.956022944550669
44780,"Sturgis, MI",1990,150,0,150,58913,2.54612734031538
44780,"Sturgis, MI",1991,119,50,169,59074,2.86081863425534
44780,"Sturgis, MI",1992,150,2,152,59286,2.56384306581655
44780,"Sturgis, MI",1993,146,37,183,59645,3.06815324000335
44780,"Sturgis, MI",1994,141,150,291,59958,4.85339737816472
44780,"Sturgis, MI",1995,165,2,167,60468,2.76179136071972
44780,"Sturgis, MI",1996,208,50,258,60893,4.23694020659189
44780,"Sturgis, MI",1997,221,0,221,61117,3.61601518399136
44780,"Sturgis, MI",1998,211,0,211,61182,3.44872674969762
44780,"Sturgis, MI",1999,224,2,226,61528,3.6731244311533
44780,"Sturgis, MI",2000,232,8,240,62480,3.84122919334187
44780,"Sturgis, MI",2001,166,12,178,62404,2.85238125761169
44780,"Sturgis, MI",2002,177,6,183,62152,2.94439438795212
44780,"Sturgis, MI",2003,191,6,197,62363,3.15892436220195
44780,"Sturgis, MI",2004,160,48,208,62265,3.34056050750823
44780,"Sturgis, MI",2005,171,0,171,62273,2.74597337529909
44780,"Sturgis, MI",2006,137,0,137,62236,2.20129828395141
44780,"Sturgis, MI",2007,71,0,71,62243,1.14069051941584
44780,"Sturgis, MI",2008,68,8,76,62083,1.2241676465377
44780,"Sturgis, MI",2009,34,8,42,61417,0.683849748440985
44780,"Sturgis, MI",2010,32,0,32,61283,0.522167648450631
44780,"Sturgis, MI",2011,38,0,38,61057,0.622369261509737
44780,"Sturgis, MI",2012,28,2,30,60983,0.491940376826329
44780,"Sturgis, MI",2013,32,0,32,60985,0.52471919324424
44780,"Sturgis, MI",2014,44,0,44,61009,0.721205068104706
44780,"Sturgis, MI",2015,60,12,72,60805,1.18411314858975
44780,"Sturgis, MI",2016,64,0,64,60809,1.05247578483448
44780,"Sturgis, MI",2017,64,0,64,60819,1.05230273434289
44780,"Sturgis, MI",2018,67,0,67,61043,1.09758694690628
44860,"Sulphur Springs, TX",1990,25,0,25,28805,0.867904877625412
44860,"Sulphur Springs, TX",1991,48,0,48,28966,1.65711523855555
44860,"Sulphur Springs, TX",1992,37,0,37,29067,1.27292118209654
44860,"Sulphur Springs, TX",1993,45,0,45,29119,1.54538273979189
44860,"Sulphur Springs, TX",1994,46,0,46,29444,1.56228773264502
44860,"Sulphur Springs, TX",1995,39,0,39,29692,1.31348511383538
44860,"Sulphur Springs, TX",1996,26,0,26,30040,0.865512649800266
44860,"Sulphur Springs, TX",1997,31,0,31,30124,1.02907980347895
44860,"Sulphur Springs, TX",1998,36,0,36,30325,1.18713932399011
44860,"Sulphur Springs, TX",1999,36,0,36,30590,1.17685518143184
44860,"Sulphur Springs, TX",2000,33,0,33,31999,1.03128222756961
44860,"Sulphur Springs, TX",2001,58,0,58,32203,1.80107443405894
44860,"Sulphur Springs, TX",2002,49,0,49,32335,1.51538580485542
44860,"Sulphur Springs, TX",2003,84,0,84,32625,2.57471264367816
44860,"Sulphur Springs, TX",2004,93,0,93,33061,2.81298206345846
44860,"Sulphur Springs, TX",2005,29,0,29,33330,0.87008700870087
44860,"Sulphur Springs, TX",2006,14,0,14,33746,0.414863983879571
44860,"Sulphur Springs, TX",2007,18,2,20,34331,0.582563863563543
44860,"Sulphur Springs, TX",2008,12,2,14,34472,0.406126711533999
44860,"Sulphur Springs, TX",2009,8,6,14,34919,0.400927861622612
44860,"Sulphur Springs, TX",2010,8,6,14,35206,0.397659489859683
44860,"Sulphur Springs, TX",2011,8,6,14,35253,0.397129322327178
44860,"Sulphur Springs, TX",2012,9,160,169,35310,4.78617955253469
44860,"Sulphur Springs, TX",2013,12,0,12,35303,0.339914454862193
44860,"Sulphur Springs, TX",2014,8,0,8,35696,0.224114746750336
44860,"Sulphur Springs, TX",2015,10,6,16,35990,0.444567935537649
44860,"Sulphur Springs, TX",2016,10,0,10,36212,0.276151551971722
44860,"Sulphur Springs, TX",2017,21,8,29,36493,0.7946729509769
44860,"Sulphur Springs, TX",2018,26,20,46,36810,1.24966041836457
44900,"Summerville, GA",1990,7,0,7,22233,0.314847299059956
44900,"Summerville, GA",1991,36,0,36,22372,1.60915430001788
44900,"Summerville, GA",1992,9,26,35,22380,1.5638963360143
44900,"Summerville, GA",1993,15,70,85,22559,3.76789751318764
44900,"Summerville, GA",1994,7,4,11,22719,0.484176240151415
44900,"Summerville, GA",1995,21,32,53,22824,2.32211706975114
44900,"Summerville, GA",1996,11,0,11,22890,0.480559196155526
44900,"Summerville, GA",1997,12,0,12,22895,0.52413190652981
44900,"Summerville, GA",1998,9,0,9,22767,0.39530899986823
44900,"Summerville, GA",1999,12,0,12,22989,0.521988777241289
44900,"Summerville, GA",2000,9,0,9,25419,0.354065856249262
44900,"Summerville, GA",2001,9,0,9,25675,0.350535540408958
44900,"Summerville, GA",2002,8,0,8,25688,0.311429461227032
44900,"Summerville, GA",2003,7,0,7,25981,0.269427658673646
44900,"Summerville, GA",2004,15,48,63,25537,2.46700865410972
44900,"Summerville, GA",2005,14,48,62,25506,2.43080059593821
44900,"Summerville, GA",2006,9,0,9,25640,0.351014040561622
44900,"Summerville, GA",2007,4,0,4,26230,0.152497140678612
44900,"Summerville, GA",2008,1,2,3,26146,0.114740304444274
44900,"Summerville, GA",2009,0,0,0,25894,0
44900,"Summerville, GA",2010,0,0,0,25952,0
44900,"Summerville, GA",2011,2,0,2,25675,0.0778967867575462
44900,"Summerville, GA",2012,0,0,0,25616,0
44900,"Summerville, GA",2013,0,0,0,25040,0
44900,"Summerville, GA",2014,0,0,0,24857,0
44900,"Summerville, GA",2015,1,0,1,24895,0.0401687085760193
44900,"Summerville, GA",2016,2,0,2,24826,0.0805607024893257
44900,"Summerville, GA",2017,0,0,0,24716,0
44900,"Summerville, GA",2018,5,68,73,24790,2.94473578055668
44920,"Summit Park, UT",1990,326,113,439,15772,27.8341364443317
44920,"Summit Park, UT",1991,345,119,464,17015,27.2700558330884
44920,"Summit Park, UT",1992,543,137,680,18195,37.372904644133
44920,"Summit Park, UT",1993,623,39,662,19913,33.2446140712098
44920,"Summit Park, UT",1994,638,127,765,21570,35.4659248956885
44920,"Summit Park, UT",1995,610,270,880,23269,37.81855687825
44920,"Summit Park, UT",1996,490,521,1011,24502,41.2619378009958
44920,"Summit Park, UT",1997,452,348,800,25666,31.1696407698901
44920,"Summit Park, UT",1998,522,221,743,26816,27.707338902148
44920,"Summit Park, UT",1999,533,461,994,27667,35.9272779846026
44920,"Summit Park, UT",2000,398,141,539,29964,17.9882525697504
44920,"Summit Park, UT",2001,421,238,659,30803,21.3940200629809
44920,"Summit Park, UT",2002,432,4,436,31536,13.8254693049214
44920,"Summit Park, UT",2003,587,41,628,32353,19.4108737984113
44920,"Summit Park, UT",2004,578,121,699,33271,21.009287367377
44920,"Summit Park, UT",2005,685,223,908,34137,26.598705217213
44920,"Summit Park, UT",2006,559,236,795,34242,23.2171018048011
44920,"Summit Park, UT",2007,649,503,1152,34647,33.2496320027708
44920,"Summit Park, UT",2008,203,31,234,35229,6.64225496040194
44920,"Summit Park, UT",2009,120,262,382,35838,10.6590769574195
44920,"Summit Park, UT",2010,87,156,243,36500,6.65753424657534
44920,"Summit Park, UT",2011,100,8,108,37418,2.88631140093003
44920,"Summit Park, UT",2012,115,25,140,37862,3.69763879351328
44920,"Summit Park, UT",2013,167,59,226,38421,5.88219983862992
44920,"Summit Park, UT",2014,193,93,286,39118,7.31121222966409
44920,"Summit Park, UT",2015,175,72,247,39647,6.22997956970263
44920,"Summit Park, UT",2016,217,127,344,40506,8.49256900212314
44920,"Summit Park, UT",2017,193,105,298,41349,7.20694575443179
44920,"Summit Park, UT",2018,255,133,388,41933,9.25285574607111
44940,"Sumter, SC",1990,501,60,561,101462,5.52916362776212
44940,"Sumter, SC",1991,407,78,485,103603,4.68133162167119
44940,"Sumter, SC",1992,388,144,532,104945,5.06932202582305
44940,"Sumter, SC",1993,443,87,530,107836,4.91487072962647
44940,"Sumter, SC",1994,350,18,368,108982,3.37670440990255
44940,"Sumter, SC",1995,309,47,356,110131,3.23251400604734
44940,"Sumter, SC",1996,379,10,389,111057,3.50270581773324
44940,"Sumter, SC",1997,319,34,353,111412,3.16841991885973
44940,"Sumter, SC",1998,337,145,482,112251,4.29394838353333
44940,"Sumter, SC",1999,259,12,271,112418,2.41064598196018
44940,"Sumter, SC",2000,294,0,294,104802,2.80528997538215
44940,"Sumter, SC",2001,293,65,358,104629,3.42161351059458
44940,"Sumter, SC",2002,330,74,404,105380,3.83374454355665
44940,"Sumter, SC",2003,493,160,653,105112,6.21242103660857
44940,"Sumter, SC",2004,572,102,674,106099,6.35255751703598
44940,"Sumter, SC",2005,571,56,627,106082,5.91052204898098
44940,"Sumter, SC",2006,760,8,768,105953,7.24849697507385
44940,"Sumter, SC",2007,568,348,916,106014,8.64036825324957
44940,"Sumter, SC",2008,296,3,299,106463,2.8084874557358
44940,"Sumter, SC",2009,385,32,417,107004,3.8970505775485
44940,"Sumter, SC",2010,289,64,353,107612,3.2803033118983
44940,"Sumter, SC",2011,345,0,345,107298,3.21534418162501
44940,"Sumter, SC",2012,251,48,299,107774,2.7743240484718
44940,"Sumter, SC",2013,299,284,583,107732,5.41157687595144
44940,"Sumter, SC",2014,269,20,289,107653,2.6845512897922
44940,"Sumter, SC",2015,217,0,217,107173,2.02476369981245
44940,"Sumter, SC",2016,243,30,273,107125,2.54842473745624
44940,"Sumter, SC",2017,222,0,222,106514,2.08423305856507
44940,"Sumter, SC",2018,279,0,279,106512,2.6194231635872
44980,"Sunbury, PA",1990,170,2,172,96742,1.77792478964669
44980,"Sunbury, PA",1991,177,42,219,96575,2.26766761584261
44980,"Sunbury, PA",1992,227,0,227,96011,2.36431242253492
44980,"Sunbury, PA",1993,258,4,262,95902,2.73195553794499
44980,"Sunbury, PA",1994,260,19,279,95571,2.91929560222243
44980,"Sunbury, PA",1995,181,0,181,95537,1.89455394245162
44980,"Sunbury, PA",1996,191,18,209,94996,2.20009263547939
44980,"Sunbury, PA",1997,153,10,163,94241,1.72960813234155
44980,"Sunbury, PA",1998,171,13,184,93085,1.97668797335768
44980,"Sunbury, PA",1999,173,5,178,92318,1.92811802682034
44980,"Sunbury, PA",2000,163,6,169,94823,1.78226801514401
44980,"Sunbury, PA",2001,192,0,192,94176,2.03873598369011
44980,"Sunbury, PA",2002,204,4,208,94024,2.21220114013443
44980,"Sunbury, PA",2003,233,28,261,93910,2.77925673517197
44980,"Sunbury, PA",2004,210,44,254,93692,2.71101054519063
44980,"Sunbury, PA",2005,164,0,164,93543,1.75320440866767
44980,"Sunbury, PA",2006,162,4,166,93475,1.77587590264777
44980,"Sunbury, PA",2007,128,0,128,93728,1.36565380675999
44980,"Sunbury, PA",2008,143,2,145,94150,1.5400955921402
44980,"Sunbury, PA",2009,118,2,120,94774,1.26617004663726
44980,"Sunbury, PA",2010,122,2,124,94301,1.31493833575466
44980,"Sunbury, PA",2011,53,2,55,94395,0.582657979765877
44980,"Sunbury, PA",2012,58,0,58,94419,0.614283142164183
44980,"Sunbury, PA",2013,80,6,86,93896,0.915906960892903
44980,"Sunbury, PA",2014,66,2,68,93609,0.726425877853625
44980,"Sunbury, PA",2015,47,4,51,92890,0.549036494778771
44980,"Sunbury, PA",2016,55,0,55,92275,0.596044432403143
44980,"Sunbury, PA",2017,51,15,66,91767,0.719212788911046
44980,"Sunbury, PA",2018,167,0,167,91083,1.83349252879242
45000,"Susanville, CA",1990,142,34,176,27654,6.36435958631663
45000,"Susanville, CA",1991,138,0,138,27940,4.93915533285612
45000,"Susanville, CA",1992,91,0,91,28490,3.19410319410319
45000,"Susanville, CA",1993,46,0,46,28611,1.60777323407081
45000,"Susanville, CA",1994,67,18,85,28333,3.00003529453288
45000,"Susanville, CA",1995,92,80,172,28562,6.02198725579441
45000,"Susanville, CA",1996,72,4,76,31528,2.41055569652372
45000,"Susanville, CA",1997,70,10,80,33695,2.3742395014097
45000,"Susanville, CA",1998,91,0,91,33545,2.71277388582501
45000,"Susanville, CA",1999,136,2,138,33299,4.14426859665455
45000,"Susanville, CA",2000,102,4,106,33719,3.14362822147751
45000,"Susanville, CA",2001,128,3,131,33548,3.90485274830094
45000,"Susanville, CA",2002,124,0,124,33430,3.70924319473527
45000,"Susanville, CA",2003,140,0,140,33930,4.12614205717654
45000,"Susanville, CA",2004,160,0,160,34458,4.64333391375007
45000,"Susanville, CA",2005,147,9,156,34488,4.52331245650661
45000,"Susanville, CA",2006,132,0,132,34605,3.81447767663632
45000,"Susanville, CA",2007,59,0,59,35615,1.65660536290889
45000,"Susanville, CA",2008,31,16,47,35221,1.33443116322648
45000,"Susanville, CA",2009,18,0,18,35160,0.511945392491468
45000,"Susanville, CA",2010,13,0,13,34832,0.373220027560864
45000,"Susanville, CA",2011,21,0,21,34238,0.613353583737368
45000,"Susanville, CA",2012,9,3,12,33624,0.356887937187723
45000,"Susanville, CA",2013,4,3,7,32126,0.217892050052917
45000,"Susanville, CA",2014,6,0,6,31710,0.189214758751183
45000,"Susanville, CA",2015,7,0,7,31383,0.223050696236816
45000,"Susanville, CA",2016,13,0,13,30906,0.42063029832395
45000,"Susanville, CA",2017,12,0,12,31123,0.385566944060662
45000,"Susanville, CA",2018,7,0,7,30802,0.227257970261671
45020,"Sweetwater, TX",1990,9,0,9,16539,0.544168329403229
45020,"Sweetwater, TX",1991,6,0,6,16362,0.366703337000367
45020,"Sweetwater, TX",1992,2,0,2,16175,0.123647604327666
45020,"Sweetwater, TX",1993,8,0,8,16152,0.495294700346706
45020,"Sweetwater, TX",1994,13,0,13,16329,0.796129585400208
45020,"Sweetwater, TX",1995,10,30,40,16344,2.44738130200685
45020,"Sweetwater, TX",1996,3,0,3,16397,0.182960297615417
45020,"Sweetwater, TX",1997,6,0,6,16409,0.365652995307453
45020,"Sweetwater, TX",1998,5,0,5,16403,0.304822288605743
45020,"Sweetwater, TX",1999,6,0,6,16236,0.369549150036955
45020,"Sweetwater, TX",2000,2,0,2,15947,0.125415438640497
45020,"Sweetwater, TX",2001,5,0,5,15503,0.322518222279559
45020,"Sweetwater, TX",2002,4,0,4,15194,0.263261813873898
45020,"Sweetwater, TX",2003,2,0,2,15148,0.132030631106417
45020,"Sweetwater, TX",2004,3,0,3,15013,0.199826816758809
45020,"Sweetwater, TX",2005,4,0,4,14745,0.271278399457443
45020,"Sweetwater, TX",2006,1,0,1,14740,0.067842605156038
45020,"Sweetwater, TX",2007,0,0,0,14750,0
45020,"Sweetwater, TX",2008,3,0,3,15093,0.198767640628106
45020,"Sweetwater, TX",2009,1,0,1,15128,0.0661025912215759
45020,"Sweetwater, TX",2010,1,0,1,15247,0.0655866727880895
45020,"Sweetwater, TX",2011,0,0,0,15145,0
45020,"Sweetwater, TX",2012,1,0,1,14937,0.0669478476266988
45020,"Sweetwater, TX",2013,1,0,1,15072,0.066348195329087
45020,"Sweetwater, TX",2014,0,0,0,15128,0
45020,"Sweetwater, TX",2015,0,0,0,15100,0
45020,"Sweetwater, TX",2016,1,0,1,15015,0.066600066600066593
45020,"Sweetwater, TX",2017,4,0,4,14837,0.269596279571342
45020,"Sweetwater, TX",2018,9,0,9,14751,0.61012812690665
45060,"Syracuse, NY",1990,1772,253,2025,661538,3.06104864724324
45060,"Syracuse, NY",1991,1530,456,1986,665783,2.98295390540161
45060,"Syracuse, NY",1992,1816,233,2049,668784,3.06376946816909
45060,"Syracuse, NY",1993,1515,422,1937,670747,2.88782506667939
45060,"Syracuse, NY",1994,1386,285,1671,668081,2.50119371752826
45060,"Syracuse, NY",1995,984,102,1086,665117,1.63279543298397
45060,"Syracuse, NY",1996,1029,273,1302,661266,1.96895046773915
45060,"Syracuse, NY",1997,914,86,1000,656270,1.5237630853155
45060,"Syracuse, NY",1998,1118,156,1274,652696,1.95190410236925
45060,"Syracuse, NY",1999,1270,80,1350,651667,2.07161019354977
45060,"Syracuse, NY",2000,1282,309,1591,649961,2.44783917804299
45060,"Syracuse, NY",2001,1347,237,1584,650697,2.43431274464152
45060,"Syracuse, NY",2002,1582,339,1921,652241,2.94523036730288
45060,"Syracuse, NY",2003,1545,158,1703,655091,2.59963882880394
45060,"Syracuse, NY",2004,1469,164,1633,656149,2.4887639850095
45060,"Syracuse, NY",2005,1445,201,1646,655021,2.51289653308825
45060,"Syracuse, NY",2006,1383,291,1674,655321,2.55447330392281
45060,"Syracuse, NY",2007,1220,200,1420,656209,2.16394471883196
45060,"Syracuse, NY",2008,917,214,1131,658913,1.71646332672143
45060,"Syracuse, NY",2009,784,249,1033,660857,1.56312182514523
45060,"Syracuse, NY",2010,826,313,1139,663108,1.71766891667722
45060,"Syracuse, NY",2011,697,523,1220,662417,1.84174017273107
45060,"Syracuse, NY",2012,771,728,1499,660897,2.26812952699135
45060,"Syracuse, NY",2013,710,336,1046,661807,1.5805212093556
45060,"Syracuse, NY",2014,652,511,1163,660134,1.76176352073973
45060,"Syracuse, NY",2015,615,579,1194,657633,1.81560231922668
45060,"Syracuse, NY",2016,634,736,1370,654205,2.09414480170589
45060,"Syracuse, NY",2017,557,602,1159,651048,1.7802066821494
45060,"Syracuse, NY",2018,570,168,738,650502,1.13450842580038
45140,"Tahlequah, OK",1990,18,12,30,34117,0.879327021719377
45140,"Tahlequah, OK",1991,27,20,47,34800,1.35057471264368
45140,"Tahlequah, OK",1992,39,0,39,35514,1.09815847271499
45140,"Tahlequah, OK",1993,32,20,52,35820,1.45170295924065
45140,"Tahlequah, OK",1994,55,15,70,36266,1.93018254012022
45140,"Tahlequah, OK",1995,27,26,53,37084,1.42918778988243
45140,"Tahlequah, OK",1996,24,2,26,37693,0.689783248879102
45140,"Tahlequah, OK",1997,20,4,24,38449,0.62420349033785
45140,"Tahlequah, OK",1998,22,8,30,39057,0.768108149627468
45140,"Tahlequah, OK",1999,22,0,22,39579,0.555850324667121
45140,"Tahlequah, OK",2000,6,152,158,42635,3.70587545443884
45140,"Tahlequah, OK",2001,31,25,56,43066,1.30032972646635
45140,"Tahlequah, OK",2002,75,93,168,43625,3.85100286532951
45140,"Tahlequah, OK",2003,66,161,227,44066,5.15136386329596
45140,"Tahlequah, OK",2004,40,91,131,44437,2.94799378895965
45140,"Tahlequah, OK",2005,40,68,108,44805,2.41044526280549
45140,"Tahlequah, OK",2006,65,6,71,45517,1.55985675681613
45140,"Tahlequah, OK",2007,82,110,192,45546,4.21551837702542
45140,"Tahlequah, OK",2008,29,10,39,46217,0.843845338295432
45140,"Tahlequah, OK",2009,22,28,50,46492,1.07545384152112
45140,"Tahlequah, OK",2010,21,17,38,47106,0.80669129197979
45140,"Tahlequah, OK",2011,51,84,135,47679,2.83143522305417
45140,"Tahlequah, OK",2012,31,4,35,47972,0.72959226215292206
45140,"Tahlequah, OK",2013,41,25,66,47858,1.37907977767562
45140,"Tahlequah, OK",2014,44,19,63,48237,1.30605137135394
45140,"Tahlequah, OK",2015,46,14,60,48373,1.24036135860914
45140,"Tahlequah, OK",2016,52,29,81,48787,1.6602783528399
45140,"Tahlequah, OK",2017,59,25,84,48925,1.71691364333163
45140,"Tahlequah, OK",2018,65,38,103,48675,2.1160760143811
45180,"Talladega-Sylacauga, AL",1990,57,0,57,85182,0.669155455377897
45180,"Talladega-Sylacauga, AL",1991,43,12,55,85562,0.64280872349875
45180,"Talladega-Sylacauga, AL",1992,60,30,90,85998,1.0465359659527
45180,"Talladega-Sylacauga, AL",1993,85,40,125,86751,1.44090558033913
45180,"Talladega-Sylacauga, AL",1994,65,16,81,87321,0.927611914659704
45180,"Talladega-Sylacauga, AL",1995,51,54,105,87762,1.19641758392015
45180,"Talladega-Sylacauga, AL",1996,65,0,65,87971,0.738879858135067
45180,"Talladega-Sylacauga, AL",1997,58,0,58,88238,0.657313175729278
45180,"Talladega-Sylacauga, AL",1998,54,28,82,88615,0.925351238503639
45180,"Talladega-Sylacauga, AL",1999,79,0,79,89281,0.884846719906811
45180,"Talladega-Sylacauga, AL",2000,77,24,101,92616,1.09052431545305
45180,"Talladega-Sylacauga, AL",2001,73,36,109,92787,1.1747335294815
45180,"Talladega-Sylacauga, AL",2002,75,88,163,92835,1.75580330694242
45180,"Talladega-Sylacauga, AL",2003,79,26,105,92632,1.13351757492011
45180,"Talladega-Sylacauga, AL",2004,117,27,144,92699,1.5534148156938
45180,"Talladega-Sylacauga, AL",2005,186,44,230,93013,2.47277262318171
45180,"Talladega-Sylacauga, AL",2006,219,110,329,93442,3.52090066565356
45180,"Talladega-Sylacauga, AL",2007,217,28,245,93665,2.61570490578124
45180,"Talladega-Sylacauga, AL",2008,215,144,359,94228,3.80990788300717
45180,"Talladega-Sylacauga, AL",2009,42,26,68,94084,0.722758386123039
45180,"Talladega-Sylacauga, AL",2010,29,87,116,93882,1.23559361751987
45180,"Talladega-Sylacauga, AL",2011,24,84,108,93264,1.15800308800823
45180,"Talladega-Sylacauga, AL",2012,23,28,51,93425,0.545892427080546
45180,"Talladega-Sylacauga, AL",2013,25,43,68,92769,0.733003481766538
45180,"Talladega-Sylacauga, AL",2014,21,44,65,92488,0.702793875962287
45180,"Talladega-Sylacauga, AL",2015,24,0,24,91993,0.260889415499005
45180,"Talladega-Sylacauga, AL",2016,30,42,72,91294,0.78866081012991
45180,"Talladega-Sylacauga, AL",2017,35,0,35,90779,0.385551724517785
45180,"Talladega-Sylacauga, AL",2018,43,0,43,90543,0.474912472526866
45220,"Tallahassee, FL",1990,2059,1089,3148,260646,12.0776839084429
45220,"Tallahassee, FL",1991,1655,326,1981,268681,7.37305577990256
45220,"Tallahassee, FL",1992,1957,82,2039,270853,7.52806873100907
45220,"Tallahassee, FL",1993,1950,493,2443,276734,8.82797198754038
45220,"Tallahassee, FL",1994,1967,488,2455,282380,8.69395849564417
45220,"Tallahassee, FL",1995,1916,1159,3075,285576,10.767711572401
45220,"Tallahassee, FL",1996,1795,380,2175,287310,7.57022031951551
45220,"Tallahassee, FL",1997,1176,815,1991,289990,6.86575399151695
45220,"Tallahassee, FL",1998,1355,549,1904,291490,6.53195649936533
45220,"Tallahassee, FL",1999,1914,766,2680,292801,9.15297420432307
45220,"Tallahassee, FL",2000,1888,856,2744,321336,8.53934822117659
45220,"Tallahassee, FL",2001,1814,746,2560,324386,7.89183256983963
45220,"Tallahassee, FL",2002,2106,1214,3320,327940,10.1238031347198
45220,"Tallahassee, FL",2003,2416,1110,3526,334289,10.5477595733033
45220,"Tallahassee, FL",2004,2216,1511,3727,339179,10.9882982142173
45220,"Tallahassee, FL",2005,2833,1450,4283,344257,12.4412865969319
45220,"Tallahassee, FL",2006,2430,588,3018,350580,8.608591476981
45220,"Tallahassee, FL",2007,2120,779,2899,357357,8.11233584342828
45220,"Tallahassee, FL",2008,894,277,1171,361238,3.24163017179809
45220,"Tallahassee, FL",2009,595,300,895,364690,2.45413913186542
45220,"Tallahassee, FL",2010,577,48,625,369341,1.69220314018752
45220,"Tallahassee, FL",2011,575,464,1039,371196,2.79906033470188
45220,"Tallahassee, FL",2012,468,766,1234,375258,3.28840424454642
45220,"Tallahassee, FL",2013,628,652,1280,373189,3.42989745142542
45220,"Tallahassee, FL",2014,628,632,1260,375366,3.35672383753457
45220,"Tallahassee, FL",2015,737,159,896,377671,2.37243526773303
45220,"Tallahassee, FL",2016,810,803,1613,378859,4.25752060793066
45220,"Tallahassee, FL",2017,1897,1156,3053,383467,7.96157166066441
45220,"Tallahassee, FL",2018,2073,1128,3201,385145,8.31115553882304
45300,"Tampa-St. Petersburg-Clearwater, FL",1990,7850,5255,13105,2075576,6.31390997005169
45300,"Tampa-St. Petersburg-Clearwater, FL",1991,7841,3296,11137,2099409,5.30482626301021
45300,"Tampa-St. Petersburg-Clearwater, FL",1992,9721,1291,11012,2114182,5.20863388298642
45300,"Tampa-St. Petersburg-Clearwater, FL",1993,10331,2132,12463,2133270,5.84220469045175
45300,"Tampa-St. Petersburg-Clearwater, FL",1994,11003,3740,14743,2153849,6.84495524059486
45300,"Tampa-St. Petersburg-Clearwater, FL",1995,9405,4214,13619,2175534,6.26007223973516
45300,"Tampa-St. Petersburg-Clearwater, FL",1996,10006,4674,14680,2195743,6.68566403263041
45300,"Tampa-St. Petersburg-Clearwater, FL",1997,10745,6241,16986,2225805,7.6313962813454
45300,"Tampa-St. Petersburg-Clearwater, FL",1998,11573,7286,18859,2254406,8.36539647250761
45300,"Tampa-St. Petersburg-Clearwater, FL",1999,13309,9671,22980,2275713,10.097934141959
45300,"Tampa-St. Petersburg-Clearwater, FL",2000,13293,5951,19244,2404013,8.00494839254197
45300,"Tampa-St. Petersburg-Clearwater, FL",2001,15826,5988,21814,2444015,8.9254771349603
45300,"Tampa-St. Petersburg-Clearwater, FL",2002,17546,5996,23542,2487445,9.46432986457992
45300,"Tampa-St. Petersburg-Clearwater, FL",2003,20178,9103,29281,2529652,11.5751099360703
45300,"Tampa-St. Petersburg-Clearwater, FL",2004,23081,6476,29557,2587771,11.4217989149735
45300,"Tampa-St. Petersburg-Clearwater, FL",2005,27643,6531,34174,2651580,12.8881647923125
45300,"Tampa-St. Petersburg-Clearwater, FL",2006,18294,4346,22640,2699935,8.3853870556143
45300,"Tampa-St. Petersburg-Clearwater, FL",2007,8054,4195,12249,2726780,4.49211157482452
45300,"Tampa-St. Petersburg-Clearwater, FL",2008,5093,4520,9613,2746981,3.49947815438112
45300,"Tampa-St. Petersburg-Clearwater, FL",2009,3923,3039,6962,2763937,2.51887072679298
45300,"Tampa-St. Petersburg-Clearwater, FL",2010,4396,2105,6501,2788367,2.33147214839367
45300,"Tampa-St. Petersburg-Clearwater, FL",2011,4511,1831,6342,2828748,2.24198125813964
45300,"Tampa-St. Petersburg-Clearwater, FL",2012,5883,4278,10161,2845719,3.57062661492579
45300,"Tampa-St. Petersburg-Clearwater, FL",2013,7314,4838,12152,2870355,4.23362267036656
45300,"Tampa-St. Petersburg-Clearwater, FL",2014,7267,5119,12386,2912875,4.2521563747157
45300,"Tampa-St. Petersburg-Clearwater, FL",2015,9739,5914,15653,2969251,5.27169983271876
45300,"Tampa-St. Petersburg-Clearwater, FL",2016,10685,7067,17752,3034215,5.85060715868849
45300,"Tampa-St. Petersburg-Clearwater, FL",2017,12732,5536,18268,3091225,5.90963129503676
45300,"Tampa-St. Petersburg-Clearwater, FL",2018,14228,3224,17452,3142663,5.55325213043842
45340,"Taos, NM",1990,68,8,76,23182,3.27840565956345
45340,"Taos, NM",1991,66,0,66,23642,2.79164199306319
45340,"Taos, NM",1992,93,0,93,24116,3.85636092220932
45340,"Taos, NM",1993,78,4,82,24556,3.33930607590813
45340,"Taos, NM",1994,59,22,81,24916,3.25092310162145
45340,"Taos, NM",1995,62,0,62,25418,2.43921630340703
45340,"Taos, NM",1996,59,0,59,25901,2.27790432801822
45340,"Taos, NM",1997,51,0,51,26535,1.92198982475975
45340,"Taos, NM",1998,61,0,61,26765,2.27909583411171
45340,"Taos, NM",1999,66,0,66,27124,2.43326942928772
45340,"Taos, NM",2000,234,0,234,30080,7.77925531914894
45340,"Taos, NM",2001,152,0,152,30236,5.02711998941659
45340,"Taos, NM",2002,186,0,186,30844,6.03034625859162
45340,"Taos, NM",2003,207,0,207,31307,6.6119398217651
45340,"Taos, NM",2004,264,8,272,31675,8.58721389108129
45340,"Taos, NM",2005,308,0,308,31850,9.67032967032967
45340,"Taos, NM",2006,262,56,318,32170,9.88498601181225
45340,"Taos, NM",2007,191,7,198,32485,6.09512082499615
45340,"Taos, NM",2008,112,0,112,32467,3.44965657436782
45340,"Taos, NM",2009,72,0,72,32792,2.19565747743352
45340,"Taos, NM",2010,60,0,60,32896,1.82392996108949
45340,"Taos, NM",2011,56,0,56,32891,1.7025934146119
45340,"Taos, NM",2012,62,0,62,32766,1.89220533479827
45340,"Taos, NM",2013,102,0,102,32962,3.09447242278988
45340,"Taos, NM",2014,74,6,80,32971,2.42637469291195
45340,"Taos, NM",2015,74,0,74,32814,2.25513500335223
45340,"Taos, NM",2016,78,0,78,32960,2.36650485436893
45340,"Taos, NM",2017,92,0,92,32862,2.79958614813462
45340,"Taos, NM",2018,111,0,111,32835,3.38053905893102
45380,"Taylorville, IL",1990,44,0,44,34455,1.27702800754607
45380,"Taylorville, IL",1991,68,10,78,35080,2.22348916761688
45380,"Taylorville, IL",1992,76,14,90,35394,2.54280386506188
45380,"Taylorville, IL",1993,78,10,88,35500,2.47887323943662
45380,"Taylorville, IL",1994,103,48,151,35640,4.2368125701459
45380,"Taylorville, IL",1995,94,54,148,35883,4.12451578742023
45380,"Taylorville, IL",1996,77,30,107,35875,2.98257839721254
45380,"Taylorville, IL",1997,68,27,95,35845,2.65029990235737
45380,"Taylorville, IL",1998,78,23,101,35802,2.82107144852243
45380,"Taylorville, IL",1999,87,24,111,35710,3.10837300476057
45380,"Taylorville, IL",2000,86,13,99,35383,2.7979538196309
45380,"Taylorville, IL",2001,81,15,96,35240,2.72417707150965
45380,"Taylorville, IL",2002,104,14,118,35181,3.35408316989284
45380,"Taylorville, IL",2003,99,19,118,35172,3.3549414306835
45380,"Taylorville, IL",2004,77,2,79,35308,2.2374532683811
45380,"Taylorville, IL",2005,75,0,75,35165,2.13280250248827
45380,"Taylorville, IL",2006,65,0,65,35076,1.85311894172654
45380,"Taylorville, IL",2007,48,0,48,35034,1.37009761945539
45380,"Taylorville, IL",2008,43,0,43,34974,1.22948476010751
45380,"Taylorville, IL",2009,37,0,37,34808,1.06297402895886
45380,"Taylorville, IL",2010,35,0,35,34764,1.00678863191808
45380,"Taylorville, IL",2011,34,0,34,34699,0.97985532724286
45380,"Taylorville, IL",2012,36,0,36,34516,1.04299455325067
45380,"Taylorville, IL",2013,46,0,46,34147,1.34711687703166
45380,"Taylorville, IL",2014,29,0,29,33810,0.857734398107069
45380,"Taylorville, IL",2015,27,0,27,33457,0.807006007711391
45380,"Taylorville, IL",2016,22,0,22,33214,0.662371289215391
45380,"Taylorville, IL",2017,25,0,25,33011,0.757323316470267
45380,"Taylorville, IL",2018,25,0,25,32661,0.765438902666789
45460,"Terre Haute, IN",1990,219,236,455,166571,2.73156791998607
45460,"Terre Haute, IN",1991,228,54,282,166764,1.69101244872994
45460,"Terre Haute, IN",1992,411,50,461,167801,2.7473018635169
45460,"Terre Haute, IN",1993,536,150,686,169104,4.05667518213644
45460,"Terre Haute, IN",1994,434,47,481,169363,2.84005361265448
45460,"Terre Haute, IN",1995,344,59,403,170170,2.36822001527884
45460,"Terre Haute, IN",1996,391,164,555,170787,3.24966185950921
45460,"Terre Haute, IN",1997,400,56,456,170637,2.67233952776948
45460,"Terre Haute, IN",1998,529,18,547,170083,3.21607685659355
45460,"Terre Haute, IN",1999,464,76,540,169951,3.17738642314549
45460,"Terre Haute, IN",2000,400,36,436,170855,2.55187146995991
45460,"Terre Haute, IN",2001,434,96,530,170497,3.10855909488143
45460,"Terre Haute, IN",2002,382,17,399,170055,2.34629972655905
45460,"Terre Haute, IN",2003,296,63,359,170438,2.10633778852134
45460,"Terre Haute, IN",2004,316,273,589,170001,3.46468550184999
45460,"Terre Haute, IN",2005,314,189,503,170634,2.94782985805877
45460,"Terre Haute, IN",2006,286,181,467,171730,2.71938508123217
45460,"Terre Haute, IN",2007,284,209,493,171987,2.86649572351399
45460,"Terre Haute, IN",2008,127,78,205,171967,1.19208917990079
45460,"Terre Haute, IN",2009,124,6,130,172190,0.754979963993263
45460,"Terre Haute, IN",2010,161,28,189,172239,1.09731245536725
45460,"Terre Haute, IN",2011,114,309,423,172459,2.45275688714419
45460,"Terre Haute, IN",2012,95,145,240,172477,1.39148987981006
45460,"Terre Haute, IN",2013,105,164,269,171890,1.56495433125836
45460,"Terre Haute, IN",2014,75,263,338,171035,1.97620370099687
45460,"Terre Haute, IN",2015,79,136,215,170438,1.26145577864091
45460,"Terre Haute, IN",2016,70,344,414,170346,2.43034764538058
45460,"Terre Haute, IN",2017,48,227,275,170022,1.61743774335086
45460,"Terre Haute, IN",2018,85,45,130,169725,0.765944910885256
45500,"Texarkana, TX-AR",1990,166,36,202,134316,1.50391613806248
45500,"Texarkana, TX-AR",1991,177,0,177,134345,1.31750344262905
45500,"Texarkana, TX-AR",1992,241,4,245,134521,1.82127697534214
45500,"Texarkana, TX-AR",1993,250,4,254,135208,1.87858706585409
45500,"Texarkana, TX-AR",1994,258,8,266,135853,1.95799871920385
45500,"Texarkana, TX-AR",1995,214,16,230,135949,1.69181089967561
45500,"Texarkana, TX-AR",1996,233,428,661,136663,4.83671513138157
45500,"Texarkana, TX-AR",1997,179,10,189,136459,1.38503140137331
45500,"Texarkana, TX-AR",1998,164,6,170,136138,1.24873290337746
45500,"Texarkana, TX-AR",1999,220,152,372,136096,2.73336468375265
45500,"Texarkana, TX-AR",2000,265,156,421,143205,2.93984148598163
45500,"Texarkana, TX-AR",2001,229,22,251,142882,1.75669433518568
45500,"Texarkana, TX-AR",2002,250,164,414,143149,2.89209145715304
45500,"Texarkana, TX-AR",2003,289,375,664,143582,4.62453510885766
45500,"Texarkana, TX-AR",2004,254,80,334,143996,2.31950887524653
45500,"Texarkana, TX-AR",2005,236,28,264,144534,1.82655984059114
45500,"Texarkana, TX-AR",2006,210,27,237,146051,1.62272083039486
45500,"Texarkana, TX-AR",2007,238,206,444,146273,3.03542007068974
45500,"Texarkana, TX-AR",2008,129,30,159,147495,1.07800264415743
45500,"Texarkana, TX-AR",2009,219,84,303,148743,2.0370706520643
45500,"Texarkana, TX-AR",2010,101,139,240,149327,1.60721102011023
45500,"Texarkana, TX-AR",2011,90,280,370,149622,2.47289837056048
45500,"Texarkana, TX-AR",2012,113,109,222,149705,1.48291640225777
45500,"Texarkana, TX-AR",2013,95,34,129,149687,0.861798285756278
45500,"Texarkana, TX-AR",2014,129,4,133,149592,0.8890849778063
45500,"Texarkana, TX-AR",2015,69,264,333,149827,2.22256335640439
45500,"Texarkana, TX-AR",2016,121,8,129,150257,0.858529053554909
45500,"Texarkana, TX-AR",2017,85,100,185,150254,1.23124841934325
45500,"Texarkana, TX-AR",2018,83,108,191,150242,1.27128233117238
45520,"The Dalles, OR",1990,22,0,22,21773,1.01042575667111
45520,"The Dalles, OR",1991,39,2,41,22144,1.85151734104046
45520,"The Dalles, OR",1992,32,0,32,22345,1.43208771537257
45520,"The Dalles, OR",1993,42,0,42,22335,1.88045668233714
45520,"The Dalles, OR",1994,39,6,45,22680,1.98412698412698
45520,"The Dalles, OR",1995,46,20,66,22845,2.88903479973736
45520,"The Dalles, OR",1996,35,48,83,22971,3.6132514910104
45520,"The Dalles, OR",1997,28,2,30,23121,1.29752173348904
45520,"The Dalles, OR",1998,40,0,40,23117,1.73032832980058
45520,"The Dalles, OR",1999,33,0,33,23367,1.41224804211067
45520,"The Dalles, OR",2000,27,4,31,23837,1.30049922389562
45520,"The Dalles, OR",2001,27,0,27,23808,1.13407258064516
45520,"The Dalles, OR",2002,23,0,23,23699,0.970505084602726
45520,"The Dalles, OR",2003,17,0,17,23885,0.711743772241993
45520,"The Dalles, OR",2004,4,0,4,23817,0.167947264558928
45520,"The Dalles, OR",2005,0,0,0,23929,0
45540,"The Villages, FL",1990,151,5,156,31730,4.91648282382603
45540,"The Villages, FL",1991,149,93,242,32087,7.54199520054851
45540,"The Villages, FL",1992,143,0,143,32381,4.41616997622062
45540,"The Villages, FL",1993,497,0,497,32670,15.2127333945516
45540,"The Villages, FL",1994,703,0,703,33329,21.0927420564673
45540,"The Villages, FL",1995,858,0,858,34771,24.675735526732
45540,"The Villages, FL",1996,881,4,885,38045,23.2619266657905
45540,"The Villages, FL",1997,1301,4,1305,40582,32.1571139914248
45540,"The Villages, FL",1998,1299,28,1327,41656,31.856155175725
45540,"The Villages, FL",1999,1574,2,1576,43348,36.3569253483436
45540,"The Villages, FL",2000,1907,2,1909,53738,35.5242100561986
45540,"The Villages, FL",2001,1672,6,1678,55793,30.0754574946678
45540,"The Villages, FL",2002,508,2,510,59539,8.56581400426611
45540,"The Villages, FL",2003,2206,74,2280,61934,36.8133819872768
45540,"The Villages, FL",2004,4153,0,4153,64456,64.4315502047909
45540,"The Villages, FL",2005,5039,8,5047,69261,72.8692915204805
45540,"The Villages, FL",2006,3558,18,3576,76202,46.9279021547991
45540,"The Villages, FL",2007,2406,14,2420,82101,29.4758894532344
45540,"The Villages, FL",2008,2414,296,2710,86433,31.3537653442551
45540,"The Villages, FL",2009,2123,130,2253,90643,24.8557527884117
45540,"The Villages, FL",2010,2420,0,2420,94278,25.6687668384989
45540,"The Villages, FL",2011,2653,2,2655,97972,27.0995794716858
45540,"The Villages, FL",2012,3192,7,3199,101674,31.4633042862482
45540,"The Villages, FL",2013,3857,0,3857,106908,36.0777490926778
45540,"The Villages, FL",2014,2570,0,2570,112245,22.8963428215065
45540,"The Villages, FL",2015,1568,0,1568,117070,13.3936960792688
45540,"The Villages, FL",2016,1068,4,1072,121995,8.78724537890897
45540,"The Villages, FL",2017,1814,0,1814,124933,14.5197826034755
45540,"The Villages, FL",2018,2076,0,2076,128754,16.1237709119717
45580,"Thomaston, GA",1990,184,9,193,26318,7.33338399574436
45580,"Thomaston, GA",1991,130,13,143,26264,5.44471519951264
45580,"Thomaston, GA",1992,168,0,168,26307,6.38613296841145
45580,"Thomaston, GA",1993,226,6,232,26426,8.77923257398017
45580,"Thomaston, GA",1994,81,9,90,26622,3.3806626098715302
45580,"Thomaston, GA",1995,65,8,73,26786,2.72530426342119
45580,"Thomaston, GA",1996,75,15,90,26881,3.34808972880473
45580,"Thomaston, GA",1997,80,36,116,27116,4.27791709691695
45580,"Thomaston, GA",1998,75,4,79,27014,2.92440956541053
45580,"Thomaston, GA",1999,85,5,90,27042,3.32815620146439
45580,"Thomaston, GA",2000,133,5,138,27746,4.97368990124703
45580,"Thomaston, GA",2001,99,11,110,27788,3.95854325608176
45580,"Thomaston, GA",2002,91,16,107,27624,3.87344338256588
45580,"Thomaston, GA",2003,98,15,113,27648,4.08709490740741
45580,"Thomaston, GA",2004,103,13,116,27514,4.21603547285019
45580,"Thomaston, GA",2005,107,14,121,27440,4.40962099125364
45580,"Thomaston, GA",2006,96,0,96,27349,3.51018318768511
45580,"Thomaston, GA",2007,65,4,69,27423,2.51613609014331
45580,"Thomaston, GA",2008,27,10,37,27321,1.35426960945793
45580,"Thomaston, GA",2009,21,2,23,27360,0.840643274853801
45580,"Thomaston, GA",2010,23,48,71,27056,2.62418687167357
45580,"Thomaston, GA",2011,18,0,18,26922,0.668598172498329
45580,"Thomaston, GA",2012,11,0,11,26566,0.414063088157796
45580,"Thomaston, GA",2013,10,0,10,26432,0.378329297820823
45580,"Thomaston, GA",2014,22,0,22,26173,0.840560883353074
45580,"Thomaston, GA",2015,14,0,14,26241,0.53351625319157
45580,"Thomaston, GA",2016,18,0,18,26255,0.685583698343173
45580,"Thomaston, GA",2017,19,0,19,26197,0.725273886322861
45580,"Thomaston, GA",2018,14,0,14,26215,0.534045393858478
45620,"Thomasville, GA",1990,119,0,119,38916,3.05786822900606
45620,"Thomasville, GA",1991,97,2,99,39084,2.53300583358919
45620,"Thomasville, GA",1992,96,0,96,39472,2.43210376976084
45620,"Thomasville, GA",1993,152,0,152,39650,3.83354350567465
45620,"Thomasville, GA",1994,206,0,206,40111,5.13574829847174
45620,"Thomasville, GA",1995,116,0,116,41230,2.81348532621877
45620,"Thomasville, GA",1996,186,30,216,41762,5.17216608399981
45620,"Thomasville, GA",1997,194,12,206,42583,4.83761125331705
45620,"Thomasville, GA",1998,190,4,194,42917,4.52035323997483
45620,"Thomasville, GA",1999,173,4,177,42932,4.12279884468462
45620,"Thomasville, GA",2000,192,0,192,42829,4.48294379976184
45620,"Thomasville, GA",2001,132,19,151,42674,3.53845432816235
45620,"Thomasville, GA",2002,164,26,190,42555,4.46481024556456
45620,"Thomasville, GA",2003,198,108,306,42956,7.12356830244902
45620,"Thomasville, GA",2004,211,33,244,42762,5.70600065478696
45620,"Thomasville, GA",2005,280,96,376,43556,8.6325649738268
45620,"Thomasville, GA",2006,355,85,440,43901,10.0225507391631
45620,"Thomasville, GA",2007,263,99,362,44269,8.1772798120581
45620,"Thomasville, GA",2008,154,73,227,44627,5.08660676272212
45620,"Thomasville, GA",2009,94,36,130,44689,2.90899326456175
45620,"Thomasville, GA",2010,72,0,72,44750,1.60893854748603
45620,"Thomasville, GA",2011,70,64,134,44590,3.00515810719892
45620,"Thomasville, GA",2012,77,84,161,44535,3.61513416414056
45620,"Thomasville, GA",2013,77,0,77,44772,1.7198248905566
45620,"Thomasville, GA",2014,71,0,71,44759,1.58627315176836
45620,"Thomasville, GA",2015,71,8,79,44812,1.76292064625547
45620,"Thomasville, GA",2016,79,160,239,44968,5.31489058886319
45620,"Thomasville, GA",2017,94,2,96,44662,2.14947830370337
45620,"Thomasville, GA",2018,98,2,100,44448,2.24982001439885
45660,"Tiffin, OH",1990,100,16,116,59845,1.9383407135099
45660,"Tiffin, OH",1991,104,29,133,59682,2.22847759793573
45660,"Tiffin, OH",1992,140,14,154,59749,2.57744899496226
45660,"Tiffin, OH",1993,145,29,174,60019,2.89908195738016
45660,"Tiffin, OH",1994,151,10,161,60238,2.67273149838972
45660,"Tiffin, OH",1995,154,16,170,60140,2.82673761223811
45660,"Tiffin, OH",1996,167,14,181,60187,3.00729393390599
45660,"Tiffin, OH",1997,168,10,178,60181,2.95774413851548
45660,"Tiffin, OH",1998,195,12,207,59996,3.45023001533436
45660,"Tiffin, OH",1999,194,6,200,59791,3.34498503119199
45660,"Tiffin, OH",2000,187,16,203,58588,3.46487335290503
45660,"Tiffin, OH",2001,187,2,189,58376,3.237631903522
45660,"Tiffin, OH",2002,180,4,184,58090,3.16749870889998
45660,"Tiffin, OH",2003,138,18,156,58006,2.68937696100403
45660,"Tiffin, OH",2004,66,66,132,57857,2.281487114783
45660,"Tiffin, OH",2005,82,40,122,57664,2.11570477247503
45660,"Tiffin, OH",2006,49,42,91,57406,1.58520015329408
45660,"Tiffin, OH",2007,41,0,41,57289,0.715669674806682
45660,"Tiffin, OH",2008,33,0,33,57199,0.576933163167188
45660,"Tiffin, OH",2009,53,0,53,56897,0.931507812362691
45660,"Tiffin, OH",2010,14,0,14,56619,0.247266818559141
45660,"Tiffin, OH",2011,18,0,18,56516,0.318493877839904
45660,"Tiffin, OH",2012,13,0,13,56102,0.231720794267584
45660,"Tiffin, OH",2013,22,4,26,55845,0.46557435759692
45660,"Tiffin, OH",2014,27,0,27,55802,0.483853625318089
45660,"Tiffin, OH",2015,31,2,33,55637,0.59313047072991
45660,"Tiffin, OH",2016,24,52,76,55447,1.37067830540877
45660,"Tiffin, OH",2017,28,0,28,55281,0.506503138510519
45660,"Tiffin, OH",2018,23,3,26,55207,0.470954770228413
45700,"Tifton, GA",1990,93,12,105,35037,2.99683192054114
45700,"Tifton, GA",1991,86,4,90,35361,2.54517688979384
45700,"Tifton, GA",1992,100,0,100,35599,2.80906767044018
45700,"Tifton, GA",1993,86,0,86,35406,2.42896684177823
45700,"Tifton, GA",1994,106,12,118,35712,3.30421146953405
45700,"Tifton, GA",1995,153,0,153,36247,4.22103898253649
45700,"Tifton, GA",1996,164,4,168,36485,4.60463204056462
45700,"Tifton, GA",1997,139,2,141,36614,3.85098596165401
45700,"Tifton, GA",1998,136,0,136,36744,3.70128456346614
45700,"Tifton, GA",1999,161,0,161,36904,4.36267071320182
45700,"Tifton, GA",2000,116,0,116,38348,3.02492959215604
45700,"Tifton, GA",2001,136,2,138,38133,3.61891275273385
45700,"Tifton, GA",2002,141,2,143,38217,3.74179030274485
45700,"Tifton, GA",2003,127,2,129,38215,3.37563783854507
45700,"Tifton, GA",2004,135,0,135,38622,3.49541711977629
45700,"Tifton, GA",2005,151,0,151,38789,3.89285622212483
45700,"Tifton, GA",2006,145,0,145,39503,3.67060729564843
45700,"Tifton, GA",2007,121,0,121,39720,3.04632426988922
45700,"Tifton, GA",2008,80,0,80,39806,2.00974727428026
45700,"Tifton, GA",2009,53,0,53,39748,1.33340042266278
45700,"Tifton, GA",2010,47,0,47,40247,1.16778890352076
45700,"Tifton, GA",2011,38,12,50,41152,1.21500777604977
45700,"Tifton, GA",2012,48,8,56,40943,1.36775517182424
45700,"Tifton, GA",2013,40,28,68,40175,1.69259489732421
45700,"Tifton, GA",2014,37,22,59,40454,1.45844663074109
45700,"Tifton, GA",2015,38,33,71,40536,1.75152950463785
45700,"Tifton, GA",2016,39,120,159,40552,3.92089169461432
45700,"Tifton, GA",2017,43,0,43,40438,1.06335624907265
45700,"Tifton, GA",2018,71,106,177,40571,4.36272214143107
45740,"Toccoa, GA",1990,91,45,136,23476,5.79315045152496
45740,"Toccoa, GA",1991,92,4,96,23769,4.03887416382683
45740,"Toccoa, GA",1992,106,17,123,24047,5.11498315798228
45740,"Toccoa, GA",1993,103,11,114,24408,4.67059980334317
45740,"Toccoa, GA",1994,90,28,118,24663,4.78449499249889
45740,"Toccoa, GA",1995,87,16,103,24963,4.12610663782398
45740,"Toccoa, GA",1996,104,6,110,25189,4.36698558894756
45740,"Toccoa, GA",1997,116,20,136,25229,5.39062190336517
45740,"Toccoa, GA",1998,87,10,97,25367,3.82386565222533
45740,"Toccoa, GA",1999,123,7,130,25355,5.12719384736738
45740,"Toccoa, GA",2000,87,4,91,25482,3.57114826151793
45740,"Toccoa, GA",2001,96,2,98,25594,3.82902242713136
45740,"Toccoa, GA",2002,78,2,80,25625,3.1219512195122
45740,"Toccoa, GA",2003,71,6,77,25432,3.02768166089965
45740,"Toccoa, GA",2004,81,4,85,25314,3.35782570909378
45740,"Toccoa, GA",2005,111,0,111,25332,4.38180956892468
45740,"Toccoa, GA",2006,126,48,174,25488,6.82674199623352
45740,"Toccoa, GA",2007,105,56,161,25620,6.28415300546448
45740,"Toccoa, GA",2008,71,41,112,26004,4.30702968774035
45740,"Toccoa, GA",2009,43,0,43,26069,1.64946871763397
45740,"Toccoa, GA",2010,2,0,2,26135,0.0765257317773101
45740,"Toccoa, GA",2011,4,0,4,25764,0.155255395124981
45740,"Toccoa, GA",2012,2,0,2,25721,0.0777574744372303
45740,"Toccoa, GA",2013,20,0,20,25568,0.782227784730914
45740,"Toccoa, GA",2014,25,0,25,25424,0.983322844556325
45740,"Toccoa, GA",2015,26,0,26,25472,1.02072864321608
45740,"Toccoa, GA",2016,32,0,32,25664,1.24688279301746
45740,"Toccoa, GA",2017,0,0,0,25785,0
45740,"Toccoa, GA",2018,1,0,1,26035,0.0384098329172268
45780,"Toledo, OH",1990,938,574,1512,614378,2.46102562266227
45780,"Toledo, OH",1991,924,340,1264,613307,2.06095805200332
45780,"Toledo, OH",1992,1192,328,1520,613412,2.47794304643535
45780,"Toledo, OH",1993,1280,534,1814,612260,2.96279358442492
45780,"Toledo, OH",1994,1521,461,1982,611453,3.24145927814566
45780,"Toledo, OH",1995,1471,721,2192,610911,3.58808402533266
45780,"Toledo, OH",1996,1681,343,2024,610072,3.31764119644894
45780,"Toledo, OH",1997,1475,488,1963,610453,3.21564477527344
45780,"Toledo, OH",1998,1506,840,2346,610103,3.8452523590279
45780,"Toledo, OH",1999,1773,524,2297,609020,3.77163311549703
45780,"Toledo, OH",2000,1561,583,2144,618207,3.4680940202877
45780,"Toledo, OH",2001,1976,740,2716,619037,4.38745987719635
45780,"Toledo, OH",2002,1860,533,2393,618721,3.86765601943364
45780,"Toledo, OH",2003,2278,668,2946,619006,4.75924304449391
45780,"Toledo, OH",2004,2391,1483,3874,618181,6.26677300014074
45780,"Toledo, OH",2005,2069,761,2830,616819,4.58805581540128
45780,"Toledo, OH",2006,1370,310,1680,614581,2.73356970033242
45780,"Toledo, OH",2007,1019,675,1694,613567,2.76090467707683
45780,"Toledo, OH",2008,587,437,1024,611964,1.67330104385225
45780,"Toledo, OH",2009,390,155,545,610734,0.892368854525866
45780,"Toledo, OH",2010,387,252,639,610019,1.0475083562971
45780,"Toledo, OH",2011,363,161,524,608770,0.860752008147576
45780,"Toledo, OH",2012,437,265,702,607476,1.15560120893665
45780,"Toledo, OH",2013,621,136,757,607347,1.24640444424686
45780,"Toledo, OH",2014,598,477,1075,606336,1.77294437407642
45780,"Toledo, OH",2015,649,66,715,605182,1.1814627665727
45780,"Toledo, OH",2016,694,133,827,604883,1.36720655068831
45780,"Toledo, OH",2017,704,267,971,603830,1.6080684960999
45780,"Toledo, OH",2018,785,311,1096,602871,1.81796769126397
45820,"Topeka, KS",1990,589,101,690,210623,3.27599549906705
45820,"Topeka, KS",1991,645,127,772,212601,3.63121528120752
45820,"Topeka, KS",1992,810,192,1002,214236,4.67708508373943
45820,"Topeka, KS",1993,864,311,1175,216576,5.42534722222222
45820,"Topeka, KS",1994,935,200,1135,219028,5.18198586482094
45820,"Topeka, KS",1995,856,189,1045,220579,4.73753167799292
45820,"Topeka, KS",1996,852,294,1146,221892,5.16467470661403
45820,"Topeka, KS",1997,807,224,1031,223075,4.62176398072397
45820,"Topeka, KS",1998,872,168,1040,224430,4.63396159158758
45820,"Topeka, KS",1999,861,279,1140,224759,5.07209944874288
45820,"Topeka, KS",2000,816,61,877,224859,3.90022191684567
45820,"Topeka, KS",2001,909,78,987,225090,4.38491270158603
45820,"Topeka, KS",2002,957,414,1371,225355,6.08373455215105
45820,"Topeka, KS",2003,1234,144,1378,226153,6.09322007667376
45820,"Topeka, KS",2004,1135,32,1167,227155,5.13746120490414
45820,"Topeka, KS",2005,1130,61,1191,228208,5.21892308770946
45820,"Topeka, KS",2006,815,105,920,228825,4.02053971375505
45820,"Topeka, KS",2007,670,372,1042,230025,4.52994239756548
45820,"Topeka, KS",2008,462,103,565,231272,2.44301082707807
45820,"Topeka, KS",2009,343,146,489,232548,2.10279168171732
45820,"Topeka, KS",2010,353,28,381,234274,1.62630082723648
45820,"Topeka, KS",2011,252,12,264,234688,1.1248977365694
45820,"Topeka, KS",2012,270,42,312,234413,1.33098420309454
45820,"Topeka, KS",2013,272,10,282,233861,1.20584449737237
45820,"Topeka, KS",2014,285,30,315,233752,1.34758205277388
45820,"Topeka, KS",2015,354,34,388,233580,1.66110112167138
45820,"Topeka, KS",2016,368,20,388,233225,1.66362954228749
45820,"Topeka, KS",2017,327,8,335,233153,1.43682474598225
45820,"Topeka, KS",2018,330,26,356,232594,1.5305639870332
45860,"Torrington, CT",1990,708,143,851,174488,4.87712622071432
45860,"Torrington, CT",1991,538,12,550,175599,3.13213628779207
45860,"Torrington, CT",1992,658,19,677,176494,3.83582444728999
45860,"Torrington, CT",1993,699,8,707,177487,3.98339033281311
45860,"Torrington, CT",1994,717,2,719,178036,4.03850906558224
45860,"Torrington, CT",1995,614,12,626,178815,3.50082487487068
45860,"Torrington, CT",1996,629,36,665,179905,3.69639531975209
45860,"Torrington, CT",1997,639,76,715,180552,3.96007798307413
45860,"Torrington, CT",1998,721,53,774,181404,4.26671958721969
45860,"Torrington, CT",1999,820,26,846,182344,4.63958232790769
45860,"Torrington, CT",2000,718,7,725,182597,3.97049239582249
45860,"Torrington, CT",2001,743,21,764,184118,4.1495128124355
45860,"Torrington, CT",2002,776,31,807,185974,4.33931624850786
45860,"Torrington, CT",2003,697,35,732,187424,3.90558306300154
45860,"Torrington, CT",2004,799,11,810,188601,4.29478104569965
45860,"Torrington, CT",2005,674,4,678,188912,3.58897264334717
45860,"Torrington, CT",2006,534,7,541,189682,2.85214200609441
45860,"Torrington, CT",2007,375,9,384,189866,2.02247901151338
45860,"Torrington, CT",2008,249,12,261,190175,1.37242013934534
45860,"Torrington, CT",2009,157,6,163,190015,0.857827013656817
45860,"Torrington, CT",2010,140,24,164,189806,0.864040125180447
45860,"Torrington, CT",2011,111,0,111,189002,0.58729537253574
45860,"Torrington, CT",2012,144,10,154,187609,0.820856142295945
45860,"Torrington, CT",2013,145,13,158,186886,0.845435185086095
45860,"Torrington, CT",2014,141,4,145,185398,0.782101209290284
45860,"Torrington, CT",2015,101,11,112,184133,0.608255988877605
45860,"Torrington, CT",2016,112,45,157,182801,0.85885744607524
45860,"Torrington, CT",2017,125,17,142,181710,0.781464971658137
45860,"Torrington, CT",2018,117,9,126,181111,0.695705948285858
45900,"Traverse City, MI",1990,882,199,1081,106775,10.1240927183329
45900,"Traverse City, MI",1991,813,100,913,108551,8.41079308343544
45900,"Traverse City, MI",1992,989,30,1019,110897,9.18870663769083
45900,"Traverse City, MI",1993,1010,80,1090,113222,9.62710427302114
45900,"Traverse City, MI",1994,1028,69,1097,115177,9.52447103154276
45900,"Traverse City, MI",1995,1088,199,1287,117516,10.9517001940161
45900,"Traverse City, MI",1996,1142,286,1428,119734,11.9264369352064
45900,"Traverse City, MI",1997,1108,53,1161,121465,9.55830897789487
45900,"Traverse City, MI",1998,1290,234,1524,123721,12.3180381665198
45900,"Traverse City, MI",1999,1537,282,1819,125919,14.4457945186985
45900,"Traverse City, MI",2000,1260,430,1690,131991,12.8039032964369
45900,"Traverse City, MI",2001,1206,105,1311,134768,9.72782856464443
45900,"Traverse City, MI",2002,1151,94,1245,136313,9.13339153272248
45900,"Traverse City, MI",2003,1402,82,1484,138196,10.7383715881791
45900,"Traverse City, MI",2004,1295,282,1577,139447,11.3089560908445
45900,"Traverse City, MI",2005,1269,436,1705,140590,12.1274628351945
45900,"Traverse City, MI",2006,990,191,1181,141962,8.31912765387921
45900,"Traverse City, MI",2007,655,52,707,142791,4.95129244840361
45900,"Traverse City, MI",2008,429,16,445,143219,3.10712964062031
45900,"Traverse City, MI",2009,306,84,390,143278,2.72198104384483
45900,"Traverse City, MI",2010,325,25,350,143343,2.44169579260934
45900,"Traverse City, MI",2011,328,29,357,144316,2.47373818564816
45900,"Traverse City, MI",2012,391,21,412,145005,2.84128133512638
45900,"Traverse City, MI",2013,616,37,653,146215,4.46602605751804
45900,"Traverse City, MI",2014,502,57,559,147291,3.7952081254116
45900,"Traverse City, MI",2015,588,85,673,147828,4.55258814297697
45900,"Traverse City, MI",2016,687,172,859,148295,5.79250817627027
45900,"Traverse City, MI",2017,714,125,839,148671,5.64333326607072
45900,"Traverse City, MI",2018,675,276,951,149914,6.34363701855731
45940,"Trenton, NJ",1990,520,484,1004,326114,3.07867800830384
45940,"Trenton, NJ",1991,412,19,431,326869,1.31857104834047
45940,"Trenton, NJ",1992,598,50,648,327374,1.97938748953796
45940,"Trenton, NJ",1993,881,489,1370,328501,4.17045914624309
45940,"Trenton, NJ",1994,1056,248,1304,328945,3.9641885421575
45940,"Trenton, NJ",1995,809,49,858,329683,2.60249997725087
45940,"Trenton, NJ",1996,788,14,802,329846,2.43143770123027
45940,"Trenton, NJ",1997,1040,23,1063,329947,3.22172955050357
45940,"Trenton, NJ",1998,1200,193,1393,331632,4.20043904086457
45940,"Trenton, NJ",1999,1099,60,1159,334413,3.46577435685814
45940,"Trenton, NJ",2000,1210,73,1283,351465,3.65043460942057
45940,"Trenton, NJ",2001,1172,183,1355,353816,3.8296741809302
45940,"Trenton, NJ",2002,1126,302,1428,355935,4.01196847739053
45940,"Trenton, NJ",2003,778,410,1188,358724,3.31173827232078
45940,"Trenton, NJ",2004,938,703,1641,361248,4.54258570289663
45940,"Trenton, NJ",2005,1221,75,1296,362015,3.57996215626424
45940,"Trenton, NJ",2006,578,269,847,362840,2.3343622533348
45940,"Trenton, NJ",2007,466,234,700,363088,1.92790728418455
45940,"Trenton, NJ",2008,325,300,625,364119,1.71647181278648
45940,"Trenton, NJ",2009,178,91,269,365388,0.736203706744611
45940,"Trenton, NJ",2010,180,475,655,367744,1.7811303515489
45940,"Trenton, NJ",2011,135,265,400,367384,1.08877904318098
45940,"Trenton, NJ",2012,110,334,444,368604,1.20454471465312
45940,"Trenton, NJ",2013,191,797,988,369517,2.67376061182571
45940,"Trenton, NJ",2014,239,129,368,369017,0.997244029407859
45940,"Trenton, NJ",2015,284,612,896,368352,2.4324559117366
45940,"Trenton, NJ",2016,175,536,711,368028,1.93191822361342
45940,"Trenton, NJ",2017,152,453,605,368602,1.64133672633355
45940,"Trenton, NJ",2018,180,321,501,369811,1.35474607299404
45980,"Troy, AL",1990,38,15,53,27637,1.91771899989145
45980,"Troy, AL",1991,54,0,54,27994,1.92898478245338
45980,"Troy, AL",1992,68,62,130,28146,4.61877353798053
45980,"Troy, AL",1993,60,84,144,28353,5.07882763728706
45980,"Troy, AL",1994,58,46,104,28749,3.61751713103064
45980,"Troy, AL",1995,44,2,46,28557,1.6108134607977
45980,"Troy, AL",1996,52,65,117,28360,4.12552891396333
45980,"Troy, AL",1997,49,39,88,28544,3.08295964125561
45980,"Troy, AL",1998,37,44,81,28689,2.82338178395901
45980,"Troy, AL",1999,51,116,167,28487,5.86232316495243
45980,"Troy, AL",2000,25,0,25,29748,0.84039263143740806
45980,"Troy, AL",2001,27,0,27,29844,0.904704463208685
45980,"Troy, AL",2002,48,34,82,29695,2.76140764438458
45980,"Troy, AL",2003,51,78,129,30050,4.29284525790349
45980,"Troy, AL",2004,39,46,85,30593,2.77841336253391
45980,"Troy, AL",2005,57,66,123,30772,3.99714025737684
45980,"Troy, AL",2006,71,62,133,31309,4.24797981411096
45980,"Troy, AL",2007,89,202,291,31761,9.16218003211486
45980,"Troy, AL",2008,57,40,97,32149,3.0172011571122
45980,"Troy, AL",2009,77,0,77,32560,2.36486486486486
45980,"Troy, AL",2010,56,32,88,32963,2.66965992173043
45980,"Troy, AL",2011,54,23,77,33017,2.33213193203501
45980,"Troy, AL",2012,30,402,432,33210,13.0081300813008
45980,"Troy, AL",2013,41,30,71,33713,2.10601251742651
45980,"Troy, AL",2014,42,2,44,33197,1.32542097177456
45980,"Troy, AL",2015,34,0,34,33522,1.01425929240499
45980,"Troy, AL",2016,33,0,33,33521,0.984457504251066
45980,"Troy, AL",2017,61,0,61,33435,1.82443547181098
45980,"Troy, AL",2018,49,0,49,33338,1.46979422880797
46020,"Truckee-Grass Valley, CA",1990,1093,52,1145,79198,14.4574357938332
46020,"Truckee-Grass Valley, CA",1991,889,74,963,81420,11.8275607958733
46020,"Truckee-Grass Valley, CA",1992,792,32,824,83162,9.90837161203434
46020,"Truckee-Grass Valley, CA",1993,426,90,516,84242,6.12521070249994
46020,"Truckee-Grass Valley, CA",1994,703,34,737,85658,8.60398328235541
46020,"Truckee-Grass Valley, CA",1995,597,120,717,87118,8.23021648798182
46020,"Truckee-Grass Valley, CA",1996,525,75,600,88581,6.7734615775392
46020,"Truckee-Grass Valley, CA",1997,537,108,645,89987,7.1677020014002
46020,"Truckee-Grass Valley, CA",1998,648,20,668,91152,7.32841846585922
46020,"Truckee-Grass Valley, CA",1999,786,31,817,92011,8.87937311843149
46020,"Truckee-Grass Valley, CA",2000,739,92,831,92520,8.98184176394293
46020,"Truckee-Grass Valley, CA",2001,730,30,760,93715,8.10969428586672
46020,"Truckee-Grass Valley, CA",2002,755,157,912,94647,9.63580462138261
46020,"Truckee-Grass Valley, CA",2003,709,203,912,95606,9.53915026253583
46020,"Truckee-Grass Valley, CA",2004,768,186,954,96512,9.88478116710875
46020,"Truckee-Grass Valley, CA",2005,689,133,822,97250,8.45244215938303
46020,"Truckee-Grass Valley, CA",2006,467,170,637,97549,6.53005156382946
46020,"Truckee-Grass Valley, CA",2007,389,60,449,97794,4.59128371883756
46020,"Truckee-Grass Valley, CA",2008,188,11,199,98200,2.02647657841141
46020,"Truckee-Grass Valley, CA",2009,103,0,103,98591,1.04472010629774
46020,"Truckee-Grass Valley, CA",2010,108,34,142,98785,1.43746520220681
46020,"Truckee-Grass Valley, CA",2011,91,0,91,98697,0.922013840339625
46020,"Truckee-Grass Valley, CA",2012,92,0,92,98140,0.937436315467699
46020,"Truckee-Grass Valley, CA",2013,174,0,174,97952,1.77638026788631
46020,"Truckee-Grass Valley, CA",2014,207,83,290,98589,2.94150463033401
46020,"Truckee-Grass Valley, CA",2015,206,10,216,98709,2.18825031152175
46020,"Truckee-Grass Valley, CA",2016,236,16,252,98964,2.54638050200073
46020,"Truckee-Grass Valley, CA",2017,403,16,419,99503,4.21092831371918
46020,"Truckee-Grass Valley, CA",2018,390,151,541,99696,5.42649654951051
46060,"Tucson, AZ",1990,2207,471,2678,668271,4.0073562970711
46060,"Tucson, AZ",1991,2631,30,2661,676903,3.93113932129123
46060,"Tucson, AZ",1992,4141,74,4215,692714,6.08476225397494
46060,"Tucson, AZ",1993,5360,840,6200,711612,8.71261305318067
46060,"Tucson, AZ",1994,6526,1954,8480,734325,11.5480202907432
46060,"Tucson, AZ",1995,4934,2341,7275,754505,9.64208322012445
46060,"Tucson, AZ",1996,5073,624,5697,767074,7.42692360841327
46060,"Tucson, AZ",1997,5577,1225,6802,778938,8.73240232213604
46060,"Tucson, AZ",1998,6512,1028,7540,790744,9.53532369515292
46060,"Tucson, AZ",1999,7234,1500,8734,803096,10.8754121549603
46060,"Tucson, AZ",2000,6816,963,7779,848019,9.17314352626533
46060,"Tucson, AZ",2001,6298,1174,7472,859280,8.69565217391304
46060,"Tucson, AZ",2002,6114,1033,7147,874267,8.17484818710989
46060,"Tucson, AZ",2003,7598,312,7910,885893,8.92884355108348
46060,"Tucson, AZ",2004,9604,917,10521,901342,11.6725948641026
46060,"Tucson, AZ",2005,11166,478,11644,920298,12.652423454142
46060,"Tucson, AZ",2006,8132,390,8522,940930,9.05699680103727
46060,"Tucson, AZ",2007,4698,539,5237,955869,5.47878422670889
46060,"Tucson, AZ",2008,2743,478,3221,967778,3.32824263415783
46060,"Tucson, AZ",2009,1934,195,2129,975580,2.18229155989258
46060,"Tucson, AZ",2010,1726,212,1938,981653,1.97422103329792
46060,"Tucson, AZ",2011,1388,854,2242,988407,2.26829635969798
46060,"Tucson, AZ",2012,2175,666,2841,993215,2.86040786738017
46060,"Tucson, AZ",2013,2623,868,3491,997437,3.49997042419722
46060,"Tucson, AZ",2014,2296,954,3250,1004675,3.23487695025755
46060,"Tucson, AZ",2015,2226,202,2428,1009737,2.40458654085173
46060,"Tucson, AZ",2016,2420,46,2466,1017624,2.42329190349284
46060,"Tucson, AZ",2017,2888,1607,4495,1027502,4.37468734854044
46060,"Tucson, AZ",2018,3240,1164,4404,1039073,4.2383932601463
46100,"Tullahoma-Manchester, TN",1990,252,84,336,80165,4.19135532963263
46100,"Tullahoma-Manchester, TN",1991,250,71,321,81144,3.95593019816622
46100,"Tullahoma-Manchester, TN",1992,303,2,305,81910,3.72359907215236
46100,"Tullahoma-Manchester, TN",1993,365,113,478,82803,5.77273770274024
46100,"Tullahoma-Manchester, TN",1994,390,64,454,84014,5.40386126121837
46100,"Tullahoma-Manchester, TN",1995,405,80,485,85507,5.6720502415007
46100,"Tullahoma-Manchester, TN",1996,426,151,577,86913,6.63882273077675
46100,"Tullahoma-Manchester, TN",1997,441,66,507,87865,5.77021567176919
46100,"Tullahoma-Manchester, TN",1998,459,42,501,88569,5.65660671340988
46100,"Tullahoma-Manchester, TN",1999,441,20,461,89277,5.1637039775082
46100,"Tullahoma-Manchester, TN",2000,411,189,600,93250,6.4343163538874
46100,"Tullahoma-Manchester, TN",2001,361,42,403,93949,4.28956135775793
46100,"Tullahoma-Manchester, TN",2002,473,39,512,94891,5.39566449926758
46100,"Tullahoma-Manchester, TN",2003,460,18,478,95586,5.00073232481744
46100,"Tullahoma-Manchester, TN",2004,476,62,538,96434,5.57894518530809
46100,"Tullahoma-Manchester, TN",2005,849,14,863,97453,8.85555088093748
46100,"Tullahoma-Manchester, TN",2006,857,14,871,98646,8.82955213592036
46100,"Tullahoma-Manchester, TN",2007,717,81,798,99383,8.02954227584195
46100,"Tullahoma-Manchester, TN",2008,430,42,472,99852,4.72699595401194
46100,"Tullahoma-Manchester, TN",2009,251,44,295,100288,2.94152839821315
46100,"Tullahoma-Manchester, TN",2010,169,8,177,100062,1.76890327996642
46100,"Tullahoma-Manchester, TN",2011,155,48,203,100105,2.02787073572749
46100,"Tullahoma-Manchester, TN",2012,200,6,206,100128,2.05736657078939
46100,"Tullahoma-Manchester, TN",2013,213,18,231,100761,2.2925536665972
46100,"Tullahoma-Manchester, TN",2014,250,16,266,101090,2.63131862696607
46100,"Tullahoma-Manchester, TN",2015,286,0,286,101667,2.81310553080154
46100,"Tullahoma-Manchester, TN",2016,371,6,377,102176,3.689711869715
46100,"Tullahoma-Manchester, TN",2017,491,52,543,102888,5.27758339164917
46100,"Tullahoma-Manchester, TN",2018,453,41,494,104001,4.74995432736224
46140,"Tulsa, OK",1990,1753,302,2055,762798,2.69402908764837
46140,"Tulsa, OK",1991,2111,108,2219,773136,2.87012892945096
46140,"Tulsa, OK",1992,2803,19,2822,782778,3.60510898364543
46140,"Tulsa, OK",1993,3089,24,3113,790816,3.93644033504633
46140,"Tulsa, OK",1994,2713,406,3119,794818,3.92416880342418
46140,"Tulsa, OK",1995,2555,1075,3630,798743,4.54464076680484
46140,"Tulsa, OK",1996,3001,635,3636,807903,4.50054028763354
46140,"Tulsa, OK",1997,2926,351,3277,819571,3.99843332670385
46140,"Tulsa, OK",1998,3366,2061,5427,831775,6.52460100387725
46140,"Tulsa, OK",1999,3803,1579,5382,841895,6.39272118257027
46140,"Tulsa, OK",2000,3500,275,3775,861237,4.38323016777031
46140,"Tulsa, OK",2001,3726,470,4196,867602,4.83631895730992
46140,"Tulsa, OK",2002,3935,713,4648,874844,5.31294722259054
46140,"Tulsa, OK",2003,4016,338,4354,877577,4.9613880035598
46140,"Tulsa, OK",2004,4401,254,4655,878004,5.30179816948442
46140,"Tulsa, OK",2005,4994,650,5644,882861,6.39285232896232
46140,"Tulsa, OK",2006,4830,351,5181,894011,5.79523070745215
46140,"Tulsa, OK",2007,4399,761,5160,906441,5.69259334032772
46140,"Tulsa, OK",2008,2868,1120,3988,916525,4.35121791549603
46140,"Tulsa, OK",2009,2680,660,3340,929824,3.59207764049971
46140,"Tulsa, OK",2010,2269,347,2616,939822,2.78350581280285
46140,"Tulsa, OK",2011,2033,1532,3565,945882,3.76896906802328
46140,"Tulsa, OK",2012,2699,737,3436,952916,3.60577427601174
46140,"Tulsa, OK",2013,3008,717,3725,962403,3.87051993811324
46140,"Tulsa, OK",2014,3022,1511,4533,969986,4.67326332545006
46140,"Tulsa, OK",2015,2885,889,3774,981521,3.84505272938633
46140,"Tulsa, OK",2016,3036,716,3752,989256,3.79274929846268
46140,"Tulsa, OK",2017,3160,484,3644,991610,3.6748318391303
46140,"Tulsa, OK",2018,2845,567,3412,993797,3.43329673967621
46180,"Tupelo, MS",1990,205,204,409,108217,3.77944315588124
46180,"Tupelo, MS",1991,184,60,244,109724,2.22376143778936
46180,"Tupelo, MS",1992,216,67,283,111279,2.54315728933581
46180,"Tupelo, MS",1993,292,84,376,113258,3.31985378516308
46180,"Tupelo, MS",1994,363,225,588,114978,5.11402181286855
46180,"Tupelo, MS",1995,351,116,467,117156,3.98613814059886
46180,"Tupelo, MS",1996,258,132,390,118546,3.28986216321091
46180,"Tupelo, MS",1997,221,12,233,119533,1.9492525076757
46180,"Tupelo, MS",1998,244,21,265,120937,2.19122352960632
46180,"Tupelo, MS",1999,150,32,182,121905,1.49296583405111
46180,"Tupelo, MS",2000,140,88,228,125696,1.81390020366599
46180,"Tupelo, MS",2001,173,11,184,126680,1.45247868645406
46180,"Tupelo, MS",2002,133,8,141,127069,1.10963334881049
46180,"Tupelo, MS",2003,222,30,252,128545,1.96040297172197
46180,"Tupelo, MS",2004,226,8,234,129298,1.80977277297406
46180,"Tupelo, MS",2005,248,7,255,130350,1.95627157652474
46180,"Tupelo, MS",2006,291,10,301,131999,2.28032030545686
46180,"Tupelo, MS",2007,233,14,247,133096,1.85580332992727
46180,"Tupelo, MS",2008,177,7,184,134388,1.36916986635712
46180,"Tupelo, MS",2009,129,165,294,135535,2.1691813922603
46180,"Tupelo, MS",2010,110,24,134,136355,0.982728906164057
46180,"Tupelo, MS",2011,148,11,159,137072,1.15997432006537
46180,"Tupelo, MS",2012,110,112,222,138398,1.60406942296854
46180,"Tupelo, MS",2013,123,16,139,139020,0.999856135807797
46180,"Tupelo, MS",2014,109,15,124,138955,0.89237522939081
46180,"Tupelo, MS",2015,125,22,147,139148,1.05642912582286
46180,"Tupelo, MS",2016,253,22,275,139708,1.96839121596473
46180,"Tupelo, MS",2017,173,25,198,140186,1.41240922774029
46180,"Tupelo, MS",2018,157,26,183,140552,1.30200922078661
46220,"Tuscaloosa, AL",1990,476,417,893,187233,4.76945837539323
46220,"Tuscaloosa, AL",1991,486,336,822,189594,4.33558023988101
46220,"Tuscaloosa, AL",1992,586,298,884,190069,4.65094255244148
46220,"Tuscaloosa, AL",1993,669,74,743,191531,3.87926758592604
46220,"Tuscaloosa, AL",1994,596,264,860,192898,4.45831475702185
46220,"Tuscaloosa, AL",1995,691,771,1462,195849,7.46493472011601
46220,"Tuscaloosa, AL",1996,679,382,1061,195900,5.41602858601327
46220,"Tuscaloosa, AL",1997,561,366,927,197326,4.69780971590161
46220,"Tuscaloosa, AL",1998,561,140,701,198552,3.53056126354809
46220,"Tuscaloosa, AL",1999,716,55,771,199338,3.86780242603016
46220,"Tuscaloosa, AL",2000,628,127,755,204489,3.69213013902948
46220,"Tuscaloosa, AL",2001,738,416,1154,205692,5.61033000797309
46220,"Tuscaloosa, AL",2002,730,666,1396,206365,6.76471300850435
46220,"Tuscaloosa, AL",2003,930,270,1200,207368,5.78681378033255
46220,"Tuscaloosa, AL",2004,1176,99,1275,209105,6.09741517419478
46220,"Tuscaloosa, AL",2005,1315,419,1734,212545,8.15827236585194
46220,"Tuscaloosa, AL",2006,1188,1435,2623,217938,12.0355330415072
46220,"Tuscaloosa, AL",2007,971,1024,1995,220757,9.03708602671716
46220,"Tuscaloosa, AL",2008,529,727,1256,224304,5.59954347671018
46220,"Tuscaloosa, AL",2009,365,329,694,228631,3.03545888352848
46220,"Tuscaloosa, AL",2010,353,271,624,230490,2.7072758037225
46220,"Tuscaloosa, AL",2011,327,417,744,231431,3.21478107945781
46220,"Tuscaloosa, AL",2012,512,405,917,233466,3.92776678402851
46220,"Tuscaloosa, AL",2013,584,441,1025,235636,4.34992955236042
46220,"Tuscaloosa, AL",2014,440,946,1386,238427,5.81310002642318
46220,"Tuscaloosa, AL",2015,453,294,747,240530,3.10564170789507
46220,"Tuscaloosa, AL",2016,537,928,1465,241758,6.05977878705151
46220,"Tuscaloosa, AL",2017,572,597,1169,242700,4.81664606510095
46220,"Tuscaloosa, AL",2018,578,469,1047,243575,4.2984706969106
46300,"Twin Falls, ID",1990,142,8,150,69013,2.17350354281077
46300,"Twin Falls, ID",1991,172,54,226,70483,3.20644694465332
46300,"Twin Falls, ID",1992,289,222,511,71757,7.12125646278412
46300,"Twin Falls, ID",1993,333,113,446,73128,6.09889508806476
46300,"Twin Falls, ID",1994,415,118,533,75000,7.10666666666667
46300,"Twin Falls, ID",1995,335,148,483,76131,6.34432754068645
46300,"Twin Falls, ID",1996,377,124,501,77734,6.44505621735663
46300,"Twin Falls, ID",1997,329,157,486,79038,6.14894101571396
46300,"Twin Falls, ID",1998,372,104,476,80198,5.93531010748398
46300,"Twin Falls, ID",1999,377,33,410,81068,5.05748260719396
46300,"Twin Falls, ID",2000,311,30,341,82853,4.11572302753069
46300,"Twin Falls, ID",2001,378,78,456,83135,5.48505442954231
46300,"Twin Falls, ID",2002,536,22,558,84203,6.62684227402824
46300,"Twin Falls, ID",2003,643,212,855,86063,9.93458280561914
46300,"Twin Falls, ID",2004,755,30,785,87640,8.95709721588316
46300,"Twin Falls, ID",2005,1047,132,1179,89487,13.1750980589359
46300,"Twin Falls, ID",2006,1034,66,1100,92085,11.9454851495901
46300,"Twin Falls, ID",2007,644,25,669,94310,7.09362739900329
46300,"Twin Falls, ID",2008,444,12,456,96360,4.73225404732254
46300,"Twin Falls, ID",2009,316,13,329,98310,3.34655681009053
46300,"Twin Falls, ID",2010,251,2,253,99989,2.53027833061637
46300,"Twin Falls, ID",2011,206,0,206,100622,2.04726600544612
46300,"Twin Falls, ID",2012,335,2,337,101142,3.33194914081193
46300,"Twin Falls, ID",2013,393,20,413,102688,4.02189155500156
46300,"Twin Falls, ID",2014,369,49,418,103948,4.02124138992573
46300,"Twin Falls, ID",2015,416,62,478,105236,4.54217188034513
46300,"Twin Falls, ID",2016,442,74,516,107172,4.81469040421006
46300,"Twin Falls, ID",2017,425,96,521,109037,4.77819455781065
46300,"Twin Falls, ID",2018,521,64,585,110096,5.31354454294434
46340,"Tyler, TX",1990,95,24,119,151473,0.785618559083137
46340,"Tyler, TX",1991,133,0,133,153315,0.867495026579265
46340,"Tyler, TX",1992,261,0,261,154626,1.68794381281285
46340,"Tyler, TX",1993,290,22,312,157671,1.97880396521872
46340,"Tyler, TX",1994,322,73,395,159515,2.47625615145911
46340,"Tyler, TX",1995,298,16,314,161708,1.94177158829495
46340,"Tyler, TX",1996,354,424,778,163995,4.74404707460593
46340,"Tyler, TX",1997,414,139,553,166075,3.32982086406744
46340,"Tyler, TX",1998,440,121,561,168204,3.33523578511807
46340,"Tyler, TX",1999,440,90,530,169561,3.12571876787705
46340,"Tyler, TX",2000,467,76,543,175658,3.09123410263125
46340,"Tyler, TX",2001,463,74,537,177836,3.01963606918734
46340,"Tyler, TX",2002,548,83,631,181107,3.4841281673265
46340,"Tyler, TX",2003,574,83,657,184254,3.56572991631118
46340,"Tyler, TX",2004,608,116,724,187300,3.86545648691938
46340,"Tyler, TX",2005,604,141,745,191362,3.89314492950534
46340,"Tyler, TX",2006,576,103,679,196124,3.46209540902694
46340,"Tyler, TX",2007,370,92,462,199953,2.31054297759974
46340,"Tyler, TX",2008,258,89,347,203263,1.70714788230027
46340,"Tyler, TX",2009,160,49,209,207111,1.00912071304759
46340,"Tyler, TX",2010,201,65,266,210408,1.2642104862933
46340,"Tyler, TX",2011,185,77,262,212764,1.23141132898423
46340,"Tyler, TX",2012,228,125,353,214836,1.64311381705115
46340,"Tyler, TX",2013,373,0,373,216521,1.72269664374356
46340,"Tyler, TX",2014,377,12,389,219605,1.77136221852872
46340,"Tyler, TX",2015,420,50,470,222447,2.11286283923811
46340,"Tyler, TX",2016,454,127,581,225344,2.57828031809145
46340,"Tyler, TX",2017,472,206,678,227460,2.98074386705355
46340,"Tyler, TX",2018,478,182,660,230221,2.86681058634964
46380,"Ukiah, CA",1990,491,71,562,80822,6.95355225062483
46380,"Ukiah, CA",1991,462,24,486,81540,5.96026490066225
46380,"Ukiah, CA",1992,357,15,372,81637,4.55675735267097
46380,"Ukiah, CA",1993,306,33,339,81633,4.15273235088751
46380,"Ukiah, CA",1994,266,20,286,81782,3.49710205179624
46380,"Ukiah, CA",1995,242,34,276,82473,3.34654977992798
46380,"Ukiah, CA",1996,191,34,225,82925,2.71329514621646
46380,"Ukiah, CA",1997,224,41,265,83250,3.18318318318318
46380,"Ukiah, CA",1998,259,17,276,83780,3.29434232513726
46380,"Ukiah, CA",1999,266,0,266,84221,3.15835717932582
46380,"Ukiah, CA",2000,270,14,284,86407,3.28677074774035
46380,"Ukiah, CA",2001,317,8,325,86841,3.74247187388446
46380,"Ukiah, CA",2002,352,12,364,87364,4.1664758939609
46380,"Ukiah, CA",2003,395,4,399,88140,4.52688904016338
46380,"Ukiah, CA",2004,356,22,378,88030,4.29399068499375
46380,"Ukiah, CA",2005,281,19,300,87981,3.40982712176493
46380,"Ukiah, CA",2006,272,20,292,87345,3.34306485774801
46380,"Ukiah, CA",2007,220,12,232,87071,2.66449219602393
46380,"Ukiah, CA",2008,143,2,145,87468,1.65774911967805
46380,"Ukiah, CA",2009,112,2,114,87722,1.29955997355281
46380,"Ukiah, CA",2010,122,35,157,87800,1.78815489749431
46380,"Ukiah, CA",2011,102,4,106,87334,1.21373119289166
46380,"Ukiah, CA",2012,72,0,72,87304,0.824704480894346
46380,"Ukiah, CA",2013,111,0,111,87077,1.27473385624218
46380,"Ukiah, CA",2014,104,5,109,87257,1.24918344660027
46380,"Ukiah, CA",2015,105,2,107,87168,1.22751468428781
46380,"Ukiah, CA",2016,115,48,163,87382,1.86537273122611
46380,"Ukiah, CA",2017,132,60,192,87697,2.18935653443105
46380,"Ukiah, CA",2018,140,0,140,87606,1.5980640595393
46460,"Union City, TN-KY",1990,103,14,117,40006,2.92456131580263
46460,"Union City, TN-KY",1991,66,5,71,39916,1.77873534422287
46460,"Union City, TN-KY",1992,65,6,71,39752,1.78607365667136
46460,"Union City, TN-KY",1993,81,41,122,39477,3.09040707247258
46460,"Union City, TN-KY",1994,96,8,104,39487,2.63377820548535
46460,"Union City, TN-KY",1995,101,25,126,39705,3.17340385341896
46460,"Union City, TN-KY",1996,105,16,121,39787,3.04119435996682
46460,"Union City, TN-KY",1997,111,6,117,39678,2.94873733555119
46460,"Union City, TN-KY",1998,101,6,107,39716,2.69412831100816
46460,"Union City, TN-KY",1999,110,37,147,39706,3.7022112527074
46460,"Union City, TN-KY",2000,88,4,92,40204,2.2883295194508
46460,"Union City, TN-KY",2001,50,0,50,40123,1.24616803329761
46460,"Union City, TN-KY",2002,70,0,70,39917,1.75363880051106
46460,"Union City, TN-KY",2003,76,0,76,39780,1.91050779286073
46460,"Union City, TN-KY",2004,85,0,85,39620,2.14538112064614
46460,"Union City, TN-KY",2005,53,2,55,39269,1.4005958898877
46460,"Union City, TN-KY",2006,61,0,61,38861,1.56969712565297
46460,"Union City, TN-KY",2007,40,0,40,38833,1.03005176010095
46460,"Union City, TN-KY",2008,32,0,32,38916,0.822283893514236
46460,"Union City, TN-KY",2009,26,2,28,38584,0.725689404934688
46460,"Union City, TN-KY",2010,27,6,33,38626,0.854346813027494
46460,"Union City, TN-KY",2011,24,0,24,38411,0.624821014813465
46460,"Union City, TN-KY",2012,10,0,10,37866,0.264089156499234
46460,"Union City, TN-KY",2013,18,0,18,37402,0.481257686754719
46460,"Union City, TN-KY",2014,12,0,12,37089,0.32354606487098603
46460,"Union City, TN-KY",2015,10,64,74,36843,2.00852265016421
46460,"Union City, TN-KY",2016,15,0,15,36726,0.40842999509884
46460,"Union City, TN-KY",2017,12,0,12,36607,0.327806157292321
46460,"Union City, TN-KY",2018,29,0,29,36387,0.796987935251601
46500,"Urbana, OH",1990,163,11,174,36108,4.81887670322366
46500,"Urbana, OH",1991,177,27,204,36400,5.6043956043956
46500,"Urbana, OH",1992,169,4,173,36613,4.72509764291372
46500,"Urbana, OH",1993,167,0,167,37005,4.51290366166734
46500,"Urbana, OH",1994,137,4,141,37312,3.77894511149228
46500,"Urbana, OH",1995,110,5,115,37596,3.05883604638791
46500,"Urbana, OH",1996,193,2,195,37933,5.14064271215037
46500,"Urbana, OH",1997,198,3,201,38102,5.27531363183035
46500,"Urbana, OH",1998,183,6,189,38368,4.92597998331943
46500,"Urbana, OH",1999,162,2,164,38586,4.25024620328617
46500,"Urbana, OH",2000,175,0,175,38941,4.49397806938702
46500,"Urbana, OH",2001,162,0,162,39047,4.14884626219684
46500,"Urbana, OH",2002,178,0,178,39280,4.53156822810591
46500,"Urbana, OH",2003,202,0,202,39395,5.12755425815459
46500,"Urbana, OH",2004,212,0,212,39565,5.3582711992923
46500,"Urbana, OH",2005,114,0,114,39592,2.87936956961002
46500,"Urbana, OH",2006,106,0,106,40018,2.64880803638363
46500,"Urbana, OH",2007,61,0,61,40127,1.52017344929848
46500,"Urbana, OH",2008,66,0,66,40263,1.63922211459653
46500,"Urbana, OH",2009,24,0,24,40265,0.596051161057991
46500,"Urbana, OH",2010,29,0,29,40077,0.723607056416398
46500,"Urbana, OH",2011,22,0,22,39819,0.552500062784098
46500,"Urbana, OH",2012,26,0,26,39568,0.657096643752527
46500,"Urbana, OH",2013,25,0,25,39460,0.633552965027876
46500,"Urbana, OH",2014,29,0,29,39074,0.74218150176588
46500,"Urbana, OH",2015,37,0,37,38951,0.949911427177736
46500,"Urbana, OH",2016,53,0,53,38719,1.36883700508794
46500,"Urbana, OH",2017,39,0,39,38824,1.0045332783845
46500,"Urbana, OH",2018,46,0,46,38754,1.18697424781958
46520,"Urban Honolulu, HI",1990,1524,1453,2977,838059,3.552255867427
46520,"Urban Honolulu, HI",1991,1203,2915,4118,848098,4.85557093637764
46520,"Urban Honolulu, HI",1992,1793,2795,4588,859544,5.3377139506529
46520,"Urban Honolulu, HI",1993,1916,1495,3411,863939,3.94819541657455
46520,"Urban Honolulu, HI",1994,2440,2172,4612,870150,5.30023559156467
46520,"Urban Honolulu, HI",1995,2090,2454,4544,870960,5.21723156057683
46520,"Urban Honolulu, HI",1996,1125,875,2000,871009,2.2961875250428
46520,"Urban Honolulu, HI",1997,1141,894,2035,872270,2.33299322457496
46520,"Urban Honolulu, HI",1998,1272,329,1601,870511,1.83914964888439
46520,"Urban Honolulu, HI",1999,1449,479,1928,860726,2.23996951410786
46520,"Urban Honolulu, HI",2000,1732,237,1969,876629,2.2461041101766
46520,"Urban Honolulu, HI",2001,1673,302,1975,882755,2.23731386398265
46520,"Urban Honolulu, HI",2002,1964,709,2673,890473,3.00177546090673
46520,"Urban Honolulu, HI",2003,2910,563,3473,894311,3.88343652264145
46520,"Urban Honolulu, HI",2004,1898,2186,4084,907997,4.49781221744125
46520,"Urban Honolulu, HI",2005,2079,1909,3988,918181,4.34337020696355
46520,"Urban Honolulu, HI",2006,1727,879,2606,926954,2.81135849243868
46520,"Urban Honolulu, HI",2007,1152,1792,2944,925335,3.18155046550709
46520,"Urban Honolulu, HI",2008,780,658,1438,933680,1.54014223288493
46520,"Urban Honolulu, HI",2009,862,174,1036,943177,1.09841524973573
46520,"Urban Honolulu, HI",2010,879,1012,1891,956296,1.97742121686172
46520,"Urban Honolulu, HI",2011,734,990,1724,967287,1.78230452802529
46520,"Urban Honolulu, HI",2012,994,730,1724,978073,1.76264961817778
46520,"Urban Honolulu, HI",2013,1137,1504,2641,986222,2.67789605180172
46520,"Urban Honolulu, HI",2014,875,703,1578,987649,1.59773360778981
46520,"Urban Honolulu, HI",2015,982,2851,3833,991339,3.8664876495326
46520,"Urban Honolulu, HI",2016,846,812,1658,992692,1.67020586445746
46520,"Urban Honolulu, HI",2017,1028,940,1968,986429,1.9950751650651
46520,"Urban Honolulu, HI",2018,983,1427,2410,980080,2.4589829401681502
46540,"Utica-Rome, NY",1990,699,243,942,316881,2.97272477680896
46540,"Utica-Rome, NY",1991,649,80,729,318433,2.28933559021835
46540,"Utica-Rome, NY",1992,607,66,673,318659,2.11197549731845
46540,"Utica-Rome, NY",1993,555,159,714,317077,2.25181895880181
46540,"Utica-Rome, NY",1994,486,203,689,314718,2.18926149759467
46540,"Utica-Rome, NY",1995,429,50,479,307487,1.5577894350005
46540,"Utica-Rome, NY",1996,362,60,422,301087,1.40158824525802
46540,"Utica-Rome, NY",1997,324,43,367,297396,1.23404484256681
46540,"Utica-Rome, NY",1998,361,4,365,294657,1.23872841982373
46540,"Utica-Rome, NY",1999,427,8,435,293218,1.483537845562
46540,"Utica-Rome, NY",2000,377,28,405,299597,1.35181593941194
46540,"Utica-Rome, NY",2001,413,6,419,298521,1.4035863473591501
46540,"Utica-Rome, NY",2002,474,4,478,298049,1.60376313961798
46540,"Utica-Rome, NY",2003,470,11,481,298323,1.61234634942663
46540,"Utica-Rome, NY",2004,509,3,512,298986,1.7124547637682
46540,"Utica-Rome, NY",2005,563,33,596,298574,1.99615505703779
46540,"Utica-Rome, NY",2006,566,72,638,298258,2.13908763553702
46540,"Utica-Rome, NY",2007,432,48,480,298831,1.60625905612202
46540,"Utica-Rome, NY",2008,315,28,343,298886,1.1475947351164
46540,"Utica-Rome, NY",2009,319,95,414,299000,1.38461538461538
46540,"Utica-Rome, NY",2010,282,32,314,299224,1.04938106568992
46540,"Utica-Rome, NY",2011,236,18,254,298576,0.850704678205884
46540,"Utica-Rome, NY",2012,289,37,326,297988,1.09400378538733
46540,"Utica-Rome, NY",2013,206,147,353,297237,1.18760450414989
46540,"Utica-Rome, NY",2014,220,16,236,296010,0.797270362487754
46540,"Utica-Rome, NY",2015,224,22,246,293888,0.837053571428572
46540,"Utica-Rome, NY",2016,217,17,234,292794,0.799196704850509
46540,"Utica-Rome, NY",2017,193,154,347,292336,1.1869903125171
46540,"Utica-Rome, NY",2018,183,92,275,291410,0.943687587934525
46620,"Uvalde, TX",1990,13,0,13,23323,0.557389701153368
46620,"Uvalde, TX",1991,8,0,8,23436,0.341355180064857
46620,"Uvalde, TX",1992,14,0,14,23973,0.583990322446085
46620,"Uvalde, TX",1993,18,0,18,23887,0.753547954954578
46620,"Uvalde, TX",1994,17,28,45,24545,1.83336728457934
46620,"Uvalde, TX",1995,14,30,44,24784,1.77533892834087
46620,"Uvalde, TX",1996,23,2,25,25121,0.995183312766212
46620,"Uvalde, TX",1997,18,0,18,25479,0.706464146944543
46620,"Uvalde, TX",1998,25,0,25,25459,0.981971012215719
46620,"Uvalde, TX",1999,25,5,30,26019,1.15300357431108
46620,"Uvalde, TX",2000,31,0,31,25900,1.1969111969112
46620,"Uvalde, TX",2001,25,0,25,25939,0.963799683873704
46620,"Uvalde, TX",2002,41,0,41,26309,1.55840206773348
46620,"Uvalde, TX",2003,41,0,41,26258,1.5614288978597
46620,"Uvalde, TX",2004,20,4,24,26205,0.915855752718947
46620,"Uvalde, TX",2005,35,4,39,26368,1.47906553398058
46620,"Uvalde, TX",2006,37,4,41,26301,1.55887608836166
46620,"Uvalde, TX",2007,22,6,28,26217,1.06800930693825
46620,"Uvalde, TX",2008,26,0,26,26206,0.992139204762268
46620,"Uvalde, TX",2009,19,9,28,26223,1.06776493917553
46620,"Uvalde, TX",2010,10,2,12,26443,0.453806300344136
46620,"Uvalde, TX",2011,21,125,146,26589,5.49099251570198
46620,"Uvalde, TX",2012,21,32,53,26752,1.98116028708134
46620,"Uvalde, TX",2013,24,4,28,26920,1.04011887072808
46620,"Uvalde, TX",2014,13,0,13,27046,0.48066257487244
46620,"Uvalde, TX",2015,20,8,28,26968,1.03826757638683
46620,"Uvalde, TX",2016,19,4,23,27088,0.849084465445954
46620,"Uvalde, TX",2017,20,2,22,27098,0.811868034541295
46620,"Uvalde, TX",2018,18,0,18,26846,0.670490948372197
46660,"Valdosta, GA",1990,394,57,451,97172,4.6412546824188
46660,"Valdosta, GA",1991,332,120,452,98104,4.60735545951235
46660,"Valdosta, GA",1992,828,56,884,99036,8.92604709398602
46660,"Valdosta, GA",1993,595,105,700,102212,6.84851093805033
46660,"Valdosta, GA",1994,671,103,774,103879,7.45097661702558
46660,"Valdosta, GA",1995,649,48,697,105054,6.6346831153502
46660,"Valdosta, GA",1996,794,144,938,106268,8.82673994052772
46660,"Valdosta, GA",1997,687,317,1004,107218,9.36409931168274
46660,"Valdosta, GA",1998,651,264,915,107900,8.48007414272474
46660,"Valdosta, GA",1999,610,40,650,108431,5.99459564146785
46660,"Valdosta, GA",2000,565,401,966,115947,8.33139279153406
46660,"Valdosta, GA",2001,519,22,541,115962,4.66532139838913
46660,"Valdosta, GA",2002,635,164,799,117554,6.79687632917638
46660,"Valdosta, GA",2003,793,257,1050,118006,8.89785265156009
46660,"Valdosta, GA",2004,937,500,1437,124387,11.5526542162766
46660,"Valdosta, GA",2005,1109,117,1226,126411,9.69852307156814
46660,"Valdosta, GA",2006,1259,203,1462,129323,11.3050269480294
46660,"Valdosta, GA",2007,1080,173,1253,131036,9.562257700174
46660,"Valdosta, GA",2008,702,144,846,134907,6.27098667971269
46660,"Valdosta, GA",2009,545,352,897,137780,6.51037886485702
46660,"Valdosta, GA",2010,499,353,852,140055,6.08332440826818
46660,"Valdosta, GA",2011,381,279,660,141991,4.64818192702354
46660,"Valdosta, GA",2012,357,6,363,144118,2.51876934178937
46660,"Valdosta, GA",2013,405,32,437,142944,3.05714125811507
46660,"Valdosta, GA",2014,384,26,410,143445,2.85823834919307
46660,"Valdosta, GA",2015,603,24,627,143329,4.37455085851433
46660,"Valdosta, GA",2016,934,84,1018,144470,7.04644562885028
46660,"Valdosta, GA",2017,988,101,1089,145403,7.48952910187548
46660,"Valdosta, GA",2018,1039,87,1126,146174,7.70314830270773
46700,"Vallejo-Fairfield, CA",1990,1763,551,2314,343451,6.73749676081886
46700,"Vallejo-Fairfield, CA",1991,1428,54,1482,354042,4.18594404053756
46700,"Vallejo-Fairfield, CA",1992,1735,174,1909,359802,5.30569591052857
46700,"Vallejo-Fairfield, CA",1993,1401,50,1451,364084,3.98534404148493
46700,"Vallejo-Fairfield, CA",1994,1395,118,1513,365856,4.13550686608939
46700,"Vallejo-Fairfield, CA",1995,952,63,1015,365133,2.77980900110371
46700,"Vallejo-Fairfield, CA",1996,1192,391,1583,367297,4.30986367980136
46700,"Vallejo-Fairfield, CA",1997,1431,86,1517,371524,4.08318170562332
46700,"Vallejo-Fairfield, CA",1998,1777,436,2213,378253,5.85058148910914
46700,"Vallejo-Fairfield, CA",1999,1493,518,2011,387202,5.19367152029173
46700,"Vallejo-Fairfield, CA",2000,2047,186,2233,396974,5.6250535299541
46700,"Vallejo-Fairfield, CA",2001,1825,743,2568,404209,6.3531489897553
46700,"Vallejo-Fairfield, CA",2002,1806,668,2474,408226,6.06036852135827
46700,"Vallejo-Fairfield, CA",2003,2050,592,2642,408409,6.46900533533786
46700,"Vallejo-Fairfield, CA",2004,2386,575,2961,409301,7.23428479285416
46700,"Vallejo-Fairfield, CA",2005,1962,392,2354,408181,5.76704942170263
46700,"Vallejo-Fairfield, CA",2006,1002,203,1205,408402,2.95052423837298
46700,"Vallejo-Fairfield, CA",2007,866,153,1019,408243,2.49606239421129
46700,"Vallejo-Fairfield, CA",2008,326,239,565,408972,1.38151267079409
46700,"Vallejo-Fairfield, CA",2009,586,0,586,410290,1.42825806137123
46700,"Vallejo-Fairfield, CA",2010,467,0,467,413944,1.12817192663742
46700,"Vallejo-Fairfield, CA",2011,387,0,387,416305,0.929606898788148
46700,"Vallejo-Fairfield, CA",2012,479,59,538,419699,1.2818710552086101
46700,"Vallejo-Fairfield, CA",2013,540,235,775,423749,1.82891287059084
46700,"Vallejo-Fairfield, CA",2014,646,0,646,429155,1.50528363877853
46700,"Vallejo-Fairfield, CA",2015,1036,398,1434,433708,3.30637202910714
46700,"Vallejo-Fairfield, CA",2016,827,117,944,439300,2.14887320737537
46700,"Vallejo-Fairfield, CA",2017,840,67,907,443877,2.04335885842249
46700,"Vallejo-Fairfield, CA",2018,954,36,990,446610,2.21669913347216
46740,"Valley, AL",1990,15,2,17,36882,0.460929450680549
46740,"Valley, AL",1991,8,0,8,36903,0.216784543262065
46740,"Valley, AL",1992,12,2,14,37026,0.378112677577918
46740,"Valley, AL",1993,13,2,15,36998,0.405427320395697
46740,"Valley, AL",1994,15,0,15,37030,0.405076964623278
46740,"Valley, AL",1995,16,4,20,37135,0.538575467887438
46740,"Valley, AL",1996,16,0,16,36856,0.434121988278706
46740,"Valley, AL",1997,28,56,84,36640,2.29257641921397
46740,"Valley, AL",1998,26,64,90,36742,2.44951281911709
46740,"Valley, AL",1999,18,0,18,36455,0.493759429433548
46740,"Valley, AL",2000,26,0,26,36571,0.710945831396462
46740,"Valley, AL",2001,22,0,22,36274,0.606495010200143
46740,"Valley, AL",2002,19,0,19,35965,0.528291394411233
46740,"Valley, AL",2003,11,0,11,35680,0.308295964125561
46740,"Valley, AL",2004,17,0,17,35463,0.4793728674957
46740,"Valley, AL",2005,14,0,14,35279,0.396836645029621
46740,"Valley, AL",2006,22,0,22,34945,0.629560738303048
46740,"Valley, AL",2007,24,729,753,34847,21.6087468074727
46740,"Valley, AL",2008,3,0,3,34563,0.0867980210051211
46740,"Valley, AL",2009,16,0,16,34384,0.465332712889716
46740,"Valley, AL",2010,10,0,10,34122,0.293066057089268
46740,"Valley, AL",2011,2,0,2,34030,0.0587716720540699
46740,"Valley, AL",2012,9,0,9,34104,0.263898662913441
46740,"Valley, AL",2013,4,0,4,34143,0.117154321530035
46740,"Valley, AL",2014,8,0,8,33980,0.235432607416127
46740,"Valley, AL",2015,4,0,4,34007,0.117622842355986
46740,"Valley, AL",2016,12,0,12,33771,0.355334458559119
46740,"Valley, AL",2017,3,0,3,33758,0.0888678239232182
46740,"Valley, AL",2018,15,0,15,33615,0.446229361892012
46780,"Van Wert, OH",1990,34,14,48,30431,1.57733889783445
46780,"Van Wert, OH",1991,52,12,64,30347,2.10893992816423
46780,"Van Wert, OH",1992,52,0,52,30267,1.71804275283312
46780,"Van Wert, OH",1993,59,0,59,30297,1.94738753011849
46780,"Van Wert, OH",1994,58,9,67,30374,2.20583393691973
46780,"Van Wert, OH",1995,79,4,83,30359,2.73395039362298
46780,"Van Wert, OH",1996,64,2,66,30300,2.17821782178218
46780,"Van Wert, OH",1997,66,2,68,30354,2.24023192989392
46780,"Van Wert, OH",1998,101,8,109,30032,3.62946190729888
46780,"Van Wert, OH",1999,92,0,92,30013,3.0653383533802
46780,"Van Wert, OH",2000,82,2,84,29627,2.83525162858204
46780,"Van Wert, OH",2001,70,2,72,29430,2.44648318042813
46780,"Van Wert, OH",2002,77,0,77,29327,2.62556688375899
46780,"Van Wert, OH",2003,95,0,95,29288,3.24364927615406
46780,"Van Wert, OH",2004,72,2,74,29322,2.52370233954028
46780,"Van Wert, OH",2005,67,0,67,29264,2.28950246036085
46780,"Van Wert, OH",2006,44,3,47,29342,1.6017994683389
46780,"Van Wert, OH",2007,38,4,42,29182,1.43924336920019
46780,"Van Wert, OH",2008,24,2,26,29075,0.894239036973345
46780,"Van Wert, OH",2009,28,0,28,28849,0.970570903670838
46780,"Van Wert, OH",2010,18,12,30,28677,1.04613453290093
46780,"Van Wert, OH",2011,20,46,66,28623,2.30583796247773
46780,"Van Wert, OH",2012,23,64,87,28635,3.03823991618648
46780,"Van Wert, OH",2013,14,0,14,28348,0.493862000846621
46780,"Van Wert, OH",2014,24,0,24,28332,0.847098686997035
46780,"Van Wert, OH",2015,17,0,17,28325,0.60017652250662
46780,"Van Wert, OH",2016,20,0,20,28177,0.709798772048124
46780,"Van Wert, OH",2017,18,2,20,28291,0.706938602382383
46780,"Van Wert, OH",2018,18,0,18,28281,0.636469714649411
46820,"Vermillion, SD",1990,18,26,44,13180,3.33839150227618
46820,"Vermillion, SD",1991,77,18,95,13171,7.21281603522891
46820,"Vermillion, SD",1992,29,27,56,13281,4.21654995858746
46820,"Vermillion, SD",1993,60,0,60,13463,4.45665899130952
46820,"Vermillion, SD",1994,26,89,115,13559,8.48145143447157
46820,"Vermillion, SD",1995,27,66,93,13611,6.8327088384395
46820,"Vermillion, SD",1996,23,17,40,13334,2.99985000749963
46820,"Vermillion, SD",1997,29,3,32,13224,2.41984271022384
46820,"Vermillion, SD",1998,25,0,25,13204,1.8933656467737
46820,"Vermillion, SD",1999,24,8,32,13170,2.42976461655277
46820,"Vermillion, SD",2000,41,8,49,13510,3.62694300518135
46820,"Vermillion, SD",2001,31,30,61,13627,4.47640713289792
46820,"Vermillion, SD",2002,31,0,31,13505,2.29544613106257
46820,"Vermillion, SD",2003,24,0,24,13536,1.77304964539007
46820,"Vermillion, SD",2004,31,66,97,13449,7.2124321510893
46820,"Vermillion, SD",2005,35,11,46,13517,3.40312199452541
46820,"Vermillion, SD",2006,39,49,88,13627,6.45776766713143
46820,"Vermillion, SD",2007,42,34,76,13785,5.51323902792891
46820,"Vermillion, SD",2008,29,20,49,13959,3.51028010602479
46820,"Vermillion, SD",2009,20,18,38,13846,2.74447493861043
46820,"Vermillion, SD",2010,20,20,40,13828,2.89268151576511
46820,"Vermillion, SD",2011,18,30,48,13980,3.43347639484979
46820,"Vermillion, SD",2012,24,46,70,14063,4.97760079641613
46820,"Vermillion, SD",2013,24,24,48,13893,3.45497732671129
46820,"Vermillion, SD",2014,20,28,48,13881,3.45796412362222
46820,"Vermillion, SD",2015,24,50,74,13764,5.37634408602151
46820,"Vermillion, SD",2016,38,8,46,13917,3.30531005245383
46820,"Vermillion, SD",2017,36,4,40,14021,2.85286356180016
46820,"Vermillion, SD",2018,30,243,273,14041,19.4430596111388
46860,"Vernal, UT",1990,8,0,8,22299,0.358760482532849
46860,"Vernal, UT",1991,19,0,19,22967,0.827273914747246
46860,"Vernal, UT",1992,21,0,21,23423,0.896554668488238
46860,"Vernal, UT",1993,25,0,25,23993,1.04197057475097
46860,"Vernal, UT",1994,50,0,50,24444,2.04549173621339
46860,"Vernal, UT",1995,5,0,5,24872,0.201029269861692
46860,"Vernal, UT",1996,27,0,27,24916,1.08364103387382
46860,"Vernal, UT",1997,58,0,58,25429,2.28086043493649
46860,"Vernal, UT",1998,89,4,93,25659,3.6244592540629
46860,"Vernal, UT",1999,85,33,118,25985,4.54108139311141
46860,"Vernal, UT",2000,119,2,121,25215,4.79873091413841
46860,"Vernal, UT",2001,106,16,122,25786,4.73124951524083
46860,"Vernal, UT",2002,107,0,107,26395,4.05379806781587
46860,"Vernal, UT",2003,103,0,103,26561,3.87786604420014
46860,"Vernal, UT",2004,137,0,137,26994,5.07520189671779
46860,"Vernal, UT",2005,215,14,229,27661,8.27880409240447
46860,"Vernal, UT",2006,427,44,471,28662,16.432907682646
46860,"Vernal, UT",2007,511,30,541,29920,18.081550802139
46860,"Vernal, UT",2008,380,224,604,31009,19.4782160018059
46860,"Vernal, UT",2009,96,0,96,32931,2.9151862986244
46860,"Vernal, UT",2010,63,8,71,32469,2.18670116110752
46860,"Vernal, UT",2011,163,98,261,33241,7.85174934568755
46860,"Vernal, UT",2012,551,130,681,34641,19.6587858318178
46860,"Vernal, UT",2013,201,120,321,35683,8.99588039122271
46860,"Vernal, UT",2014,230,92,322,36921,8.72132390780315
46860,"Vernal, UT",2015,85,0,85,37783,2.24968901357753
46860,"Vernal, UT",2016,25,0,25,36254,0.689579080929001
46860,"Vernal, UT",2017,32,0,32,35219,0.908600471336494
46860,"Vernal, UT",2018,53,0,53,35438,1.49556972741125
46900,"Vernon, TX",1990,2,0,2,15076,0.132661183337755
46900,"Vernon, TX",1991,2,0,2,14819,0.134961873270801
46900,"Vernon, TX",1992,4,0,4,14643,0.273168066653008
46900,"Vernon, TX",1993,2,28,30,14505,2.06825232678387
46900,"Vernon, TX",1994,6,0,6,14475,0.414507772020725
46900,"Vernon, TX",1995,2,0,2,14356,0.139314572304263
46900,"Vernon, TX",1996,10,0,10,14275,0.700525394045534
46900,"Vernon, TX",1997,4,0,4,14233,0.281037026628258
46900,"Vernon, TX",1998,5,0,5,14106,0.354459095420389
46900,"Vernon, TX",1999,5,112,117,14088,8.30494037478705
46900,"Vernon, TX",2000,3,0,3,14613,0.205296653664545
46900,"Vernon, TX",2001,5,0,5,14299,0.349674802433737
46900,"Vernon, TX",2002,2,0,2,14248,0.140370578326783
46900,"Vernon, TX",2003,4,0,4,14023,0.28524566783142
46900,"Vernon, TX",2004,63,0,63,13879,4.53923193313639
46900,"Vernon, TX",2005,0,0,0,13830,0
46900,"Vernon, TX",2006,4,0,4,13835,0.289121792555114
46900,"Vernon, TX",2007,2,44,46,13746,3.34642805179689
46900,"Vernon, TX",2008,2,0,2,13506,0.14808233377758
46900,"Vernon, TX",2009,1,0,1,13575,0.0736648250460405
46900,"Vernon, TX",2010,2,0,2,13511,0.148027533121161
46900,"Vernon, TX",2011,0,0,0,13454,0
46900,"Vernon, TX",2012,0,0,0,13293,0
46900,"Vernon, TX",2013,1,0,1,13207,0.0757174225789354
46900,"Vernon, TX",2014,2,0,2,12991,0.153952736509891
46900,"Vernon, TX",2015,2,0,2,13067,0.153057319966327
46900,"Vernon, TX",2016,1,0,1,12904,0.0774953502789833
46900,"Vernon, TX",2017,3,0,3,12747,0.235349493998588
46900,"Vernon, TX",2018,1,0,1,12820,0.078003120124805
46980,"Vicksburg, MS",1990,11,2,13,59153,0.219769073419776
46980,"Vicksburg, MS",1991,26,8,34,59422,0.572178654370435
46980,"Vicksburg, MS",1992,13,82,95,59087,1.60779866975815
46980,"Vicksburg, MS",1993,14,40,54,59413,0.908891993334792
46980,"Vicksburg, MS",1994,39,36,75,60294,1.24390486615584
46980,"Vicksburg, MS",1995,49,0,49,60496,0.809970907167416
46980,"Vicksburg, MS",1996,55,4,59,60620,0.973276146486308
46980,"Vicksburg, MS",1997,33,0,33,60832,0.542477643345608
46980,"Vicksburg, MS",1998,27,150,177,60802,2.9110884510378
46980,"Vicksburg, MS",1999,39,0,39,60638,0.643161054124476
46980,"Vicksburg, MS",2000,18,24,42,61390,0.684150513112885
46980,"Vicksburg, MS",2001,19,0,19,60811,0.312443472398086
46980,"Vicksburg, MS",2002,24,0,24,60392,0.397403629619817
46980,"Vicksburg, MS",2003,26,0,26,59835,0.434528286120164
46980,"Vicksburg, MS",2004,30,0,30,59864,0.501135908058265
46980,"Vicksburg, MS",2005,33,0,33,59482,0.554789684274234
46980,"Vicksburg, MS",2006,31,0,31,59798,0.518411987022977
46980,"Vicksburg, MS",2007,27,0,27,59125,0.456659619450317
46980,"Vicksburg, MS",2008,17,0,17,58397,0.291110844735175
46980,"Vicksburg, MS",2009,11,0,11,58370,0.188452972417338
46980,"Vicksburg, MS",2010,0,0,0,58415,0
46980,"Vicksburg, MS",2011,1,0,1,58095,0.0172131852999398
46980,"Vicksburg, MS",2012,0,0,0,57569,0
46980,"Vicksburg, MS",2013,2,36,38,57434,0.661629000243758
46980,"Vicksburg, MS",2014,7,0,7,57112,0.1225661857403
46980,"Vicksburg, MS",2015,3,0,3,56721,0.052890463849368
46980,"Vicksburg, MS",2016,2,0,2,56159,0.0356131697501736
46980,"Vicksburg, MS",2017,6,0,6,55805,0.107517247558463
46980,"Vicksburg, MS",2018,3,0,3,55178,0.0543694950886223
47020,"Victoria, TX",1990,107,0,107,80523,1.32881288575935
47020,"Victoria, TX",1991,129,0,129,81602,1.58084360677434
47020,"Victoria, TX",1992,161,0,161,82955,1.94081128322585
47020,"Victoria, TX",1993,185,0,185,84102,2.19970987610283
47020,"Victoria, TX",1994,202,0,202,79150,2.55211623499684
47020,"Victoria, TX",1995,172,0,172,79622,2.16020697797091
47020,"Victoria, TX",1996,160,14,174,80342,2.16574145527868
47020,"Victoria, TX",1997,189,160,349,80646,4.32755499342807
47020,"Victoria, TX",1998,212,324,536,81674,6.56267600460367
47020,"Victoria, TX",1999,196,2,198,82121,2.41107633857357
47020,"Victoria, TX",2000,167,0,167,83937,1.98958742866674
47020,"Victoria, TX",2001,144,0,144,84491,1.70432353741819
47020,"Victoria, TX",2002,212,0,212,84573,2.50671017937167
47020,"Victoria, TX",2003,117,0,117,84674,1.3817700829062
47020,"Victoria, TX",2004,138,260,398,84718,4.69793904483109
47020,"Victoria, TX",2005,123,0,123,84453,1.45643138787254
47020,"Victoria, TX",2006,143,0,143,84528,1.69174711338255
47020,"Victoria, TX",2007,103,0,103,85261,1.20805526559623
47020,"Victoria, TX",2008,59,0,59,85762,0.687950374291644
47020,"Victoria, TX",2009,46,0,46,86635,0.530963236567207
47020,"Victoria, TX",2010,47,0,47,86876,0.541000966895345
47020,"Victoria, TX",2011,83,0,83,87550,0.94802969731582
47020,"Victoria, TX",2012,111,32,143,89115,1.60466812545587
47020,"Victoria, TX",2013,122,342,464,90076,5.15120564856344
47020,"Victoria, TX",2014,163,672,835,91059,9.16987886974379
47020,"Victoria, TX",2015,139,0,139,99688,1.39435037316427
47020,"Victoria, TX",2016,65,0,65,99981,0.650123523469459
47020,"Victoria, TX",2017,61,0,61,99651,0.612136355882028
47020,"Victoria, TX",2018,70,0,70,99619,0.702677200132505
47080,"Vidalia, GA",1990,37,12,49,31511,1.55501253530513
47080,"Vidalia, GA",1991,20,0,20,31611,0.632691151814242
47080,"Vidalia, GA",1992,17,2,19,31969,0.59432575307329
47080,"Vidalia, GA",1993,19,0,19,32259,0.588982919495335
47080,"Vidalia, GA",1994,33,50,83,32305,2.5692617241913
47080,"Vidalia, GA",1995,73,12,85,32633,2.60472527809273
47080,"Vidalia, GA",1996,56,8,64,33106,1.93318431704223
47080,"Vidalia, GA",1997,57,8,65,33401,1.94604951947546
47080,"Vidalia, GA",1998,48,8,56,33497,1.67179150371675
47080,"Vidalia, GA",1999,59,2,61,33710,1.80955206170276
47080,"Vidalia, GA",2000,57,4,61,34371,1.77475197113846
47080,"Vidalia, GA",2001,64,6,70,34545,2.02634245187437
47080,"Vidalia, GA",2002,76,4,80,34563,2.3146138934699
47080,"Vidalia, GA",2003,122,64,186,34814,5.34267823289481
47080,"Vidalia, GA",2004,157,2,159,35206,4.51627563483497
47080,"Vidalia, GA",2005,117,5,122,35536,3.43313822602431
47080,"Vidalia, GA",2006,104,4,108,36016,2.998667258996
47080,"Vidalia, GA",2007,59,0,59,36360,1.62266226622662
47080,"Vidalia, GA",2008,50,14,64,36445,1.75607079160379
47080,"Vidalia, GA",2009,9,10,19,36215,0.524644484329698
47080,"Vidalia, GA",2010,20,10,30,36395,0.824289050693777
47080,"Vidalia, GA",2011,15,68,83,36235,2.2906030081413
47080,"Vidalia, GA",2012,17,12,29,36066,0.804081406310653
47080,"Vidalia, GA",2013,20,14,34,36154,0.940421530121148
47080,"Vidalia, GA",2014,16,18,34,36129,0.941072268814526
47080,"Vidalia, GA",2015,14,12,26,36114,0.719942404607631
47080,"Vidalia, GA",2016,22,12,34,36135,0.94091600940916
47080,"Vidalia, GA",2017,37,4,41,35964,1.1400289178067
47080,"Vidalia, GA",2018,21,12,33,36080,0.914634146341463
47180,"Vincennes, IN",1990,73,19,92,39768,2.31341782337558
47180,"Vincennes, IN",1991,62,6,68,39748,1.71077790077488
47180,"Vincennes, IN",1992,70,14,84,39977,2.10120819471196
47180,"Vincennes, IN",1993,83,44,127,39965,3.17778055798824
47180,"Vincennes, IN",1994,88,16,104,39910,2.60586319218241
47180,"Vincennes, IN",1995,89,33,122,39745,3.06956849918229
47180,"Vincennes, IN",1996,73,32,105,39548,2.65500151714372
47180,"Vincennes, IN",1997,64,19,83,39584,2.09680679062247
47180,"Vincennes, IN",1998,91,28,119,39243,3.03238794179854
47180,"Vincennes, IN",1999,72,78,150,38914,3.85465385208408
47180,"Vincennes, IN",2000,48,16,64,39195,1.63286133435387
47180,"Vincennes, IN",2001,63,20,83,38840,2.13697219361483
47180,"Vincennes, IN",2002,49,2,51,38832,1.31334981458591
47180,"Vincennes, IN",2003,39,0,39,38580,1.01088646967341
47180,"Vincennes, IN",2004,54,0,54,38712,1.3949163050217
47180,"Vincennes, IN",2005,52,0,52,38543,1.34914251615079
47180,"Vincennes, IN",2006,3,0,3,38399,0.0781270345581916
47180,"Vincennes, IN",2007,43,35,78,38325,2.03522504892368
47180,"Vincennes, IN",2008,39,2,41,38497,1.06501805335481
47180,"Vincennes, IN",2009,34,0,34,38499,0.883139821813554
47180,"Vincennes, IN",2010,15,2,17,38393,0.442789050087255
47180,"Vincennes, IN",2011,25,4,29,38470,0.753834156485573
47180,"Vincennes, IN",2012,29,4,33,37975,0.86899275839368
47180,"Vincennes, IN",2013,36,12,48,38055,1.2613322822231
47180,"Vincennes, IN",2014,26,8,34,37961,0.895656068069861
47180,"Vincennes, IN",2015,33,10,43,37763,1.13868071922252
47180,"Vincennes, IN",2016,39,6,45,37331,1.20543248238729
47180,"Vincennes, IN",2017,39,4,43,37094,1.15921712406319
47180,"Vincennes, IN",2018,33,4,37,36895,1.0028459140805
47220,"Vineland-Bridgeton, NJ",1990,260,34,294,138204,2.12729009290614
47220,"Vineland-Bridgeton, NJ",1991,235,12,247,139681,1.76831494619884
47220,"Vineland-Bridgeton, NJ",1992,226,14,240,140429,1.70904870076694
47220,"Vineland-Bridgeton, NJ",1993,292,8,300,141163,2.12520277976524
47220,"Vineland-Bridgeton, NJ",1994,317,6,323,141690,2.27962453242995
47220,"Vineland-Bridgeton, NJ",1995,264,139,403,141306,2.85196665392835
47220,"Vineland-Bridgeton, NJ",1996,306,10,316,141230,2.23748495362175
47220,"Vineland-Bridgeton, NJ",1997,362,88,450,140940,3.19284802043423
47220,"Vineland-Bridgeton, NJ",1998,314,102,416,140394,2.96308959072325
47220,"Vineland-Bridgeton, NJ",1999,291,80,371,140094,2.64822190814739
47220,"Vineland-Bridgeton, NJ",2000,226,29,255,146263,1.74343477161004
47220,"Vineland-Bridgeton, NJ",2001,250,6,256,146451,1.74802493666824
47220,"Vineland-Bridgeton, NJ",2002,297,13,310,147294,2.10463426887721
47220,"Vineland-Bridgeton, NJ",2003,364,10,374,148437,2.51958743439978
47220,"Vineland-Bridgeton, NJ",2004,564,2,566,149837,3.77743814945574
47220,"Vineland-Bridgeton, NJ",2005,597,33,630,152022,4.14413703279789
47220,"Vineland-Bridgeton, NJ",2006,693,44,737,153371,4.80534129659453
47220,"Vineland-Bridgeton, NJ",2007,572,111,683,154489,4.42102673976788
47220,"Vineland-Bridgeton, NJ",2008,331,5,336,155738,2.1574695963734
47220,"Vineland-Bridgeton, NJ",2009,222,40,262,156531,1.67378985632239
47220,"Vineland-Bridgeton, NJ",2010,231,15,246,156704,1.56983867674086
47220,"Vineland-Bridgeton, NJ",2011,182,0,182,157045,1.1589034989971
47220,"Vineland-Bridgeton, NJ",2012,185,5,190,156941,1.21064603895732
47220,"Vineland-Bridgeton, NJ",2013,214,5,219,156120,1.40276710222905
47220,"Vineland-Bridgeton, NJ",2014,182,30,212,156086,1.35822559358302
47220,"Vineland-Bridgeton, NJ",2015,185,52,237,154838,1.53063201539674
47220,"Vineland-Bridgeton, NJ",2016,114,20,134,153355,0.873789573212481
47220,"Vineland-Bridgeton, NJ",2017,88,0,88,151748,0.579908796162058
47220,"Vineland-Bridgeton, NJ",2018,70,4,74,150972,0.490157115226664
47240,"Vineyard Haven, MA",1990,236,0,236,11673,20.2175961620834
47240,"Vineyard Haven, MA",1991,204,0,204,11764,17.3410404624277
47240,"Vineyard Haven, MA",1992,173,45,218,11892,18.3316515304406
47240,"Vineyard Haven, MA",1993,219,0,219,12076,18.1351440874462
47240,"Vineyard Haven, MA",1994,228,0,228,12455,18.3059012444801
47240,"Vineyard Haven, MA",1995,234,0,234,12810,18.2669789227166
47240,"Vineyard Haven, MA",1996,229,0,229,13265,17.2634753109687
47240,"Vineyard Haven, MA",1997,222,6,228,13605,16.7585446527012
47240,"Vineyard Haven, MA",1998,257,0,257,13861,18.5412307914292
47240,"Vineyard Haven, MA",1999,309,0,309,14066,21.9678657756292
47240,"Vineyard Haven, MA",2000,219,27,246,15090,16.3021868787276
47240,"Vineyard Haven, MA",2001,195,0,195,15261,12.7776685669353
47240,"Vineyard Haven, MA",2002,210,0,210,15482,13.5641390001292
47240,"Vineyard Haven, MA",2003,237,2,239,15630,15.2911068458093
47240,"Vineyard Haven, MA",2004,255,0,255,15704,16.237901171676
47240,"Vineyard Haven, MA",2005,237,0,237,15743,15.0543098519977
47240,"Vineyard Haven, MA",2006,184,0,184,15768,11.6692034500254
47240,"Vineyard Haven, MA",2007,186,0,186,15919,11.684151014511
47240,"Vineyard Haven, MA",2008,119,5,124,16132,7.68658566823704
47240,"Vineyard Haven, MA",2009,107,0,107,16373,6.53514933121603
47240,"Vineyard Haven, MA",2010,113,0,113,16572,6.81873038860729
47240,"Vineyard Haven, MA",2011,89,0,89,16695,5.3309374064091
47240,"Vineyard Haven, MA",2012,90,0,90,16829,5.34791134351417
47240,"Vineyard Haven, MA",2013,106,0,106,17162,6.17643631278406
47240,"Vineyard Haven, MA",2014,114,6,120,17299,6.9368171570611
47240,"Vineyard Haven, MA",2015,106,17,123,17275,7.12011577424023
47240,"Vineyard Haven, MA",2016,117,4,121,17316,6.98775698775699
47240,"Vineyard Haven, MA",2017,134,6,140,17321,8.08267421049593
47240,"Vineyard Haven, MA",2018,132,2,134,17352,7.72245274319963
47260,"Virginia Beach-Norfolk-Newport News, VA-NC",1990,6524,2194,8718,1450926,6.00857659177656
47260,"Virginia Beach-Norfolk-Newport News, VA-NC",1991,6289,1514,7803,1472932,5.29759690196153
47260,"Virginia Beach-Norfolk-Newport News, VA-NC",1992,7723,1342,9065,1505941,6.01949213149785
47260,"Virginia Beach-Norfolk-Newport News, VA-NC",1993,7965,1789,9754,1527596,6.38519608587611
47260,"Virginia Beach-Norfolk-Newport News, VA-NC",1994,7253,1660,8913,1537951,5.79537319459463
47260,"Virginia Beach-Norfolk-Newport News, VA-NC",1995,6251,2421,8672,1545965,5.60944135216515
47260,"Virginia Beach-Norfolk-Newport News, VA-NC",1996,6564,1771,8335,1553778,5.36434419846336
47260,"Virginia Beach-Norfolk-Newport News, VA-NC",1997,6278,1325,7603,1559735,4.87454599659558
47260,"Virginia Beach-Norfolk-Newport News, VA-NC",1998,7098,1431,8529,1561236,5.46297933176022
47260,"Virginia Beach-Norfolk-Newport News, VA-NC",1999,7505,1510,9015,1573098,5.73073006258987
47260,"Virginia Beach-Norfolk-Newport News, VA-NC",2000,6517,930,7447,1584803,4.69900675352078
47260,"Virginia Beach-Norfolk-Newport News, VA-NC",2001,7105,1627,8732,1593489,5.47979935851455
47260,"Virginia Beach-Norfolk-Newport News, VA-NC",2002,7653,2527,10180,1608368,6.3293972523701
47260,"Virginia Beach-Norfolk-Newport News, VA-NC",2003,7793,2503,10296,1616332,6.36997844502243
47260,"Virginia Beach-Norfolk-Newport News, VA-NC",2004,7251,2892,10143,1642657,6.17475224590404
47260,"Virginia Beach-Norfolk-Newport News, VA-NC",2005,7627,3693,11320,1649013,6.86471240675483
47260,"Virginia Beach-Norfolk-Newport News, VA-NC",2006,5902,1809,7711,1665757,4.62912657728588
47260,"Virginia Beach-Norfolk-Newport News, VA-NC",2007,4760,1559,6319,1663563,3.79847351738407
47260,"Virginia Beach-Norfolk-Newport News, VA-NC",2008,3338,1811,5149,1662528,3.09709069561535
47260,"Virginia Beach-Norfolk-Newport News, VA-NC",2009,2995,2303,5298,1668443,3.17541564200875
47260,"Virginia Beach-Norfolk-Newport News, VA-NC",2010,3150,817,3967,1679795,2.36159769495683
47260,"Virginia Beach-Norfolk-Newport News, VA-NC",2011,2964,2605,5569,1685911,3.30325859431488
47260,"Virginia Beach-Norfolk-Newport News, VA-NC",2012,3531,1849,5380,1697056,3.17019591575057
47260,"Virginia Beach-Norfolk-Newport News, VA-NC",2013,4110,3273,7383,1704386,4.33176522219732
47260,"Virginia Beach-Norfolk-Newport News, VA-NC",2014,3766,1949,5715,1714136,3.3340411729291
47260,"Virginia Beach-Norfolk-Newport News, VA-NC",2015,4024,2698,6722,1719838,3.90850766176814
47260,"Virginia Beach-Norfolk-Newport News, VA-NC",2016,4095,2118,6213,1722419,3.60713624269124
47260,"Virginia Beach-Norfolk-Newport News, VA-NC",2017,4404,1778,6182,1724876,3.58402575025683
47260,"Virginia Beach-Norfolk-Newport News, VA-NC",2018,4168,1436,5604,1728733,3.24168046771827
47300,"Visalia-Porterville, CA",1990,1892,246,2138,313913,6.81080426742441
47300,"Visalia-Porterville, CA",1991,1680,310,1990,322936,6.16221170758293
47300,"Visalia-Porterville, CA",1992,1736,230,1966,330534,5.94795089158755
47300,"Visalia-Porterville, CA",1993,1563,231,1794,337159,5.32093166725492
47300,"Visalia-Porterville, CA",1994,1749,169,1918,342884,5.59372849126818
47300,"Visalia-Porterville, CA",1995,1386,328,1714,344671,4.97285817489722
47300,"Visalia-Porterville, CA",1996,1276,99,1375,346594,3.96717773533298
47300,"Visalia-Porterville, CA",1997,1198,145,1343,350100,3.83604684375893
47300,"Visalia-Porterville, CA",1998,1415,61,1476,354277,4.16623150811371
47300,"Visalia-Porterville, CA",1999,1539,97,1636,358385,4.56492319712042
47300,"Visalia-Porterville, CA",2000,1539,88,1627,368627,4.41367561247548
47300,"Visalia-Porterville, CA",2001,1695,77,1772,373171,4.7484933180767
47300,"Visalia-Porterville, CA",2002,1832,161,1993,379568,5.25070606584327
47300,"Visalia-Porterville, CA",2003,1962,308,2270,388743,5.83933344137386
47300,"Visalia-Porterville, CA",2004,2186,306,2492,398226,6.25775313515441
47300,"Visalia-Porterville, CA",2005,2944,373,3317,407970,8.13049979165135
47300,"Visalia-Porterville, CA",2006,2815,760,3575,414921,8.61609800419839
47300,"Visalia-Porterville, CA",2007,2254,435,2689,422140,6.36992466954091
47300,"Visalia-Porterville, CA",2008,1275,212,1487,429283,3.46391541244354
47300,"Visalia-Porterville, CA",2009,993,104,1097,436987,2.51037216210093
47300,"Visalia-Porterville, CA",2010,1085,282,1367,442994,3.08582057544797
47300,"Visalia-Porterville, CA",2011,718,204,922,446864,2.06326757134162
47300,"Visalia-Porterville, CA",2012,544,129,673,449975,1.49563864659148
47300,"Visalia-Porterville, CA",2013,870,76,946,452769,2.08936565886799
47300,"Visalia-Porterville, CA",2014,836,256,1092,455602,2.39682881111145
47300,"Visalia-Porterville, CA",2015,1129,146,1275,457803,2.78504072712499
47300,"Visalia-Porterville, CA",2016,1190,126,1316,460023,2.86072652889095
47300,"Visalia-Porterville, CA",2017,1162,152,1314,463097,2.83741851059281
47300,"Visalia-Porterville, CA",2018,1206,322,1528,465861,3.27994831076222
47340,"Wabash, IN",1990,51,12,63,35106,1.79456503161853
47340,"Wabash, IN",1991,66,14,80,34966,2.28793685294286
47340,"Wabash, IN",1992,83,50,133,34778,3.82425671401461
47340,"Wabash, IN",1993,88,18,106,34689,3.0557237164519
47340,"Wabash, IN",1994,96,4,100,34786,2.8747197148278
47340,"Wabash, IN",1995,124,23,147,34905,4.21143102707348
47340,"Wabash, IN",1996,123,24,147,34836,4.21977264898381
47340,"Wabash, IN",1997,123,26,149,34776,4.28456406717276
47340,"Wabash, IN",1998,74,64,138,34566,3.9923624370769
47340,"Wabash, IN",1999,99,3,102,34552,2.9520722389442
47340,"Wabash, IN",2000,88,0,88,34993,2.51478867202012
47340,"Wabash, IN",2001,101,0,101,34700,2.91066282420749
47340,"Wabash, IN",2002,123,0,123,34488,3.56645789839944
47340,"Wabash, IN",2003,78,8,86,34325,2.50546249089585
47340,"Wabash, IN",2004,74,2,76,34131,2.22671471682635
47340,"Wabash, IN",2005,55,0,55,33806,1.62693013074602
47340,"Wabash, IN",2006,39,0,39,33665,1.15847319174217
47340,"Wabash, IN",2007,57,4,61,33361,1.8284823596415
47340,"Wabash, IN",2008,18,0,18,33238,0.541548829652807
47340,"Wabash, IN",2009,34,0,34,33036,1.02918028817048
47340,"Wabash, IN",2010,23,0,23,32848,0.70019483682416
47340,"Wabash, IN",2011,23,0,23,32563,0.70632312747597
47340,"Wabash, IN",2012,20,0,20,32385,0.617569862590706
47340,"Wabash, IN",2013,24,0,24,32270,0.743724821815928
47340,"Wabash, IN",2014,24,0,24,32101,0.747640260428024
47340,"Wabash, IN",2015,20,0,20,31859,0.627766094353244
47340,"Wabash, IN",2016,28,0,28,31504,0.888776028440833
47340,"Wabash, IN",2017,35,0,35,31410,1.11429481056988
47340,"Wabash, IN",2018,21,4,25,31280,0.79923273657289
47380,"Waco, TX",1990,223,23,246,207276,1.18682336594685
47380,"Waco, TX",1991,261,284,545,208518,2.61368323118388
47380,"Waco, TX",1992,301,16,317,209441,1.5135527427772
47380,"Waco, TX",1993,371,6,377,211713,1.7807125684298999
47380,"Waco, TX",1994,413,88,501,215304,2.32694236985843
47380,"Waco, TX",1995,334,179,513,216682,2.36752475978623
47380,"Waco, TX",1996,370,77,447,219138,2.03981053035074
47380,"Waco, TX",1997,379,265,644,220311,2.92314046960887
47380,"Waco, TX",1998,403,433,836,221300,3.77767736104835
47380,"Waco, TX",1999,506,107,613,222072,2.76036600742102
47380,"Waco, TX",2000,532,178,710,232489,3.05390792682665
47380,"Waco, TX",2001,570,397,967,233379,4.14347477707934
47380,"Waco, TX",2002,542,267,809,234661,3.44752643174622
47380,"Waco, TX",2003,620,283,903,236830,3.81286154625681
47380,"Waco, TX",2004,797,753,1550,239419,6.47400582242846
47380,"Waco, TX",2005,1033,307,1340,240784,5.56515383081932
47380,"Waco, TX",2006,967,99,1066,242397,4.39774419650408
47380,"Waco, TX",2007,826,250,1076,244453,4.40166412357386
47380,"Waco, TX",2008,551,307,858,246735,3.47741504042799
47380,"Waco, TX",2009,428,250,678,249441,2.71807762156181
47380,"Waco, TX",2010,447,160,607,253812,2.39153389122658
47380,"Waco, TX",2011,443,82,525,255699,2.05319535860523
47380,"Waco, TX",2012,493,189,682,256964,2.65406827415513
47380,"Waco, TX",2013,619,65,684,258730,2.64368260348626
47380,"Waco, TX",2014,607,864,1471,260434,5.64826405154473
47380,"Waco, TX",2015,592,915,1507,262754,5.73540269605791
47380,"Waco, TX",2016,640,1125,1765,264960,6.66138285024155
47380,"Waco, TX",2017,768,239,1007,268550,3.74976726866505
47380,"Waco, TX",2018,764,86,850,271942,3.12566650241596
47420,"Wahpeton, ND-MN",1990,26,6,32,25644,1.24785524879114
47420,"Wahpeton, ND-MN",1991,28,3,31,25334,1.22365200915765
47420,"Wahpeton, ND-MN",1992,39,12,51,25299,2.01588995612475
47420,"Wahpeton, ND-MN",1993,41,6,47,25721,1.82730064927491
47420,"Wahpeton, ND-MN",1994,43,64,107,25668,4.16861461742247
47420,"Wahpeton, ND-MN",1995,40,12,52,25530,2.03681942812378
47420,"Wahpeton, ND-MN",1996,43,4,47,25621,1.8344326919324
47420,"Wahpeton, ND-MN",1997,52,130,182,25688,7.08502024291498
47420,"Wahpeton, ND-MN",1998,65,6,71,25445,2.79033208881902
47420,"Wahpeton, ND-MN",1999,66,16,82,25095,3.26758318390118
47420,"Wahpeton, ND-MN",2000,37,0,37,25062,1.47633868007342
47420,"Wahpeton, ND-MN",2001,38,24,62,24613,2.51899402754642
47420,"Wahpeton, ND-MN",2002,43,0,43,24404,1.76200622848713
47420,"Wahpeton, ND-MN",2003,40,2,42,24579,1.70877578420603
47420,"Wahpeton, ND-MN",2004,37,16,53,24311,2.18008308995928
47420,"Wahpeton, ND-MN",2005,51,58,109,24107,4.5215082756046
47420,"Wahpeton, ND-MN",2006,60,12,72,23578,3.05369412163882
47420,"Wahpeton, ND-MN",2007,55,0,55,23374,2.3530418413622
47420,"Wahpeton, ND-MN",2008,25,8,33,23110,1.42795326698399
47420,"Wahpeton, ND-MN",2009,21,24,45,22741,1.97880480189965
47420,"Wahpeton, ND-MN",2010,21,10,31,22917,1.35270759698041
47420,"Wahpeton, ND-MN",2011,28,8,36,22837,1.57638919297631
47420,"Wahpeton, ND-MN",2012,41,9,50,22815,2.19154065307911
47420,"Wahpeton, ND-MN",2013,42,0,42,22787,1.84315618554439
47420,"Wahpeton, ND-MN",2014,37,0,37,22808,1.62223781129428
47420,"Wahpeton, ND-MN",2015,44,0,44,22642,1.94329122869005
47420,"Wahpeton, ND-MN",2016,45,0,45,22612,1.99009375552804
47420,"Wahpeton, ND-MN",2017,45,24,69,22599,3.05323244391345
47420,"Wahpeton, ND-MN",2018,51,0,51,22493,2.26737207131107
47460,"Walla Walla, WA",1990,63,0,63,52530,1.19931467732724
47460,"Walla Walla, WA",1991,125,4,129,53919,2.39247760529683
47460,"Walla Walla, WA",1992,172,72,244,54718,4.45922731093973
47460,"Walla Walla, WA",1993,174,44,218,56052,3.88924570042104
47460,"Walla Walla, WA",1994,156,28,184,56866,3.23567685435937
47460,"Walla Walla, WA",1995,184,25,209,57351,3.64422590713327
47460,"Walla Walla, WA",1996,120,51,171,57638,2.9667927409001
47460,"Walla Walla, WA",1997,122,94,216,57759,3.73967693346491
47460,"Walla Walla, WA",1998,120,86,206,57785,3.56493899800986
47460,"Walla Walla, WA",1999,141,68,209,57898,3.60979653874054
47460,"Walla Walla, WA",2000,170,67,237,59247,4.00020254190086
47460,"Walla Walla, WA",2001,161,10,171,59106,2.8931072987514
47460,"Walla Walla, WA",2002,193,10,203,59661,3.40255778481755
47460,"Walla Walla, WA",2003,212,79,291,60111,4.84104406847332
47460,"Walla Walla, WA",2004,200,126,326,60679,5.37253415514428
47460,"Walla Walla, WA",2005,221,46,267,60543,4.41008869728953
47460,"Walla Walla, WA",2006,262,34,296,60600,4.88448844884488
47460,"Walla Walla, WA",2007,226,18,244,60737,4.01732057888931
47460,"Walla Walla, WA",2008,146,6,152,61218,2.48292985723153
47460,"Walla Walla, WA",2009,91,26,117,62080,1.88466494845361
47460,"Walla Walla, WA",2010,70,62,132,63014,2.09477259021805
47460,"Walla Walla, WA",2011,82,124,206,63448,3.24675324675325
47460,"Walla Walla, WA",2012,104,48,152,63317,2.40061910703287
47460,"Walla Walla, WA",2013,141,107,248,63380,3.91290627958346
47460,"Walla Walla, WA",2014,190,24,214,63520,3.36901763224181
47460,"Walla Walla, WA",2015,194,20,214,63937,3.347044747173
47460,"Walla Walla, WA",2016,184,36,220,64072,3.43363715819703
47460,"Walla Walla, WA",2017,148,0,148,64675,2.28836490143023
47460,"Walla Walla, WA",2018,225,0,225,64981,3.46255059171142
47540,"Wapakoneta, OH",1990,203,27,230,44694,5.14610462254441
47540,"Wapakoneta, OH",1991,177,13,190,45308,4.19351990818399
47540,"Wapakoneta, OH",1992,140,30,170,45885,3.7049144600632
47540,"Wapakoneta, OH",1993,186,7,193,46240,4.17387543252595
47540,"Wapakoneta, OH",1994,166,8,174,46438,3.74693139239416
47540,"Wapakoneta, OH",1995,148,15,163,46673,3.49238317656889
47540,"Wapakoneta, OH",1996,161,38,199,46945,4.23900308872084
47540,"Wapakoneta, OH",1997,154,18,172,46888,3.66831598703293
47540,"Wapakoneta, OH",1998,161,17,178,47020,3.78562313908975
47540,"Wapakoneta, OH",1999,171,26,197,47056,4.1865011900714
47540,"Wapakoneta, OH",2000,154,10,164,46186,3.55085956783441
47540,"Wapakoneta, OH",2001,139,0,139,46137,3.01276632637579
47540,"Wapakoneta, OH",2002,182,7,189,45943,4.1137931785038
47540,"Wapakoneta, OH",2003,165,35,200,45872,4.35995814440181
47540,"Wapakoneta, OH",2004,209,0,209,45932,4.5502046503527
47540,"Wapakoneta, OH",2005,174,16,190,46166,4.11558289650392
47540,"Wapakoneta, OH",2006,166,27,193,46034,4.19255333014728
47540,"Wapakoneta, OH",2007,134,8,142,45977,3.08850077212519
47540,"Wapakoneta, OH",2008,100,5,105,46167,2.27435180973423
47540,"Wapakoneta, OH",2009,60,7,67,45996,1.45664840420906
47540,"Wapakoneta, OH",2010,59,10,69,45930,1.50228608752449
47540,"Wapakoneta, OH",2011,55,3,58,45767,1.26728865776651
47540,"Wapakoneta, OH",2012,56,7,63,45797,1.37563595868725
47540,"Wapakoneta, OH",2013,54,6,60,45828,1.30924325739722
47540,"Wapakoneta, OH",2014,61,13,74,45766,1.61692085827907
47540,"Wapakoneta, OH",2015,98,10,108,45761,2.36008828478399
47540,"Wapakoneta, OH",2016,101,12,113,45800,2.46724890829694
47540,"Wapakoneta, OH",2017,120,73,193,45791,4.21480203533446
47540,"Wapakoneta, OH",2018,106,4,110,45804,2.40153698366955
47580,"Warner Robins, GA",1990,623,39,662,119045,5.56092234029149
47580,"Warner Robins, GA",1991,732,22,754,120722,6.24575470916652
47580,"Warner Robins, GA",1992,1015,16,1031,123212,8.36769145862416
47580,"Warner Robins, GA",1993,967,14,981,125787,7.79889813732739
47580,"Warner Robins, GA",1994,888,48,936,129002,7.25570146199284
47580,"Warner Robins, GA",1995,1026,172,1198,130421,9.1856372823395
47580,"Warner Robins, GA",1996,1224,253,1477,132813,11.1208993095555
47580,"Warner Robins, GA",1997,857,366,1223,135954,8.99568971858128
47580,"Warner Robins, GA",1998,877,200,1077,138567,7.77241334516876
47580,"Warner Robins, GA",1999,1108,441,1549,141004,10.9855039573345
47580,"Warner Robins, GA",2000,1319,390,1709,144820,11.8008562353266
47580,"Warner Robins, GA",2001,1683,534,2217,147377,15.0430528508519
47580,"Warner Robins, GA",2002,1568,18,1586,150927,10.5083914740239
47580,"Warner Robins, GA",2003,1697,174,1871,154342,12.1224294100115
47580,"Warner Robins, GA",2004,1917,332,2249,159187,14.1280380935629
47580,"Warner Robins, GA",2005,2058,140,2198,161847,13.5807274771852
47580,"Warner Robins, GA",2006,2002,456,2458,165671,14.8366340518256
47580,"Warner Robins, GA",2007,1436,289,1725,170285,10.1300760489767
47580,"Warner Robins, GA",2008,857,264,1121,173782,6.45061053503815
47580,"Warner Robins, GA",2009,739,108,847,176793,4.79091366739633
47580,"Warner Robins, GA",2010,738,0,738,180453,4.08970756928397
47580,"Warner Robins, GA",2011,615,120,735,183365,4.00839854934148
47580,"Warner Robins, GA",2012,640,12,652,185275,3.51909323977871
47580,"Warner Robins, GA",2013,642,284,926,186246,4.97191886000236
47580,"Warner Robins, GA",2014,659,121,780,187236,4.16586553867846
47580,"Warner Robins, GA",2015,748,300,1048,187664,5.58444880211442
47580,"Warner Robins, GA",2016,839,0,839,189755,4.4214908698058
47580,"Warner Robins, GA",2017,1016,180,1196,191227,6.25434692799657
47580,"Warner Robins, GA",2018,895,483,1378,193835,7.1091392163438
47620,"Warren, PA",1990,75,0,75,45024,1.66577825159915
47620,"Warren, PA",1991,78,24,102,45031,2.26510626013191
47620,"Warren, PA",1992,78,0,78,45021,1.73252482174985
47620,"Warren, PA",1993,91,2,93,45397,2.04859351939555
47620,"Warren, PA",1994,108,0,108,44745,2.41367750586658
47620,"Warren, PA",1995,89,0,89,44659,1.99287937481807
47620,"Warren, PA",1996,104,0,104,44522,2.33592381294641
47620,"Warren, PA",1997,87,0,87,44124,1.9717160728855
47620,"Warren, PA",1998,89,0,89,43785,2.03265958661642
47620,"Warren, PA",1999,73,0,73,43531,1.67696584043555
47620,"Warren, PA",2000,88,0,88,43716,2.01299295452466
47620,"Warren, PA",2001,102,0,102,43562,2.34149028970203
47620,"Warren, PA",2002,99,2,101,43184,2.33882919599852
47620,"Warren, PA",2003,73,0,73,42896,1.7017903767251
47620,"Warren, PA",2004,137,32,169,42667,3.96090655541754
47620,"Warren, PA",2005,43,24,67,42218,1.58700080534369
47620,"Warren, PA",2006,63,15,78,41972,1.85838177832841
47620,"Warren, PA",2007,48,20,68,41963,1.62047518051617
47620,"Warren, PA",2008,36,0,36,41853,0.860153394021934
47620,"Warren, PA",2009,27,0,27,41831,0.645454328129856
47620,"Warren, PA",2010,32,0,32,41771,0.766081731344713
47620,"Warren, PA",2011,26,0,26,41501,0.626490927929447
47620,"Warren, PA",2012,30,0,30,41258,0.727131707790004
47620,"Warren, PA",2013,18,0,18,40953,0.4395282396894
47620,"Warren, PA",2014,19,0,19,40655,0.467347189767556
47620,"Warren, PA",2015,22,0,22,40327,0.545540208793116
47620,"Warren, PA",2016,34,0,34,40017,0.849638903466027
47620,"Warren, PA",2017,20,2,22,39677,0.554477405045744
47620,"Warren, PA",2018,18,0,18,39498,0.455719276925414
47660,"Warrensburg, MO",1990,79,22,101,42636,2.36889013978797
47660,"Warrensburg, MO",1991,74,108,182,43145,4.21833352648047
47660,"Warrensburg, MO",1992,65,83,148,43729,3.3844816940703
47660,"Warrensburg, MO",1993,87,144,231,44950,5.13904338153504
47660,"Warrensburg, MO",1994,111,38,149,45961,3.2418789843563
47660,"Warrensburg, MO",1995,56,56,112,46598,2.4035366324735
47660,"Warrensburg, MO",1996,76,36,112,46458,2.41077962891214
47660,"Warrensburg, MO",1997,53,44,97,47182,2.05586876351151
47660,"Warrensburg, MO",1998,68,43,111,47717,2.32621497579479
47660,"Warrensburg, MO",1999,57,143,200,48069,4.16068568100023
47660,"Warrensburg, MO",2000,49,24,73,48534,1.50410021840359
47660,"Warrensburg, MO",2001,63,89,152,49355,3.07972849761929
47660,"Warrensburg, MO",2002,69,83,152,49796,3.05245401237047
47660,"Warrensburg, MO",2003,87,159,246,50027,4.9173446338977
47660,"Warrensburg, MO",2004,123,110,233,50905,4.5771535212650996
47660,"Warrensburg, MO",2005,147,52,199,51178,3.88838954238149
47660,"Warrensburg, MO",2006,255,80,335,51500,6.50485436893204
47660,"Warrensburg, MO",2007,130,186,316,51750,6.10628019323671
47660,"Warrensburg, MO",2008,36,2,38,51889,0.732332478945441
47660,"Warrensburg, MO",2009,65,24,89,52351,1.70006303604516
47660,"Warrensburg, MO",2010,60,50,110,52716,2.08665300857425
47660,"Warrensburg, MO",2011,53,42,95,53321,1.78166200933966
47660,"Warrensburg, MO",2012,61,44,105,54150,1.93905817174515
47660,"Warrensburg, MO",2013,58,56,114,54166,2.10464128789277
47660,"Warrensburg, MO",2014,19,56,75,54035,1.38798926621634
47660,"Warrensburg, MO",2015,30,227,257,53497,4.80400770136643
47660,"Warrensburg, MO",2016,24,32,56,53501,1.0467094073008
47660,"Warrensburg, MO",2017,35,54,89,53759,1.65553674733533
47660,"Warrensburg, MO",2018,34,11,45,53652,0.838738537239991
47700,"Warsaw, IN",1990,326,30,356,65375,5.44550669216061
47700,"Warsaw, IN",1991,329,0,329,65376,5.03242780225159
47700,"Warsaw, IN",1992,395,105,500,65888,7.58863525983487
47700,"Warsaw, IN",1993,369,20,389,66741,5.82850122113843
47700,"Warsaw, IN",1994,386,20,406,67846,5.9841405536067
47700,"Warsaw, IN",1995,426,47,473,68945,6.86054101095076
47700,"Warsaw, IN",1996,505,16,521,69678,7.47725250437728
47700,"Warsaw, IN",1997,456,205,661,70439,9.38400601939267
47700,"Warsaw, IN",1998,431,22,453,71136,6.36808367071525
47700,"Warsaw, IN",1999,436,65,501,71417,7.01513645210524
47700,"Warsaw, IN",2000,403,30,433,74211,5.83471453019094
47700,"Warsaw, IN",2001,411,64,475,74756,6.35400502969661
47700,"Warsaw, IN",2002,438,291,729,74861,9.73804784867955
47700,"Warsaw, IN",2003,481,105,586,75176,7.79504097052251
47700,"Warsaw, IN",2004,471,28,499,75447,6.61391440348854
47700,"Warsaw, IN",2005,439,108,547,75934,7.20362419996313
47700,"Warsaw, IN",2006,391,110,501,76358,6.56119856465596
47700,"Warsaw, IN",2007,297,120,417,76832,5.4274260724698
47700,"Warsaw, IN",2008,212,24,236,77091,3.06131714467318
47700,"Warsaw, IN",2009,172,28,200,77263,2.58856114828573
47700,"Warsaw, IN",2010,155,38,193,77341,2.49544226218952
47700,"Warsaw, IN",2011,141,84,225,77347,2.90896867363957
47700,"Warsaw, IN",2012,124,101,225,77605,2.89929772566201
47700,"Warsaw, IN",2013,148,114,262,77870,3.36458199563375
47700,"Warsaw, IN",2014,133,128,261,78382,3.32984613814396
47700,"Warsaw, IN",2015,165,100,265,78553,3.37351851616106
47700,"Warsaw, IN",2016,171,110,281,78742,3.56861649437403
47700,"Warsaw, IN",2017,179,98,277,79010,3.50588533097076
47700,"Warsaw, IN",2018,234,90,324,79344,4.08348457350272
47780,"Washington, IN",1990,22,25,47,27565,1.70506076546345
47780,"Washington, IN",1991,24,6,30,27708,1.0827197921178
47780,"Washington, IN",1992,23,2,25,27858,0.897408284873286
47780,"Washington, IN",1993,23,0,23,28040,0.820256776034237
47780,"Washington, IN",1994,22,24,46,28152,1.63398692810458
47780,"Washington, IN",1995,24,7,31,28496,1.08787198203257
47780,"Washington, IN",1996,29,4,33,28638,1.15231510580348
47780,"Washington, IN",1997,23,9,32,28841,1.10953156964044
47780,"Washington, IN",1998,24,0,24,28910,0.830162573503978
47780,"Washington, IN",1999,26,0,26,28997,0.896644480463496
47780,"Washington, IN",2000,22,0,22,29882,0.73622916806104
47780,"Washington, IN",2001,17,0,17,29755,0.571332549151403
47780,"Washington, IN",2002,14,0,14,29860,0.468854655056932
47780,"Washington, IN",2003,17,0,17,30108,0.564633984323104
47780,"Washington, IN",2004,21,0,21,30300,0.693069306930693
47780,"Washington, IN",2005,18,0,18,30452,0.591094181006174
47780,"Washington, IN",2006,97,0,97,30469,3.18356362204208
47780,"Washington, IN",2007,15,0,15,30702,0.488567520031268
47780,"Washington, IN",2008,13,49,62,30947,2.00342521084435
47780,"Washington, IN",2009,8,0,8,31389,0.254866354455382
47780,"Washington, IN",2010,30,12,42,31720,1.32408575031526
47780,"Washington, IN",2011,19,22,41,31948,1.28333542005759
47780,"Washington, IN",2012,15,0,15,32117,0.467042376311611
47780,"Washington, IN",2013,13,10,23,32282,0.712471346261074
47780,"Washington, IN",2014,0,4,4,32681,0.122395275542364
47780,"Washington, IN",2015,0,6,6,32811,0.182865502422968
47780,"Washington, IN",2016,0,4,4,32972,0.12131505519835
47780,"Washington, IN",2017,23,0,23,33074,0.695410292072323
47780,"Washington, IN",2018,20,4,24,33147,0.724047425106344
47820,"Washington, NC",1990,149,9,158,42377,3.72843759586568
47820,"Washington, NC",1991,118,13,131,42688,3.06877811094453
47820,"Washington, NC",1992,121,71,192,42972,4.46802569114772
47820,"Washington, NC",1993,110,0,110,43388,2.53526320641652
47820,"Washington, NC",1994,138,2,140,43735,3.20109751914942
47820,"Washington, NC",1995,165,25,190,43953,4.32279935385525
47820,"Washington, NC",1996,157,44,201,43960,4.57233848953594
47820,"Washington, NC",1997,184,20,204,44212,4.61413190988872
47820,"Washington, NC",1998,203,116,319,44529,7.1638707359249
47820,"Washington, NC",1999,231,66,297,45123,6.58200917492188
47820,"Washington, NC",2000,190,0,190,44950,4.22691879866518
47820,"Washington, NC",2001,214,0,214,45084,4.74669505811374
47820,"Washington, NC",2002,221,0,221,45216,4.88765038924275
47820,"Washington, NC",2003,205,9,214,45418,4.71178827777533
47820,"Washington, NC",2004,219,36,255,45618,5.58989872418782
47820,"Washington, NC",2005,199,117,316,46059,6.86076553985106
47820,"Washington, NC",2006,178,40,218,46622,4.67590407961906
47820,"Washington, NC",2007,197,43,240,46702,5.13896621129716
47820,"Washington, NC",2008,163,12,175,47297,3.70002325728905
47820,"Washington, NC",2009,171,0,171,47485,3.60113720122144
47820,"Washington, NC",2010,211,0,211,47807,4.41357960131362
47820,"Washington, NC",2011,244,64,308,47655,6.46312034414017
47820,"Washington, NC",2012,317,64,381,47418,8.03492344679236
47820,"Washington, NC",2013,165,0,165,47372,3.48307016803175
47820,"Washington, NC",2014,142,28,170,47328,3.59195402298851
47820,"Washington, NC",2015,148,0,148,47385,3.12335127149942
47820,"Washington, NC",2016,216,0,216,47370,4.5598480050665
47820,"Washington, NC",2017,179,0,179,47051,3.80438247858707
47820,"Washington, NC",2018,140,0,140,47079,2.97372501539965
47900,"Washington-Arlington-Alexandria, DC-VA-MD-WV",1990,18569,8745,27314,4170589,6.54919484993606
47900,"Washington-Arlington-Alexandria, DC-VA-MD-WV",1991,17020,3106,20126,4221419,4.76759118201723
47900,"Washington-Arlington-Alexandria, DC-VA-MD-WV",1992,23136,2936,26072,4275344,6.09822273950353
47900,"Washington-Arlington-Alexandria, DC-VA-MD-WV",1993,26261,3947,30208,4326350,6.98232921515827
47900,"Washington-Arlington-Alexandria, DC-VA-MD-WV",1994,25828,5226,31054,4375544,7.09717465988229
47900,"Washington-Arlington-Alexandria, DC-VA-MD-WV",1995,22274,6090,28364,4419231,6.418311240123
47900,"Washington-Arlington-Alexandria, DC-VA-MD-WV",1996,22589,7601,30190,4469538,6.75461311661295
47900,"Washington-Arlington-Alexandria, DC-VA-MD-WV",1997,22938,6931,29869,4524042,6.60228176484657
47900,"Washington-Arlington-Alexandria, DC-VA-MD-WV",1998,28045,8778,36823,4583602,8.03363817364597
47900,"Washington-Arlington-Alexandria, DC-VA-MD-WV",1999,27721,9240,36961,4663371,7.9258116070971
47900,"Washington-Arlington-Alexandria, DC-VA-MD-WV",2000,28891,9336,38227,4863388,7.86015839163974
47900,"Washington-Arlington-Alexandria, DC-VA-MD-WV",2001,27637,9660,37297,4970350,7.50389811582685
47900,"Washington-Arlington-Alexandria, DC-VA-MD-WV",2002,28440,10633,39073,5055829,7.72830726672124
47900,"Washington-Arlington-Alexandria, DC-VA-MD-WV",2003,28753,7903,36656,5124633,7.1529024615031
47900,"Washington-Arlington-Alexandria, DC-VA-MD-WV",2004,28234,11276,39510,5199870,7.59826687974892
47900,"Washington-Arlington-Alexandria, DC-VA-MD-WV",2005,27460,10878,38338,5273577,7.26982842954602
47900,"Washington-Arlington-Alexandria, DC-VA-MD-WV",2006,19722,9502,29224,5318889,5.49438049938624
47900,"Washington-Arlington-Alexandria, DC-VA-MD-WV",2007,15320,7908,23228,5372905,4.32317340433155
47900,"Washington-Arlington-Alexandria, DC-VA-MD-WV",2008,9466,4411,13877,5445083,2.54853782761438
47900,"Washington-Arlington-Alexandria, DC-VA-MD-WV",2009,9032,3375,12407,5547895,2.2363436943201
47900,"Washington-Arlington-Alexandria, DC-VA-MD-WV",2010,9597,3577,13174,5665061,2.32548246170694
47900,"Washington-Arlington-Alexandria, DC-VA-MD-WV",2011,9795,10015,19810,5768757,3.43401533467262
47900,"Washington-Arlington-Alexandria, DC-VA-MD-WV",2012,11145,11424,22569,5865970,3.8474455205192
47900,"Washington-Arlington-Alexandria, DC-VA-MD-WV",2013,13498,10759,24257,5950951,4.07615522292151
47900,"Washington-Arlington-Alexandria, DC-VA-MD-WV",2014,12411,12393,24804,6020449,4.11995849479001
47900,"Washington-Arlington-Alexandria, DC-VA-MD-WV",2015,12638,10369,23007,6082465,3.78251251754017
47900,"Washington-Arlington-Alexandria, DC-VA-MD-WV",2016,13384,12303,25687,6139035,4.18420810436819
47900,"Washington-Arlington-Alexandria, DC-VA-MD-WV",2017,14225,13040,27265,6200001,4.3975799358742
47900,"Washington-Arlington-Alexandria, DC-VA-MD-WV",2018,13588,12169,25757,6249950,4.12115296922375
47920,"Washington Court House, OH",1990,37,16,53,27500,1.92727272727273
47920,"Washington Court House, OH",1991,66,4,70,27777,2.52007056197574
47920,"Washington Court House, OH",1992,61,0,61,27841,2.19101325383427
47920,"Washington Court House, OH",1993,68,13,81,28081,2.88451265980556
47920,"Washington Court House, OH",1994,94,2,96,28199,3.40437604170361
47920,"Washington Court House, OH",1995,88,24,112,28231,3.96727002231589
47920,"Washington Court House, OH",1996,83,15,98,28468,3.44246171139525
47920,"Washington Court House, OH",1997,85,57,142,28530,4.97721696459867
47920,"Washington Court House, OH",1998,99,20,119,28500,4.17543859649123
47920,"Washington Court House, OH",1999,152,6,158,28374,5.56847818425319
47920,"Washington Court House, OH",2000,105,0,105,28495,3.68485699245482
47920,"Washington Court House, OH",2001,93,2,95,28310,3.35570469798658
47920,"Washington Court House, OH",2002,132,0,132,28370,4.6528022559041204
47920,"Washington Court House, OH",2003,94,6,100,28450,3.51493848857645
47920,"Washington Court House, OH",2004,144,18,162,28470,5.69020021074816
47920,"Washington Court House, OH",2005,131,50,181,28695,6.3077191148283704
47920,"Washington Court House, OH",2006,169,2,171,28791,5.93935604876524
47920,"Washington Court House, OH",2007,61,20,81,28908,2.80199252801993
47920,"Washington Court House, OH",2008,28,12,40,28896,1.38427464008859
47920,"Washington Court House, OH",2009,35,3,38,28929,1.31356078675378
47920,"Washington Court House, OH",2010,23,0,23,29017,0.792638797946032
47920,"Washington Court House, OH",2011,20,0,20,28865,0.692880651307812
47920,"Washington Court House, OH",2012,20,0,20,28765,0.695289414218669
47920,"Washington Court House, OH",2013,21,18,39,28683,1.35969040895304
47920,"Washington Court House, OH",2014,22,0,22,28647,0.767968722728383
47920,"Washington Court House, OH",2015,24,22,46,28598,1.60850409119519
47920,"Washington Court House, OH",2016,29,4,33,28658,1.15151092190662
47920,"Washington Court House, OH",2017,38,0,38,28655,1.3261210957948
47920,"Washington Court House, OH",2018,32,2,34,28666,1.18607409474639
47940,"Waterloo-Cedar Falls, IA",1990,194,52,246,158822,1.54890380425886
47940,"Waterloo-Cedar Falls, IA",1991,233,58,291,159460,1.82490906810485
47940,"Waterloo-Cedar Falls, IA",1992,232,84,316,159404,1.98238438182229
47940,"Waterloo-Cedar Falls, IA",1993,202,172,374,159515,2.3446070902423
47940,"Waterloo-Cedar Falls, IA",1994,242,110,352,158893,2.21532729572731
47940,"Waterloo-Cedar Falls, IA",1995,221,99,320,158053,2.02463730520775
47940,"Waterloo-Cedar Falls, IA",1996,227,198,425,157878,2.69195201358011
47940,"Waterloo-Cedar Falls, IA",1997,210,137,347,156978,2.21050083451184
47940,"Waterloo-Cedar Falls, IA",1998,256,227,483,156601,3.0842714925192
47940,"Waterloo-Cedar Falls, IA",1999,290,45,335,155983,2.14766993839072
47940,"Waterloo-Cedar Falls, IA",2000,397,180,577,163699,3.52476191057978
47940,"Waterloo-Cedar Falls, IA",2001,378,285,663,163590,4.05281496423987
47940,"Waterloo-Cedar Falls, IA",2002,413,217,630,162634,3.87372874060775
47940,"Waterloo-Cedar Falls, IA",2003,505,185,690,162388,4.2490824445156
47940,"Waterloo-Cedar Falls, IA",2004,598,87,685,162793,4.20779763257634
47940,"Waterloo-Cedar Falls, IA",2005,555,180,735,163260,4.50202131569276
47940,"Waterloo-Cedar Falls, IA",2006,521,124,645,163976,3.93350246377519
47940,"Waterloo-Cedar Falls, IA",2007,436,30,466,164310,2.83610248919725
47940,"Waterloo-Cedar Falls, IA",2008,338,12,350,165724,2.11194516183534
47940,"Waterloo-Cedar Falls, IA",2009,346,14,360,167225,2.15278815966512
47940,"Waterloo-Cedar Falls, IA",2010,369,22,391,167925,2.32842042578532
47940,"Waterloo-Cedar Falls, IA",2011,346,64,410,168429,2.43426013334996
47940,"Waterloo-Cedar Falls, IA",2012,386,223,609,168806,3.60769166972738
47940,"Waterloo-Cedar Falls, IA",2013,345,86,431,169852,2.53750323811318
47940,"Waterloo-Cedar Falls, IA",2014,334,73,407,170459,2.38767093553288
47940,"Waterloo-Cedar Falls, IA",2015,328,86,414,170855,2.42310731321881
47940,"Waterloo-Cedar Falls, IA",2016,357,194,551,170139,3.23852849728751
47940,"Waterloo-Cedar Falls, IA",2017,304,404,708,169553,4.17568547887681
47940,"Waterloo-Cedar Falls, IA",2018,261,74,335,169659,1.9745489481843
47980,"Watertown, SD",1990,91,22,113,22782,4.96005618470723
47980,"Watertown, SD",1991,92,42,134,22955,5.83750816815509
47980,"Watertown, SD",1992,153,74,227,23308,9.73914535781706
47980,"Watertown, SD",1993,135,76,211,23984,8.79753168779186
47980,"Watertown, SD",1994,105,23,128,24531,5.21788757082875
47980,"Watertown, SD",1995,108,74,182,24822,7.33220530174845
47980,"Watertown, SD",1996,132,72,204,25102,8.1268424826707
47980,"Watertown, SD",1997,87,8,95,25452,3.73251610875373
47980,"Watertown, SD",1998,87,6,93,25443,3.65522933616319
47980,"Watertown, SD",1999,95,6,101,25403,3.97590835728064
47980,"Watertown, SD",2000,103,6,109,25950,4.20038535645472
47980,"Watertown, SD",2001,96,8,104,26033,3.99492951254177
47980,"Watertown, SD",2002,143,6,149,26100,5.7088122605364
47980,"Watertown, SD",2003,137,14,151,26184,5.76688053773297
47980,"Watertown, SD",2004,128,28,156,26254,5.9419517025977
47980,"Watertown, SD",2005,136,10,146,26364,5.53785465028069
47980,"Watertown, SD",2006,118,18,136,26754,5.08335202212753
47980,"Watertown, SD",2007,123,10,133,27036,4.91936677023228
47980,"Watertown, SD",2008,69,4,73,27043,2.69940465185076
47980,"Watertown, SD",2009,75,23,98,27137,3.61130559752368
47980,"Watertown, SD",2010,57,2,59,27212,2.16816110539468
47980,"Watertown, SD",2011,51,50,101,27427,3.68250264338061
47980,"Watertown, SD",2012,84,24,108,27621,3.91006842619746
47980,"Watertown, SD",2013,117,30,147,27859,5.27657130550271
47980,"Watertown, SD",2014,73,76,149,27949,5.33113886006655
47980,"Watertown, SD",2015,80,40,120,27886,4.30323459800617
47980,"Watertown, SD",2016,40,28,68,28031,2.42588562662766
47980,"Watertown, SD",2017,72,57,129,28083,4.59352633265677
47980,"Watertown, SD",2018,65,114,179,28015,6.38943423166161
48020,"Watertown-Fort Atkinson, WI",1990,242,74,316,67994,4.6474688943142
48020,"Watertown-Fort Atkinson, WI",1991,270,163,433,68388,6.33152014973387
48020,"Watertown-Fort Atkinson, WI",1992,311,97,408,68963,5.91621594188188
48020,"Watertown-Fort Atkinson, WI",1993,382,236,618,70051,8.82214386661147
48020,"Watertown-Fort Atkinson, WI",1994,363,293,656,71608,9.16098759915093
48020,"Watertown-Fort Atkinson, WI",1995,400,238,638,72779,8.766264994023
48020,"Watertown-Fort Atkinson, WI",1996,407,338,745,73000,10.2054794520548
48020,"Watertown-Fort Atkinson, WI",1997,331,249,580,73296,7.9131194062431804
48020,"Watertown-Fort Atkinson, WI",1998,399,210,609,73570,8.27783063748811
48020,"Watertown-Fort Atkinson, WI",1999,379,172,551,73928,7.45319770587599
48020,"Watertown-Fort Atkinson, WI",2000,406,171,577,76053,7.58681445833826
48020,"Watertown-Fort Atkinson, WI",2001,388,176,564,76736,7.34987489574645
48020,"Watertown-Fort Atkinson, WI",2002,366,271,637,77376,8.23252688172043
48020,"Watertown-Fort Atkinson, WI",2003,390,103,493,78148,6.30854276500998
48020,"Watertown-Fort Atkinson, WI",2004,481,304,785,79408,9.88565383840419
48020,"Watertown-Fort Atkinson, WI",2005,439,181,620,80392,7.71221017016619
48020,"Watertown-Fort Atkinson, WI",2006,334,100,434,81300,5.33825338253383
48020,"Watertown-Fort Atkinson, WI",2007,256,80,336,82276,4.08381545043512
48020,"Watertown-Fort Atkinson, WI",2008,177,26,203,83140,2.44166466201588
48020,"Watertown-Fort Atkinson, WI",2009,160,10,170,83480,2.03641590800192
48020,"Watertown-Fort Atkinson, WI",2010,134,60,194,83719,2.31727564829967
48020,"Watertown-Fort Atkinson, WI",2011,83,2,85,83830,1.01395681736848
48020,"Watertown-Fort Atkinson, WI",2012,84,2,86,84351,1.01954926438335
48020,"Watertown-Fort Atkinson, WI",2013,107,66,173,84605,2.04479640683175
48020,"Watertown-Fort Atkinson, WI",2014,103,6,109,84369,1.29194372340552
48020,"Watertown-Fort Atkinson, WI",2015,136,106,242,84503,2.86380365194135
48020,"Watertown-Fort Atkinson, WI",2016,181,28,209,84485,2.47381191927561
48020,"Watertown-Fort Atkinson, WI",2017,191,22,213,84775,2.51253317605426
48020,"Watertown-Fort Atkinson, WI",2018,169,68,237,85129,2.78401014930282
48060,"Watertown-Fort Drum, NY",1990,199,47,246,111464,2.20699059786119
48060,"Watertown-Fort Drum, NY",1991,190,0,190,112480,1.68918918918919
48060,"Watertown-Fort Drum, NY",1992,192,42,234,113677,2.05846389331175
48060,"Watertown-Fort Drum, NY",1993,148,0,148,113738,1.30123617436565
48060,"Watertown-Fort Drum, NY",1994,176,0,176,115423,1.52482607452587
48060,"Watertown-Fort Drum, NY",1995,169,0,169,113526,1.48864577277452
48060,"Watertown-Fort Drum, NY",1996,130,0,130,112420,1.15637786870664
48060,"Watertown-Fort Drum, NY",1997,108,44,152,110583,1.3745331560909
48060,"Watertown-Fort Drum, NY",1998,157,4,161,109753,1.46693028892149
48060,"Watertown-Fort Drum, NY",1999,142,2,144,108969,1.32147675026843
48060,"Watertown-Fort Drum, NY",2000,164,0,164,111790,1.46703640754987
48060,"Watertown-Fort Drum, NY",2001,198,0,198,111422,1.77702787600294
48060,"Watertown-Fort Drum, NY",2002,215,0,215,111112,1.93498452012384
48060,"Watertown-Fort Drum, NY",2003,252,3,255,110246,2.31300908876513
48060,"Watertown-Fort Drum, NY",2004,222,6,228,109924,2.07416032895455
48060,"Watertown-Fort Drum, NY",2005,369,26,395,113486,3.48060553724688
48060,"Watertown-Fort Drum, NY",2006,413,42,455,113650,4.00351957765068
48060,"Watertown-Fort Drum, NY",2007,634,47,681,115059,5.91870257867703
48060,"Watertown-Fort Drum, NY",2008,518,8,526,115033,4.57260090582702
48060,"Watertown-Fort Drum, NY",2009,189,0,189,115023,1.64314963094338
48060,"Watertown-Fort Drum, NY",2010,205,86,291,116594,2.49584026622296
48060,"Watertown-Fort Drum, NY",2011,209,84,293,117769,2.48792126960406
48060,"Watertown-Fort Drum, NY",2012,110,247,357,120261,2.96854341806571
48060,"Watertown-Fort Drum, NY",2013,114,404,518,118515,4.37075475678184
48060,"Watertown-Fort Drum, NY",2014,107,412,519,118005,4.39811872378289
48060,"Watertown-Fort Drum, NY",2015,137,10,147,116403,1.26285405015335
48060,"Watertown-Fort Drum, NY",2016,103,2,105,113015,0.929080210591514
48060,"Watertown-Fort Drum, NY",2017,141,0,141,113063,1.24709232905548
48060,"Watertown-Fort Drum, NY",2018,138,0,138,111755,1.23484407856472
48100,"Wauchula, FL",1990,57,0,57,19542,2.91679459625422
48100,"Wauchula, FL",1991,49,0,49,19981,2.45232971322757
48100,"Wauchula, FL",1992,49,0,49,20914,2.34292818207899
48100,"Wauchula, FL",1993,48,4,52,21140,2.45979186376537
48100,"Wauchula, FL",1994,38,0,38,21253,1.78798287300616
48100,"Wauchula, FL",1995,30,0,30,21375,1.40350877192982
48100,"Wauchula, FL",1996,45,0,45,20966,2.14633215682534
48100,"Wauchula, FL",1997,35,0,35,20988,1.66761959214789
48100,"Wauchula, FL",1998,34,0,34,21198,1.60392489857534
48100,"Wauchula, FL",1999,38,0,38,20896,1.81852986217458
48100,"Wauchula, FL",2000,52,4,56,26769,2.09197205723038
48100,"Wauchula, FL",2001,63,0,63,26378,2.38835393130639
48100,"Wauchula, FL",2002,44,10,54,26787,2.01590323664464
48100,"Wauchula, FL",2003,62,122,184,26765,6.87464972912386
48100,"Wauchula, FL",2004,69,13,82,26847,3.05434499199166
48100,"Wauchula, FL",2005,119,0,119,26874,4.42807174220436
48100,"Wauchula, FL",2006,216,0,216,27049,7.98550778217309
48100,"Wauchula, FL",2007,141,0,141,27489,5.12932445705555
48100,"Wauchula, FL",2008,56,0,56,27603,2.02876498931276
48100,"Wauchula, FL",2009,25,0,25,27661,0.903799573406601
48100,"Wauchula, FL",2010,12,0,12,27724,0.43283797431828003
48100,"Wauchula, FL",2011,14,0,14,27682,0.505743804638393
48100,"Wauchula, FL",2012,17,0,17,27444,0.619443229849876
48100,"Wauchula, FL",2013,19,0,19,27319,0.695486657637542
48100,"Wauchula, FL",2014,17,0,17,27281,0.623144312891756
48100,"Wauchula, FL",2015,17,0,17,27185,0.625344859297407
48100,"Wauchula, FL",2016,21,0,21,27229,0.771236549267325
48100,"Wauchula, FL",2017,24,0,24,27202,0.882288067053893
48100,"Wauchula, FL",2018,33,12,45,27245,1.65167920719398
48140,"Wausau, WI",1990,431,182,613,115700,5.29818496110631
48140,"Wausau, WI",1991,443,138,581,116754,4.97627490278706
48140,"Wausau, WI",1992,550,249,799,118019,6.77009634041976
48140,"Wausau, WI",1993,599,177,776,119463,6.49573508115483
48140,"Wausau, WI",1994,590,213,803,119998,6.69177819630327
48140,"Wausau, WI",1995,576,135,711,120703,5.89049153707861
48140,"Wausau, WI",1996,630,61,691,121427,5.69066187915373
48140,"Wausau, WI",1997,646,95,741,122262,6.06075477253767
48140,"Wausau, WI",1998,752,81,833,123085,6.76768087094284
48140,"Wausau, WI",1999,685,94,779,123702,6.29739211977171
48140,"Wausau, WI",2000,652,151,803,125995,6.37326878050716
48140,"Wausau, WI",2001,829,244,1073,126459,8.48496350595845
48140,"Wausau, WI",2002,820,102,922,126880,7.26670870113493
48140,"Wausau, WI",2003,1023,372,1395,127311,10.9574192332163
48140,"Wausau, WI",2004,909,283,1192,127855,9.32306128035665
48140,"Wausau, WI",2005,870,308,1178,128958,9.13475705268382
48140,"Wausau, WI",2006,514,162,676,130516,5.17944160102976
48140,"Wausau, WI",2007,401,274,675,131773,5.12244541749827
48140,"Wausau, WI",2008,272,296,568,133036,4.26952103190114
48140,"Wausau, WI",2009,203,102,305,133793,2.2796409378667
48140,"Wausau, WI",2010,250,12,262,134049,1.95450917201919
48140,"Wausau, WI",2011,200,76,276,134323,2.0547486283064
48140,"Wausau, WI",2012,233,64,297,134363,2.21042995467502
48140,"Wausau, WI",2013,228,60,288,134880,2.13523131672598
48140,"Wausau, WI",2014,218,165,383,135131,2.83428672917391
48140,"Wausau, WI",2015,229,12,241,135289,1.78137173014805
48140,"Wausau, WI",2016,243,2,245,135057,1.81404888306419
48140,"Wausau, WI",2017,291,320,611,135415,4.51205553299118
48140,"Wausau, WI",2018,274,34,308,135428,2.27427119945654
48180,"Waycross, GA",1990,60,2,62,48858,1.2689835850833
48180,"Waycross, GA",1991,41,2,43,48998,0.877586840279195
48180,"Waycross, GA",1992,68,8,76,49401,1.53843039614583
48180,"Waycross, GA",1993,66,3,69,49793,1.38573695097704
48180,"Waycross, GA",1994,120,3,123,50084,2.45587413145915
48180,"Waycross, GA",1995,129,10,139,50497,2.75263877062004
48180,"Waycross, GA",1996,150,38,188,50711,3.70728244365128
48180,"Waycross, GA",1997,142,17,159,51131,3.10965950206333
48180,"Waycross, GA",1998,170,180,350,51231,6.83180105795319
48180,"Waycross, GA",1999,138,64,202,51245,3.94184798516928
48180,"Waycross, GA",2000,133,0,133,51123,2.60156876552628
48180,"Waycross, GA",2001,141,16,157,51237,3.06419189257763
48180,"Waycross, GA",2002,239,0,239,51198,4.66815109965233
48180,"Waycross, GA",2003,204,16,220,51500,4.27184466019417
48180,"Waycross, GA",2004,236,14,250,51746,4.83129130754068
48180,"Waycross, GA",2005,236,0,236,52190,4.52193906878712
48180,"Waycross, GA",2006,420,0,420,53126,7.90573353913338
48180,"Waycross, GA",2007,328,0,328,53949,6.07981612263434
48180,"Waycross, GA",2008,140,6,146,54275,2.69000460617227
48180,"Waycross, GA",2009,107,2,109,54549,1.99820345010908
48180,"Waycross, GA",2010,110,0,110,55131,1.9952476827919
48180,"Waycross, GA",2011,98,0,98,55052,1.78013514495386
48180,"Waycross, GA",2012,99,0,99,54804,1.80643748631487
48180,"Waycross, GA",2013,127,0,127,54766,2.31895701712741
48180,"Waycross, GA",2014,132,0,132,54533,2.42055269286487
48180,"Waycross, GA",2015,146,0,146,54456,2.68106361098869
48180,"Waycross, GA",2016,148,0,148,54813,2.70008939485159
48180,"Waycross, GA",2017,171,4,175,54947,3.18488725499117
48180,"Waycross, GA",2018,182,3,185,55069,3.35942181626686
48220,"Weatherford, OK",1990,26,3,29,26793,1.08237226141156
48220,"Weatherford, OK",1991,20,0,20,26451,0.756115080715285
48220,"Weatherford, OK",1992,24,0,24,26557,0.903716534247091
48220,"Weatherford, OK",1993,67,0,67,26417,2.53624559942461
48220,"Weatherford, OK",1994,50,0,50,26410,1.89322226429383
48220,"Weatherford, OK",1995,44,0,44,26165,1.68163577297917
48220,"Weatherford, OK",1996,42,0,42,25806,1.62752848174843
48220,"Weatherford, OK",1997,28,2,30,25572,1.1731581417175
48220,"Weatherford, OK",1998,15,5,20,25545,0.782932080642004
48220,"Weatherford, OK",1999,29,0,29,25499,1.13729950194125
48220,"Weatherford, OK",2000,35,10,45,26066,1.72638686411417
48220,"Weatherford, OK",2001,16,10,26,25778,1.00861199472418
48220,"Weatherford, OK",2002,43,0,43,25347,1.696453229179
48220,"Weatherford, OK",2003,16,16,32,25554,1.25225013696486
48220,"Weatherford, OK",2004,45,12,57,25631,2.2238695329874
48220,"Weatherford, OK",2005,62,6,68,25876,2.6279177616324
48220,"Weatherford, OK",2006,60,0,60,26148,2.29463056447912
48220,"Weatherford, OK",2007,41,0,41,26356,1.55562300804371
48220,"Weatherford, OK",2008,71,68,139,26816,5.18347255369928
48220,"Weatherford, OK",2009,34,8,42,27284,1.53936372965841
48220,"Weatherford, OK",2010,28,6,34,27478,1.23735351917898
48220,"Weatherford, OK",2011,60,16,76,27701,2.74358326414209
48220,"Weatherford, OK",2012,117,32,149,28503,5.22751991018489
48220,"Weatherford, OK",2013,68,0,68,29223,2.32693426410704
48220,"Weatherford, OK",2014,42,2,44,29426,1.49527628627744
48220,"Weatherford, OK",2015,24,7,31,29482,1.05148904416254
48220,"Weatherford, OK",2016,31,0,31,29157,1.06320952086977
48220,"Weatherford, OK",2017,65,48,113,28942,3.90436044502799
48220,"Weatherford, OK",2018,51,4,55,29036,1.89420030307205
48260,"Weirton-Steubenville, WV-OH",1990,71,32,103,142266,0.723995895013566
48260,"Weirton-Steubenville, WV-OH",1991,78,40,118,141825,0.832011281508902
48260,"Weirton-Steubenville, WV-OH",1992,87,30,117,140975,0.829934385529349
48260,"Weirton-Steubenville, WV-OH",1993,95,2,97,140652,0.689645365867531
48260,"Weirton-Steubenville, WV-OH",1994,89,54,143,139936,1.02189572375943
48260,"Weirton-Steubenville, WV-OH",1995,96,6,102,139469,0.731345316880454
48260,"Weirton-Steubenville, WV-OH",1996,70,30,100,138190,0.723641363340329
48260,"Weirton-Steubenville, WV-OH",1997,95,14,109,136527,0.798376877833689
48260,"Weirton-Steubenville, WV-OH",1998,71,15,86,134580,0.639025115173131
48260,"Weirton-Steubenville, WV-OH",1999,104,45,149,133174,1.11883701022722
48260,"Weirton-Steubenville, WV-OH",2000,66,80,146,131681,1.10874006120853
48260,"Weirton-Steubenville, WV-OH",2001,93,91,184,130701,1.40779336041805
48260,"Weirton-Steubenville, WV-OH",2002,84,103,187,129750,1.44123314065511
48260,"Weirton-Steubenville, WV-OH",2003,97,59,156,129141,1.20798197319209
48260,"Weirton-Steubenville, WV-OH",2004,84,72,156,128241,1.21645963459424
48260,"Weirton-Steubenville, WV-OH",2005,55,4,59,127464,0.462875792380594
48260,"Weirton-Steubenville, WV-OH",2006,51,0,51,126321,0.403733345999478
48260,"Weirton-Steubenville, WV-OH",2007,60,106,166,125236,1.32549746079402
48260,"Weirton-Steubenville, WV-OH",2008,82,0,82,124959,0.65621523859826
48260,"Weirton-Steubenville, WV-OH",2009,37,0,37,124734,0.296631231260122
48260,"Weirton-Steubenville, WV-OH",2010,25,0,25,124324,0.201087481097777
48260,"Weirton-Steubenville, WV-OH",2011,19,0,19,123464,0.153891012764855
48260,"Weirton-Steubenville, WV-OH",2012,16,4,20,122669,0.163040376949352
48260,"Weirton-Steubenville, WV-OH",2013,35,16,51,122131,0.417584397081822
48260,"Weirton-Steubenville, WV-OH",2014,25,16,41,121500,0.337448559670782
48260,"Weirton-Steubenville, WV-OH",2015,48,0,48,120662,0.397805439989392
48260,"Weirton-Steubenville, WV-OH",2016,35,0,35,119287,0.29341001114958
48260,"Weirton-Steubenville, WV-OH",2017,27,2,29,118181,0.245386314212945
48260,"Weirton-Steubenville, WV-OH",2018,24,2,26,117064,0.222100731223946
48300,"Wenatchee, WA",1990,373,53,426,78783,5.40725791097064
48300,"Wenatchee, WA",1991,458,193,651,80810,8.0559336715753
48300,"Wenatchee, WA",1992,532,217,749,82817,9.04403685233708
48300,"Wenatchee, WA",1993,512,124,636,84922,7.48922540684393
48300,"Wenatchee, WA",1994,524,167,691,87276,7.91741143040469
48300,"Wenatchee, WA",1995,493,116,609,89785,6.78287018989809
48300,"Wenatchee, WA",1996,431,80,511,91181,5.60423772496463
48300,"Wenatchee, WA",1997,418,244,662,92412,7.1635718304982
48300,"Wenatchee, WA",1998,424,49,473,93703,5.04786399581657
48300,"Wenatchee, WA",1999,411,62,473,94773,4.99087292794361
48300,"Wenatchee, WA",2000,367,26,393,99322,3.95682728901955
48300,"Wenatchee, WA",2001,390,65,455,99361,4.57926148086271
48300,"Wenatchee, WA",2002,487,39,526,99786,5.27128054035636
48300,"Wenatchee, WA",2003,561,102,663,100654,6.58692153317305
48300,"Wenatchee, WA",2004,626,67,693,101968,6.79624980386003
48300,"Wenatchee, WA",2005,838,64,902,103369,8.72602037361298
48300,"Wenatchee, WA",2006,863,178,1041,105094,9.90541800673683
48300,"Wenatchee, WA",2007,767,340,1107,106717,10.3732301320314
48300,"Wenatchee, WA",2008,440,49,489,108029,4.52656231197179
48300,"Wenatchee, WA",2009,331,24,355,109614,3.23863740033207
48300,"Wenatchee, WA",2010,313,7,320,111271,2.87586163510708
48300,"Wenatchee, WA",2011,246,0,246,111884,2.19870580243824
48300,"Wenatchee, WA",2012,297,2,299,112699,2.6530847656146
48300,"Wenatchee, WA",2013,386,320,706,113162,6.23884342800587
48300,"Wenatchee, WA",2014,433,27,460,113965,4.03632694248234
48300,"Wenatchee, WA",2015,490,103,593,115682,5.12612160923912
48300,"Wenatchee, WA",2016,543,31,574,117403,4.88914252617054
48300,"Wenatchee, WA",2017,599,30,629,118646,5.30148509009996
48300,"Wenatchee, WA",2018,626,181,807,119943,6.7281958930492
48460,"West Plains, MO",1990,44,28,72,31599,2.27855311876958
48460,"West Plains, MO",1991,54,18,72,32090,2.24368962293549
48460,"West Plains, MO",1992,75,36,111,32532,3.41202508299521
48460,"West Plains, MO",1993,102,69,171,33313,5.13313121003812
48460,"West Plains, MO",1994,79,26,105,33772,3.10908444865569
48460,"West Plains, MO",1995,105,88,193,34304,5.62616604477612
48460,"West Plains, MO",1996,107,21,128,35118,3.64485449057463
48460,"West Plains, MO",1997,76,56,132,35552,3.71287128712871
48460,"West Plains, MO",1998,68,4,72,35741,2.01449315911698
48460,"West Plains, MO",1999,57,0,57,36039,1.58161991176226
48460,"West Plains, MO",2000,61,2,63,37285,1.68968754190693
48460,"West Plains, MO",2001,45,2,47,37259,1.26144018894764
48460,"West Plains, MO",2002,90,4,94,37429,2.51142162494323
48460,"West Plains, MO",2003,77,12,89,37717,2.35967865949042
48460,"West Plains, MO",2004,116,0,116,38036,3.04974234935324
48460,"West Plains, MO",2005,134,0,134,38704,3.462174452253
48460,"West Plains, MO",2006,70,22,92,39067,2.35492871221235
48460,"West Plains, MO",2007,55,124,179,39391,4.54418521997411
48460,"West Plains, MO",2008,24,19,43,39910,1.07742420446004
48460,"West Plains, MO",2009,20,12,32,39917,0.801663451662199
48460,"West Plains, MO",2010,15,58,73,40564,1.79962528350261
48460,"West Plains, MO",2011,8,67,75,40591,1.84770022911483
48460,"West Plains, MO",2012,19,2,21,40545,0.517943026267111
48460,"West Plains, MO",2013,43,22,65,40247,1.61502720699679
48460,"West Plains, MO",2014,9,10,19,40131,0.47344945304129
48460,"West Plains, MO",2015,10,4,14,40078,0.349318828284845
48460,"West Plains, MO",2016,11,16,27,40140,0.672645739910314
48460,"West Plains, MO",2017,19,0,19,40084,0.474004590360243
48460,"West Plains, MO",2018,13,26,39,40076,0.973151013075157
48540,"Wheeling, WV-OH",1990,48,28,76,158954,0.47812574707148
48540,"Wheeling, WV-OH",1991,50,0,50,158246,0.315963752638297
48540,"Wheeling, WV-OH",1992,71,17,88,158456,0.555359216438633
48540,"Wheeling, WV-OH",1993,88,5,93,158345,0.58732514446304
48540,"Wheeling, WV-OH",1994,62,17,79,157812,0.50059564545155
48540,"Wheeling, WV-OH",1995,91,64,155,156349,0.991371866785205
48540,"Wheeling, WV-OH",1996,59,48,107,157182,0.680739524881984
48540,"Wheeling, WV-OH",1997,63,112,175,155904,1.12248563218391
48540,"Wheeling, WV-OH",1998,72,13,85,155345,0.54716920402974
48540,"Wheeling, WV-OH",1999,75,50,125,153990,0.811741022144295
48540,"Wheeling, WV-OH",2000,49,0,49,152914,0.320441555384072
48540,"Wheeling, WV-OH",2001,36,0,36,151728,0.237266687757039
48540,"Wheeling, WV-OH",2002,42,2,44,151442,0.290540272843729
48540,"Wheeling, WV-OH",2003,53,2,55,150666,0.365045863034792
48540,"Wheeling, WV-OH",2004,100,41,141,150186,0.938835843553993
48540,"Wheeling, WV-OH",2005,53,38,91,149438,0.608948192561464
48540,"Wheeling, WV-OH",2006,49,24,73,149208,0.489249906171251
48540,"Wheeling, WV-OH",2007,43,94,137,148727,0.921150833406174
48540,"Wheeling, WV-OH",2008,36,0,36,148073,0.243123324306254
48540,"Wheeling, WV-OH",2009,17,0,17,147910,0.114934757622879
48540,"Wheeling, WV-OH",2010,33,5,38,147907,0.256918198597767
48540,"Wheeling, WV-OH",2011,19,8,27,147253,0.18335789423645
48540,"Wheeling, WV-OH",2012,30,6,36,146515,0.245708630515647
48540,"Wheeling, WV-OH",2013,33,17,50,145931,0.342627680205028
48540,"Wheeling, WV-OH",2014,9,52,61,144958,0.420811545413154
48540,"Wheeling, WV-OH",2015,71,44,115,144144,0.797813297813298
48540,"Wheeling, WV-OH",2016,18,16,34,142946,0.237852056021155
48540,"Wheeling, WV-OH",2017,18,2,20,141228,0.141614977199989
48540,"Wheeling, WV-OH",2018,9,107,116,140045,0.828305187618266
48580,"Whitewater-Elkhorn, WI",1990,434,545,979,75224,13.0144634691056
48580,"Whitewater-Elkhorn, WI",1991,462,278,740,76465,9.67763028836723
48580,"Whitewater-Elkhorn, WI",1992,498,295,793,77756,10.1985698852822
48580,"Whitewater-Elkhorn, WI",1993,717,167,884,78883,11.2064703421523
48580,"Whitewater-Elkhorn, WI",1994,783,366,1149,80633,14.2497488621284
48580,"Whitewater-Elkhorn, WI",1995,665,196,861,81856,10.5184714620798
48580,"Whitewater-Elkhorn, WI",1996,618,289,907,83159,10.9068170612922
48580,"Whitewater-Elkhorn, WI",1997,581,212,793,84450,9.39017169923031
48580,"Whitewater-Elkhorn, WI",1998,518,306,824,85618,9.62414445560513
48580,"Whitewater-Elkhorn, WI",1999,651,164,815,86598,9.41130280145038
48580,"Whitewater-Elkhorn, WI",2000,680,291,971,92328,10.5168529590157
48580,"Whitewater-Elkhorn, WI",2001,634,155,789,93462,8.44193362008089
48580,"Whitewater-Elkhorn, WI",2002,661,363,1024,95370,10.7371290762294
48580,"Whitewater-Elkhorn, WI",2003,808,280,1088,97087,11.2064437051305
48580,"Whitewater-Elkhorn, WI",2004,871,242,1113,98128,11.3423283874124
48580,"Whitewater-Elkhorn, WI",2005,685,302,987,99848,9.88502523836231
48580,"Whitewater-Elkhorn, WI",2006,452,137,589,101026,5.83018232930137
48580,"Whitewater-Elkhorn, WI",2007,349,226,575,101449,5.66787252708257
48580,"Whitewater-Elkhorn, WI",2008,186,129,315,101916,3.09078064288237
48580,"Whitewater-Elkhorn, WI",2009,118,87,205,102077,2.00828786112445
48580,"Whitewater-Elkhorn, WI",2010,105,6,111,102198,1.08612693007691
48580,"Whitewater-Elkhorn, WI",2011,93,29,122,102638,1.18864358229895
48580,"Whitewater-Elkhorn, WI",2012,132,22,154,102883,1.49684593178659
48580,"Whitewater-Elkhorn, WI",2013,154,30,184,102803,1.78983103605926
48580,"Whitewater-Elkhorn, WI",2014,135,68,203,103193,1.9671876968399
48580,"Whitewater-Elkhorn, WI",2015,192,32,224,102513,2.18508872045497
48580,"Whitewater-Elkhorn, WI",2016,230,69,299,102686,2.91178933837135
48580,"Whitewater-Elkhorn, WI",2017,289,112,401,102956,3.89486771047826
48580,"Whitewater-Elkhorn, WI",2018,283,92,375,103718,3.61557299600841
48620,"Wichita, KS",1990,1642,673,2315,520606,4.44674091347391
48620,"Wichita, KS",1991,1970,216,2186,528581,4.13560078776952
48620,"Wichita, KS",1992,2543,284,2827,539284,5.24213586904117
48620,"Wichita, KS",1993,2695,172,2867,546568,5.24545893649098
48620,"Wichita, KS",1994,2843,287,3130,550787,5.68277755284711
48620,"Wichita, KS",1995,2338,475,2813,555106,5.06750062150292
48620,"Wichita, KS",1996,2746,263,3009,561390,5.35991022283974
48620,"Wichita, KS",1997,2894,724,3618,569469,6.35328700947725
48620,"Wichita, KS",1998,3116,1483,4599,579784,7.93226442951168
48620,"Wichita, KS",1999,3137,165,3302,584589,5.6484128165258
48620,"Wichita, KS",2000,2315,369,2684,580911,4.62032910376977
48620,"Wichita, KS",2001,2598,281,2879,584043,4.92943156582649
48620,"Wichita, KS",2002,2860,376,3236,588719,5.49668007997024
48620,"Wichita, KS",2003,2958,698,3656,590712,6.18914123972426
48620,"Wichita, KS",2004,2948,164,3112,593004,5.24785667550303
48620,"Wichita, KS",2005,2963,387,3350,596270,5.61826018414477
48620,"Wichita, KS",2006,2790,869,3659,601501,6.08311540629193
48620,"Wichita, KS",2007,2395,414,2809,608816,4.61387348558514
48620,"Wichita, KS",2008,1858,705,2563,617142,4.15301502733569
48620,"Wichita, KS",2009,1387,504,1891,627215,3.01491514074121
48620,"Wichita, KS",2010,1057,213,1270,631746,2.01030160855787
48620,"Wichita, KS",2011,901,171,1072,633179,1.69304414707373
48620,"Wichita, KS",2012,862,465,1327,636019,2.08641565739388
48620,"Wichita, KS",2013,1178,341,1519,638248,2.37995262029807
48620,"Wichita, KS",2014,1177,337,1514,640604,2.36339454639684
48620,"Wichita, KS",2015,1153,868,2021,643257,3.14182356352127
48620,"Wichita, KS",2016,1240,858,2098,645129,3.25206276574143
48620,"Wichita, KS",2017,1634,1097,2731,644949,4.23444334358221
48620,"Wichita, KS",2018,1223,735,1958,644888,3.03618612844401
48660,"Wichita Falls, TX",1990,91,2,93,140172,0.663470593271124
48660,"Wichita Falls, TX",1991,88,4,92,138417,0.664658242845893
48660,"Wichita Falls, TX",1992,206,2,208,137613,1.51148510678497
48660,"Wichita Falls, TX",1993,353,24,377,139681,2.6990070231456
48660,"Wichita Falls, TX",1994,345,50,395,141699,2.78759906562502
48660,"Wichita Falls, TX",1995,217,195,412,144847,2.84438062231182
48660,"Wichita Falls, TX",1996,204,300,504,147655,3.41336222952152
48660,"Wichita Falls, TX",1997,209,8,217,147406,1.4721246082249
48660,"Wichita Falls, TX",1998,191,2,193,146593,1.31657036829862
48660,"Wichita Falls, TX",1999,228,0,228,146211,1.55939019636005
48660,"Wichita Falls, TX",2000,233,10,243,151847,1.60029503381693
48660,"Wichita Falls, TX",2001,239,146,385,150770,2.55355840021224
48660,"Wichita Falls, TX",2002,260,234,494,150995,3.27163151097718
48660,"Wichita Falls, TX",2003,324,210,534,150694,3.5436049212311
48660,"Wichita Falls, TX",2004,319,8,327,152033,2.15084882887268
48660,"Wichita Falls, TX",2005,315,250,565,151152,3.73795914046787
48660,"Wichita Falls, TX",2006,328,30,358,151596,2.36153988231879
48660,"Wichita Falls, TX",2007,224,542,766,150641,5.08493703573396
48660,"Wichita Falls, TX",2008,158,4,162,150287,1.07793754616168
48660,"Wichita Falls, TX",2009,172,36,208,150768,1.37960309880081
48660,"Wichita Falls, TX",2010,157,30,187,151649,1.23311067003409
48660,"Wichita Falls, TX",2011,121,49,170,150286,1.13117655669856
48660,"Wichita Falls, TX",2012,123,146,269,151023,1.7811856472193
48660,"Wichita Falls, TX",2013,115,102,217,151447,1.43284449345316
48660,"Wichita Falls, TX",2014,107,50,157,151863,1.03382654102711
48660,"Wichita Falls, TX",2015,80,0,80,150149,0.532804081279263
48660,"Wichita Falls, TX",2016,94,132,226,150472,1.50194056037004
48660,"Wichita Falls, TX",2017,108,11,119,151180,0.787141156237598
48660,"Wichita Falls, TX",2018,117,203,320,151306,2.11491943478778
48700,"Williamsport, PA",1990,275,40,315,118777,2.65202859139396
48700,"Williamsport, PA",1991,309,28,337,119570,2.81843271723677
48700,"Williamsport, PA",1992,372,53,425,120397,3.52998828874474
48700,"Williamsport, PA",1993,294,37,331,120827,2.73945392999909
48700,"Williamsport, PA",1994,305,28,333,120556,2.76220179833438
48700,"Williamsport, PA",1995,303,11,314,119717,2.62285222650083
48700,"Williamsport, PA",1996,306,94,400,118839,3.36589840035679
48700,"Williamsport, PA",1997,251,115,366,118105,3.09893738622412
48700,"Williamsport, PA",1998,263,67,330,117334,2.81248401997716
48700,"Williamsport, PA",1999,269,28,297,116553,2.54819695760727
48700,"Williamsport, PA",2000,283,30,313,119851,2.61157604024998
48700,"Williamsport, PA",2001,326,62,388,118930,3.2624232741949
48700,"Williamsport, PA",2002,321,34,355,118344,2.99972960183871
48700,"Williamsport, PA",2003,287,2,289,118108,2.44691299488604
48700,"Williamsport, PA",2004,269,80,349,117911,2.95985955508816
48700,"Williamsport, PA",2005,261,38,299,117530,2.5440313111546
48700,"Williamsport, PA",2006,288,12,300,116983,2.56447518015438
48700,"Williamsport, PA",2007,197,9,206,116524,1.76787614568673
48700,"Williamsport, PA",2008,122,72,194,116147,1.67029712347284
48700,"Williamsport, PA",2009,112,6,118,116081,1.01653155985906
48700,"Williamsport, PA",2010,199,8,207,116234,1.78089027306984
48700,"Williamsport, PA",2011,76,80,156,116742,1.33628000205582
48700,"Williamsport, PA",2012,129,49,178,117234,1.51833085964823
48700,"Williamsport, PA",2013,123,16,139,116607,1.19203821382936
48700,"Williamsport, PA",2014,107,107,214,116303,1.8400213236116
48700,"Williamsport, PA",2015,143,16,159,115576,1.37571814217485
48700,"Williamsport, PA",2016,89,4,93,114821,0.809956366866688
48700,"Williamsport, PA",2017,133,4,137,113930,1.20249275871149
48700,"Williamsport, PA",2018,103,37,140,113664,1.23170045045045
48780,"Williston, ND",1990,13,0,13,20983,0.619549158842873
48780,"Williston, ND",1991,10,0,10,20928,0.47782874617737
48780,"Williston, ND",1992,1,0,1,20811,0.0480515112200279
48780,"Williston, ND",1993,20,0,20,20602,0.970779535967382
48780,"Williston, ND",1994,18,0,18,20479,0.878949167439816
48780,"Williston, ND",1995,51,0,51,20401,2.4998774569874
48780,"Williston, ND",1996,29,6,35,20474,1.70948520074241
48780,"Williston, ND",1997,15,0,15,20287,0.739389756987233
48780,"Williston, ND",1998,22,0,22,20175,1.090458488228
48780,"Williston, ND",1999,6,0,6,19747,0.303843621815972
48780,"Williston, ND",2000,25,0,25,19705,1.26871352448617
48780,"Williston, ND",2001,25,0,25,19610,1.2748597654258
48780,"Williston, ND",2002,30,0,30,19729,1.52060418673019
48780,"Williston, ND",2003,28,4,32,19705,1.6239533113423
48780,"Williston, ND",2004,35,0,35,19724,1.77448793348205
48780,"Williston, ND",2005,51,4,55,19855,2.77008310249307
48780,"Williston, ND",2006,78,0,78,20122,3.8763542391412402
48780,"Williston, ND",2007,67,72,139,20547,6.76497785564803
48780,"Williston, ND",2008,135,18,153,20928,7.31077981651376
48780,"Williston, ND",2009,69,128,197,21820,9.02841429880843
48780,"Williston, ND",2010,230,246,476,22588,21.0731361785019
48780,"Williston, ND",2011,534,970,1504,24402,61.6342922711253
48780,"Williston, ND",2012,460,1451,1911,26732,71.4873559778543
48780,"Williston, ND",2013,172,1564,1736,29589,58.6704518571091
48780,"Williston, ND",2014,890,1331,2221,32106,69.177100853423
48780,"Williston, ND",2015,178,625,803,35288,22.7556109725686
48780,"Williston, ND",2016,100,100,200,34166,5.85377275654159
48780,"Williston, ND",2017,57,0,57,33395,1.70684234166791
48780,"Williston, ND",2018,88,0,88,35350,2.48939179632249
48820,"Willmar, MN",1990,198,12,210,38817,5.41000077285725
48820,"Willmar, MN",1991,217,128,345,39154,8.81136026970424
48820,"Willmar, MN",1992,214,86,300,39585,7.57862826828344
48820,"Willmar, MN",1993,163,64,227,40072,5.66480335396287
48820,"Willmar, MN",1994,154,50,204,40458,5.0422660536853
48820,"Willmar, MN",1995,158,58,216,40764,5.29879305269355
48820,"Willmar, MN",1996,198,92,290,41065,7.06197491781322
48820,"Willmar, MN",1997,216,26,242,40975,5.90604026845638
48820,"Willmar, MN",1998,166,57,223,40855,5.45832823399829
48820,"Willmar, MN",1999,179,16,195,40833,4.77554918815664
48820,"Willmar, MN",2000,152,60,212,41141,5.15301037894072
48820,"Willmar, MN",2001,170,14,184,41272,4.45822833882535
48820,"Willmar, MN",2002,221,42,263,41069,6.40385692371375
48820,"Willmar, MN",2003,243,18,261,41364,6.30983463881636
48820,"Willmar, MN",2004,223,42,265,41456,6.39231956773447
48820,"Willmar, MN",2005,223,12,235,41487,5.6644250006026
48820,"Willmar, MN",2006,138,20,158,41537,3.80383754243205
48820,"Willmar, MN",2007,106,6,112,41639,2.6897860179159
48820,"Willmar, MN",2008,84,6,90,41840,2.15105162523901
48820,"Willmar, MN",2009,75,44,119,42058,2.82942603071948
48820,"Willmar, MN",2010,58,24,82,42237,1.94142576414045
48820,"Willmar, MN",2011,59,4,63,42203,1.49278487311329
48820,"Willmar, MN",2012,64,6,70,42377,1.65183944120631
48820,"Willmar, MN",2013,75,0,75,42460,1.76636834667923
48820,"Willmar, MN",2014,90,8,98,42492,2.3063164831027
48820,"Willmar, MN",2015,68,10,78,42590,1.83141582531111
48820,"Willmar, MN",2016,100,2,102,42636,2.39234449760766
48820,"Willmar, MN",2017,91,37,128,42715,2.99660540793632
48820,"Willmar, MN",2018,86,49,135,42855,3.15015750787539
48900,"Wilmington, NC",1990,1392,221,1613,150051,10.7496784426628
48900,"Wilmington, NC",1991,1402,115,1517,154663,9.80842218242243
48900,"Wilmington, NC",1992,1556,500,2056,158229,12.9938254049511
48900,"Wilmington, NC",1993,2274,193,2467,163400,15.0979192166463
48900,"Wilmington, NC",1994,2616,524,3140,168859,18.5953961589255
48900,"Wilmington, NC",1995,2686,602,3288,174822,18.8077015478601
48900,"Wilmington, NC",1996,2627,389,3016,180189,16.7379806758459
48900,"Wilmington, NC",1997,3071,1475,4546,184838,24.5945097869486
48900,"Wilmington, NC",1998,2227,801,3028,189194,16.0047358795733
48900,"Wilmington, NC",1999,2030,630,2660,191012,13.9258266496346
48900,"Wilmington, NC",2000,1696,512,2208,202099,10.9253385716901
48900,"Wilmington, NC",2001,1863,926,2789,205996,13.5390978465601
48900,"Wilmington, NC",2002,2262,593,2855,210563,13.5588873638768
48900,"Wilmington, NC",2003,2696,889,3585,214877,16.6839633837032
48900,"Wilmington, NC",2004,3303,1200,4503,222498,20.2383841652509
48900,"Wilmington, NC",2005,3412,1084,4496,230897,19.4718857325994
48900,"Wilmington, NC",2006,2076,613,2689,238272,11.2854217029277
48900,"Wilmington, NC",2007,1611,1187,2798,243520,11.4898160315375
48900,"Wilmington, NC",2008,950,609,1559,248260,6.27970675904294
48900,"Wilmington, NC",2009,494,96,590,251814,2.34299919782061
48900,"Wilmington, NC",2010,586,165,751,255702,2.9370126162486
48900,"Wilmington, NC",2011,631,286,917,259125,3.53883260974433
48900,"Wilmington, NC",2012,876,938,1814,262768,6.90342811910126
48900,"Wilmington, NC",2013,1376,916,2292,267724,8.56105541527842
48900,"Wilmington, NC",2014,1367,841,2208,271904,8.12051312227845
48900,"Wilmington, NC",2015,1646,712,2358,276895,8.51586341392947
48900,"Wilmington, NC",2016,1774,1173,2947,283596,10.3915428990536
48900,"Wilmington, NC",2017,2193,569,2762,289425,9.54305951455472
48900,"Wilmington, NC",2018,1868,582,2450,294436,8.32099335679061
48940,"Wilmington, OH",1990,136,34,170,35596,4.77581750758512
48940,"Wilmington, OH",1991,138,62,200,36074,5.54415922825304
48940,"Wilmington, OH",1992,154,18,172,36621,4.69675869036891
48940,"Wilmington, OH",1993,165,23,188,37008,5.07998270644185
48940,"Wilmington, OH",1994,175,11,186,37576,4.94996806472216
48940,"Wilmington, OH",1995,188,12,200,37977,5.26634541959607
48940,"Wilmington, OH",1996,234,11,245,38680,6.33402275077559
48940,"Wilmington, OH",1997,176,3,179,39471,4.53497504496973
48940,"Wilmington, OH",1998,198,17,215,40109,5.36039292926775
48940,"Wilmington, OH",1999,225,5,230,40736,5.64611154752553
48940,"Wilmington, OH",2000,198,8,206,40566,5.07814425873885
48940,"Wilmington, OH",2001,182,11,193,40777,4.73306030360252
48940,"Wilmington, OH",2002,214,5,219,41042,5.33599727108815
48940,"Wilmington, OH",2003,202,7,209,41250,5.06666666666667
48940,"Wilmington, OH",2004,203,46,249,41557,5.99177033953365
48940,"Wilmington, OH",2005,264,0,264,41775,6.31956912028725
48940,"Wilmington, OH",2006,168,10,178,42499,4.18833384314925
48940,"Wilmington, OH",2007,78,58,136,42576,3.19428786170613
48940,"Wilmington, OH",2008,35,4,39,42656,0.914291072768192
48940,"Wilmington, OH",2009,21,0,21,42418,0.495072846433118
48940,"Wilmington, OH",2010,33,0,33,41911,0.787382787335067
48940,"Wilmington, OH",2011,22,0,22,41894,0.525134864181028
48940,"Wilmington, OH",2012,29,0,29,41804,0.693713520237298
48940,"Wilmington, OH",2013,27,0,27,41847,0.645207541759266
48940,"Wilmington, OH",2014,23,0,23,41787,0.550410414722282
48940,"Wilmington, OH",2015,37,0,37,41817,0.884807614128225
48940,"Wilmington, OH",2016,48,0,48,41853,1.14687119202925
48940,"Wilmington, OH",2017,44,3,47,41966,1.1199542486775
48940,"Wilmington, OH",2018,54,0,54,42057,1.28397175262144
48980,"Wilson, NC",1990,236,56,292,66131,4.41547836869244
48980,"Wilson, NC",1991,207,106,313,66386,4.71484951646431
48980,"Wilson, NC",1992,290,56,346,66662,5.19036332543278
48980,"Wilson, NC",1993,346,120,466,66566,7.00057086200162
48980,"Wilson, NC",1994,357,60,417,67083,6.2161799561737
48980,"Wilson, NC",1995,224,147,371,67224,5.51886231107938
48980,"Wilson, NC",1996,287,51,338,67489,5.00822356235831
48980,"Wilson, NC",1997,269,204,473,67777,6.9787686088201
48980,"Wilson, NC",1998,378,119,497,68265,7.28045118289021
48980,"Wilson, NC",1999,391,78,469,68924,6.80459636701294
48980,"Wilson, NC",2000,392,206,598,73971,8.08424923280745
48980,"Wilson, NC",2001,380,152,532,74232,7.1667205517836
48980,"Wilson, NC",2002,363,56,419,75213,5.57084546554452
48980,"Wilson, NC",2003,343,80,423,75685,5.58895421814098
48980,"Wilson, NC",2004,465,21,486,76140,6.38297872340426
48980,"Wilson, NC",2005,384,58,442,76775,5.75708238358841
48980,"Wilson, NC",2006,368,152,520,77379,6.72016955504723
48980,"Wilson, NC",2007,389,142,531,78474,6.76657236791804
48980,"Wilson, NC",2008,179,10,189,79790,2.36871788444667
48980,"Wilson, NC",2009,142,114,256,80664,3.17365863334325
48980,"Wilson, NC",2010,121,60,181,81285,2.22673309958787
48980,"Wilson, NC",2011,83,4,87,81135,1.07228692919209
48980,"Wilson, NC",2012,116,0,116,81386,1.42530656378247
48980,"Wilson, NC",2013,103,2,105,81186,1.29332643559234
48980,"Wilson, NC",2014,110,72,182,81006,2.24674715453176
48980,"Wilson, NC",2015,114,0,114,81281,1.40254179943652
48980,"Wilson, NC",2016,117,0,117,81370,1.4378763672115
48980,"Wilson, NC",2017,206,142,348,81567,4.26643127735481
48980,"Wilson, NC",2018,234,0,234,81455,2.87275182616168
49020,"Winchester, VA-WV",1990,606,287,893,84891,10.519371900437
49020,"Winchester, VA-WV",1991,573,77,650,86610,7.50490705461263
49020,"Winchester, VA-WV",1992,489,42,531,87978,6.03559980904317
49020,"Winchester, VA-WV",1993,579,56,635,89653,7.08286393093371
49020,"Winchester, VA-WV",1994,584,84,668,91514,7.29942959547173
49020,"Winchester, VA-WV",1995,546,52,598,93033,6.42782668515473
49020,"Winchester, VA-WV",1996,633,49,682,94469,7.21929945273053
49020,"Winchester, VA-WV",1997,564,64,628,95834,6.55299789218858
49020,"Winchester, VA-WV",1998,687,116,803,97219,8.25970232156266
49020,"Winchester, VA-WV",1999,638,24,662,98334,6.73215774808306
49020,"Winchester, VA-WV",2000,713,14,727,103626,7.01561384208596
49020,"Winchester, VA-WV",2001,871,4,875,106252,8.23513910326394
49020,"Winchester, VA-WV",2002,1171,180,1351,108945,12.4007526733673
49020,"Winchester, VA-WV",2003,1121,16,1137,111464,10.2006028852365
49020,"Winchester, VA-WV",2004,1309,85,1394,114383,12.18712570924
49020,"Winchester, VA-WV",2005,1719,64,1783,117847,15.1297869271174
49020,"Winchester, VA-WV",2006,1392,36,1428,121229,11.7793597241584
49020,"Winchester, VA-WV",2007,752,50,802,123863,6.47489565084004
49020,"Winchester, VA-WV",2008,431,0,431,125728,3.42803512344108
49020,"Winchester, VA-WV",2009,341,20,361,127333,2.8350859557224
49020,"Winchester, VA-WV",2010,346,0,346,128675,2.68894501651447
49020,"Winchester, VA-WV",2011,293,159,452,129968,3.47777914563585
49020,"Winchester, VA-WV",2012,332,51,383,130933,2.92516019643635
49020,"Winchester, VA-WV",2013,421,0,421,132309,3.18194529472674
49020,"Winchester, VA-WV",2014,523,2,525,133563,3.93072931874846
49020,"Winchester, VA-WV",2015,637,137,774,134297,5.76334542096994
49020,"Winchester, VA-WV",2016,877,5,882,135748,6.49733329404485
49020,"Winchester, VA-WV",2017,637,251,888,138107,6.42979718623965
49020,"Winchester, VA-WV",2018,605,329,934,139810,6.68049495744224
49080,"Winnemucca, NV",1990,47,28,75,12956,5.78882371102192
49080,"Winnemucca, NV",1991,49,40,89,13636,6.52684071575242
49080,"Winnemucca, NV",1992,35,0,35,14151,2.47332344003957
49080,"Winnemucca, NV",1993,37,0,37,14642,2.52697718890862
49080,"Winnemucca, NV",1994,52,0,52,15016,3.46297282898242
49080,"Winnemucca, NV",1995,55,0,55,15751,3.491841787823
49080,"Winnemucca, NV",1996,63,2,65,16480,3.94417475728155
49080,"Winnemucca, NV",1997,60,22,82,17488,4.68892955169259
49080,"Winnemucca, NV",1998,25,22,47,18090,2.59812050856827
49080,"Winnemucca, NV",1999,15,0,15,17841,0.840760047082563
49080,"Winnemucca, NV",2000,6,42,48,15868,3.02495588605999
49080,"Winnemucca, NV",2001,6,0,6,15211,0.394451383866938
49080,"Winnemucca, NV",2002,8,0,8,14776,0.541418516513265
49080,"Winnemucca, NV",2003,26,0,26,14630,1.77717019822283
49080,"Winnemucca, NV",2004,47,0,47,14912,3.15182403433476
49080,"Winnemucca, NV",2005,58,0,58,15046,3.85484514156586
49080,"Winnemucca, NV",2006,61,0,61,15420,3.95590142671855
49080,"Winnemucca, NV",2007,52,38,90,15658,5.7478605185847496
49080,"Winnemucca, NV",2008,41,0,41,15958,2.56924426619877
49080,"Winnemucca, NV",2009,16,32,48,16290,2.94659300184162
49080,"Winnemucca, NV",2010,12,6,18,16583,1.08544895374781
49080,"Winnemucca, NV",2011,25,22,47,16638,2.82485875706215
49080,"Winnemucca, NV",2012,102,70,172,17072,10.0749765698219
49080,"Winnemucca, NV",2013,78,2,80,17357,4.6090914328513
49080,"Winnemucca, NV",2014,18,2,20,17219,1.16150763691271
49080,"Winnemucca, NV",2015,19,32,51,17023,2.99594666040063
49080,"Winnemucca, NV",2016,12,0,12,16792,0.714626012386851
49080,"Winnemucca, NV",2017,17,0,17,16702,1.01784217458987
49080,"Winnemucca, NV",2018,12,0,12,16786,0.714881448826403
49100,"Winona, MN",1990,145,111,256,47817,5.35374448417927
49100,"Winona, MN",1991,165,0,165,47852,3.44813173953022
49100,"Winona, MN",1992,156,63,219,47877,4.57422144244627
49100,"Winona, MN",1993,159,11,170,48167,3.52938733988
49100,"Winona, MN",1994,148,61,209,48239,4.3325939592446
49100,"Winona, MN",1995,156,23,179,48366,3.70094694620188
49100,"Winona, MN",1996,151,27,178,48309,3.68461363307044
49100,"Winona, MN",1997,165,97,262,48303,5.42409374158955
49100,"Winona, MN",1998,141,38,179,48023,3.72738063011474
49100,"Winona, MN",1999,155,24,179,47764,3.74759232895067
49100,"Winona, MN",2000,152,17,169,50081,3.37453325612508
49100,"Winona, MN",2001,189,16,205,50072,4.09410448953507
49100,"Winona, MN",2002,185,156,341,49977,6.82313864377614
49100,"Winona, MN",2003,227,147,374,50200,7.45019920318725
49100,"Winona, MN",2004,236,29,265,50257,5.27289730783771
49100,"Winona, MN",2005,179,14,193,50756,3.8025061076523
49100,"Winona, MN",2006,102,5,107,50904,2.1019959138771
49100,"Winona, MN",2007,97,47,144,51316,2.80614233377504
49100,"Winona, MN",2008,83,12,95,51457,1.84620168295859
49100,"Winona, MN",2009,72,3,75,51422,1.45851969973941
49100,"Winona, MN",2010,42,71,113,51434,2.19699031768869
49100,"Winona, MN",2011,46,87,133,51348,2.5901690426112
49100,"Winona, MN",2012,46,27,73,51339,1.4219209567775
49100,"Winona, MN",2013,52,20,72,51330,1.40268848626534
49100,"Winona, MN",2014,43,66,109,51057,2.13486887204497
49100,"Winona, MN",2015,45,52,97,50808,1.90914816564321
49100,"Winona, MN",2016,55,13,68,50840,1.3375295043273
49100,"Winona, MN",2017,70,2,72,50704,1.42000631113916
49100,"Winona, MN",2018,56,79,135,50825,2.65617314313822
49180,"Winston-Salem, NC",1990,2165,336,2501,489529,5.1089925213828
49180,"Winston-Salem, NC",1991,2308,203,2511,493908,5.08394275857042
49180,"Winston-Salem, NC",1992,2818,135,2953,498488,5.92391391568102
49180,"Winston-Salem, NC",1993,2874,389,3263,505243,6.45827849173566
49180,"Winston-Salem, NC",1994,2783,507,3290,512772,6.41610696371877
49180,"Winston-Salem, NC",1995,2828,753,3581,519351,6.89514413181066
49180,"Winston-Salem, NC",1996,2754,335,3089,527004,5.86143558682667
49180,"Winston-Salem, NC",1997,2880,296,3176,533474,5.95342978289476
49180,"Winston-Salem, NC",1998,3423,1031,4454,538894,8.26507624876135
49180,"Winston-Salem, NC",1999,3405,840,4245,543010,7.81753558866319
49180,"Winston-Salem, NC",2000,3550,867,4417,571210,7.73270776071847
49180,"Winston-Salem, NC",2001,3350,516,3866,578186,6.68642962645239
49180,"Winston-Salem, NC",2002,3692,752,4444,584321,7.6054086709189
49180,"Winston-Salem, NC",2003,3571,502,4073,588964,6.91553303767293
49180,"Winston-Salem, NC",2004,4122,691,4813,594765,8.09227173757703
49180,"Winston-Salem, NC",2005,4747,351,5098,602805,8.45712958585281
49180,"Winston-Salem, NC",2006,4608,282,4890,613494,7.97073810012812
49180,"Winston-Salem, NC",2007,4279,206,4485,623068,7.19825123421521
49180,"Winston-Salem, NC",2008,2396,199,2595,632186,4.1048045986466
49180,"Winston-Salem, NC",2009,1110,330,1440,637688,2.25815759430944
49180,"Winston-Salem, NC",2010,1177,290,1467,641292,2.28756946913419
49180,"Winston-Salem, NC",2011,1142,492,1634,644261,2.53623919498464
49180,"Winston-Salem, NC",2012,1057,452,1509,646847,2.33285460085615
49180,"Winston-Salem, NC",2013,1248,654,1902,650007,2.92612233406717
49180,"Winston-Salem, NC",2014,1424,661,2085,653403,3.19098626728068
49180,"Winston-Salem, NC",2015,1602,442,2044,656352,3.11418263370874
49180,"Winston-Salem, NC",2016,2243,484,2727,661034,4.12535512545497
49180,"Winston-Salem, NC",2017,2784,981,3765,666746,5.64682802746473
49180,"Winston-Salem, NC",2018,3123,376,3499,671456,5.21106371824811
49220,"Wisconsin Rapids-Marshfield, WI",1990,203,196,399,73725,5.41200406917599
49220,"Wisconsin Rapids-Marshfield, WI",1991,232,106,338,74338,4.54679975248191
49220,"Wisconsin Rapids-Marshfield, WI",1992,291,132,423,74842,5.65190668341306
49220,"Wisconsin Rapids-Marshfield, WI",1993,238,46,284,75332,3.76997822970318
49220,"Wisconsin Rapids-Marshfield, WI",1994,266,71,337,75549,4.46068114733484
49220,"Wisconsin Rapids-Marshfield, WI",1995,245,28,273,75831,3.60011077263916
49220,"Wisconsin Rapids-Marshfield, WI",1996,213,160,373,75939,4.91183713243524
49220,"Wisconsin Rapids-Marshfield, WI",1997,197,42,239,75829,3.15182845613156
49220,"Wisconsin Rapids-Marshfield, WI",1998,278,24,302,76051,3.97101944747604
49220,"Wisconsin Rapids-Marshfield, WI",1999,318,54,372,76045,4.89184035768295
49220,"Wisconsin Rapids-Marshfield, WI",2000,232,160,392,75486,5.1930159234825
49220,"Wisconsin Rapids-Marshfield, WI",2001,240,112,352,75376,4.6699214604118
49220,"Wisconsin Rapids-Marshfield, WI",2002,274,316,590,75223,7.84334578519868
49220,"Wisconsin Rapids-Marshfield, WI",2003,262,286,548,75179,7.28926960986446
49220,"Wisconsin Rapids-Marshfield, WI",2004,264,303,567,75164,7.54350486935235
49220,"Wisconsin Rapids-Marshfield, WI",2005,272,151,423,74981,5.64142916205439
49220,"Wisconsin Rapids-Marshfield, WI",2006,178,102,280,74603,3.75320027344745
49220,"Wisconsin Rapids-Marshfield, WI",2007,155,181,336,74465,4.51218693345867
49220,"Wisconsin Rapids-Marshfield, WI",2008,125,84,209,74519,2.80465384666998
49220,"Wisconsin Rapids-Marshfield, WI",2009,107,42,149,74627,1.99659640612647
49220,"Wisconsin Rapids-Marshfield, WI",2010,77,32,109,74814,1.45694656080413
49220,"Wisconsin Rapids-Marshfield, WI",2011,67,24,91,74648,1.21905476369092
49220,"Wisconsin Rapids-Marshfield, WI",2012,97,57,154,74321,2.07209267905437
49220,"Wisconsin Rapids-Marshfield, WI",2013,69,211,280,73922,3.78777630475366
49220,"Wisconsin Rapids-Marshfield, WI",2014,78,158,236,73593,3.2068267362385
49220,"Wisconsin Rapids-Marshfield, WI",2015,81,190,271,73364,3.69390981953001
49220,"Wisconsin Rapids-Marshfield, WI",2016,89,72,161,73246,2.19807224967916
49220,"Wisconsin Rapids-Marshfield, WI",2017,105,91,196,73112,2.68081847029215
49220,"Wisconsin Rapids-Marshfield, WI",2018,102,275,377,73055,5.16049551707617
49260,"Woodward, OK",1990,2,0,2,18948,0.105552037154317
49260,"Woodward, OK",1991,3,0,3,18851,0.15914275104769
49260,"Woodward, OK",1992,11,0,11,18920,0.581395348837209
49260,"Woodward, OK",1993,16,0,16,18711,0.855111966223077
49260,"Woodward, OK",1994,10,0,10,18788,0.532254630615286
49260,"Woodward, OK",1995,12,0,12,18736,0.640478223740393
49260,"Woodward, OK",1996,13,0,13,18629,0.697836706210747
49260,"Woodward, OK",1997,8,0,8,18616,0.429737859905458
49260,"Woodward, OK",1998,4,0,4,18597,0.215088455127171
49260,"Woodward, OK",1999,12,0,12,18562,0.646482060122832
49260,"Woodward, OK",2000,6,0,6,18436,0.325450206118464
49260,"Woodward, OK",2001,5,0,5,18365,0.272257010618023
49260,"Woodward, OK",2002,14,16,30,18482,1.62320095227789
49260,"Woodward, OK",2003,13,0,13,18594,0.699150263525869
49260,"Woodward, OK",2004,14,0,14,18935,0.739371534195933
49260,"Woodward, OK",2005,24,0,24,19122,1.25509883903357
49260,"Woodward, OK",2006,25,0,25,19341,1.2925908691381
49260,"Woodward, OK",2007,30,0,30,19939,1.50458899643914
49260,"Woodward, OK",2008,16,0,16,20120,0.795228628230616
49260,"Woodward, OK",2009,6,0,6,20467,0.293154834611814
49260,"Woodward, OK",2010,3,16,19,19995,0.950237559389847
49260,"Woodward, OK",2011,7,12,19,20107,0.944944546675287
49260,"Woodward, OK",2012,38,24,62,20669,2.99966132855968
49260,"Woodward, OK",2013,24,16,40,21241,1.88315051080458
49260,"Woodward, OK",2014,14,9,23,21536,1.06797919762259
49260,"Woodward, OK",2015,18,24,42,21609,1.94363459669582
49260,"Woodward, OK",2016,8,0,8,20970,0.381497377205532
49260,"Woodward, OK",2017,10,48,58,20497,2.82968239254525
49260,"Woodward, OK",2018,12,0,12,20222,0.593413114429829
49300,"Wooster, OH",1990,296,38,334,101740,3.28287792412031
49300,"Wooster, OH",1991,307,48,355,102504,3.46327948177632
49300,"Wooster, OH",1992,425,79,504,103628,4.863550391786
49300,"Wooster, OH",1993,442,102,544,104873,5.18722645485492
49300,"Wooster, OH",1994,632,53,685,105950,6.46531382727702
49300,"Wooster, OH",1995,535,149,684,107257,6.37720614971517
49300,"Wooster, OH",1996,482,269,751,108528,6.91987321244287
49300,"Wooster, OH",1997,413,142,555,109459,5.07039165349583
49300,"Wooster, OH",1998,431,132,563,110180,5.10982029406426
49300,"Wooster, OH",1999,356,105,461,111042,4.15158228418076
49300,"Wooster, OH",2000,408,89,497,111668,4.45069312605223
49300,"Wooster, OH",2001,406,245,651,112161,5.80415652499532
49300,"Wooster, OH",2002,434,158,592,112684,5.25362961911185
49300,"Wooster, OH",2003,445,87,532,113067,4.70517480785729
49300,"Wooster, OH",2004,411,85,496,113240,4.38007771105616
49300,"Wooster, OH",2005,368,98,466,113603,4.10200434847671
49300,"Wooster, OH",2006,304,44,348,114263,3.04560531405617
49300,"Wooster, OH",2007,239,104,343,114224,3.00287155063734
49300,"Wooster, OH",2008,144,11,155,114610,1.35241252944769
49300,"Wooster, OH",2009,157,9,166,114588,1.44866827241945
49300,"Wooster, OH",2010,124,8,132,114391,1.15393693559808
49300,"Wooster, OH",2011,105,24,129,114637,1.12529113636958
49300,"Wooster, OH",2012,119,12,131,115022,1.13891255585888
49300,"Wooster, OH",2013,129,93,222,115397,1.92379351282962
49300,"Wooster, OH",2014,156,28,184,115918,1.58732897392985
49300,"Wooster, OH",2015,164,47,211,116240,1.81520991052994
49300,"Wooster, OH",2016,155,18,173,116670,1.48281477672067
49300,"Wooster, OH",2017,158,16,174,116247,1.49681282097603
49300,"Wooster, OH",2018,241,12,253,115967,2.18165512602723
49340,"Worcester, MA-CT",1990,2029,844,2873,813142,3.53320822193418
49340,"Worcester, MA-CT",1991,2125,304,2429,811244,2.99416698305319
49340,"Worcester, MA-CT",1992,2842,229,3071,810882,3.78723414750852
49340,"Worcester, MA-CT",1993,2916,167,3083,814332,3.78592515092125
49340,"Worcester, MA-CT",1994,2972,306,3278,818449,4.00513654485496
49340,"Worcester, MA-CT",1995,2699,353,3052,820340,3.72040861106371
49340,"Worcester, MA-CT",1996,2976,452,3428,823789,4.1612597400548
49340,"Worcester, MA-CT",1997,2928,185,3113,829385,3.75338353117069
49340,"Worcester, MA-CT",1998,3346,351,3697,835929,4.42262440948932
49340,"Worcester, MA-CT",1999,3164,247,3411,843791,4.04247023255759
49340,"Worcester, MA-CT",2000,2974,203,3177,861697,3.68691082828419
49340,"Worcester, MA-CT",2001,3072,211,3283,871081,3.76888027634629
49340,"Worcester, MA-CT",2002,3580,275,3855,879568,4.38283339093737
49340,"Worcester, MA-CT",2003,3552,631,4183,887129,4.71521052744302
49340,"Worcester, MA-CT",2004,3922,362,4284,892171,4.80177006425898
49340,"Worcester, MA-CT",2005,3703,488,4191,896901,4.67275652496764
49340,"Worcester, MA-CT",2006,2704,439,3143,902123,3.48400384426514
49340,"Worcester, MA-CT",2007,1947,143,2090,905524,2.30805588808248
49340,"Worcester, MA-CT",2008,959,121,1080,908735,1.18846528415875
49340,"Worcester, MA-CT",2009,1119,450,1569,913363,1.7178274136351
49340,"Worcester, MA-CT",2010,1209,382,1591,918946,1.73133132958846
49340,"Worcester, MA-CT",2011,818,77,895,922313,0.970386408952275
49340,"Worcester, MA-CT",2012,957,262,1219,924866,1.31802877389806
49340,"Worcester, MA-CT",2013,1259,181,1440,928413,1.55103386100798
49340,"Worcester, MA-CT",2014,1274,110,1384,932389,1.48435899608425
49340,"Worcester, MA-CT",2015,1152,233,1385,934848,1.48152426918601
49340,"Worcester, MA-CT",2016,1323,300,1623,936683,1.73270999900713
49340,"Worcester, MA-CT",2017,1297,471,1768,942303,1.87625424093949
49340,"Worcester, MA-CT",2018,1300,469,1769,947866,1.86629755682765
49380,"Worthington, MN",1990,50,6,56,20088,2.78773397052967
49380,"Worthington, MN",1991,41,95,136,20041,6.786088518537
49380,"Worthington, MN",1992,47,8,55,20180,2.72547076313181
49380,"Worthington, MN",1993,31,0,31,20261,1.5300330684566401
49380,"Worthington, MN",1994,34,18,52,20291,2.56271253264994
49380,"Worthington, MN",1995,14,80,94,20193,4.65507849254692
49380,"Worthington, MN",1996,27,37,64,20031,3.19504767610204
49380,"Worthington, MN",1997,22,0,22,19703,1.11658123128458
49380,"Worthington, MN",1998,15,8,23,19297,1.19189511323004
49380,"Worthington, MN",1999,22,2,24,19156,1.25287116308206
49380,"Worthington, MN",2000,14,10,24,20791,1.15434563032081
49380,"Worthington, MN",2001,27,16,43,20847,2.06264690363122
49380,"Worthington, MN",2002,15,5,20,20665,0.9678199854827
49380,"Worthington, MN",2003,33,3,36,20667,1.74190738859051
49380,"Worthington, MN",2004,34,6,40,20629,1.93901788744001
49380,"Worthington, MN",2005,35,0,35,20709,1.69008643584915
49380,"Worthington, MN",2006,30,24,54,20608,2.62034161490683
49380,"Worthington, MN",2007,29,0,29,20723,1.39941128215027
49380,"Worthington, MN",2008,17,2,19,21126,0.899365710498911
49380,"Worthington, MN",2009,17,61,78,21318,3.65887981987053
49380,"Worthington, MN",2010,11,30,41,21426,1.91356296088864
49380,"Worthington, MN",2011,9,5,14,21619,0.647578518895416
49380,"Worthington, MN",2012,17,0,17,21733,0.78222058620531
49380,"Worthington, MN",2013,12,0,12,21797,0.550534477221636
49380,"Worthington, MN",2014,13,54,67,21701,3.08741532648265
49380,"Worthington, MN",2015,12,2,14,21795,0.642349162651984
49380,"Worthington, MN",2016,13,48,61,21963,2.77739835177344
49380,"Worthington, MN",2017,12,33,45,21810,2.06327372764787
49380,"Worthington, MN",2018,10,2,12,21924,0.547345374931582
49420,"Yakima, WA",1990,346,94,440,189423,2.32284358288064
49420,"Yakima, WA",1991,454,409,863,193744,4.45433148897514
49420,"Yakima, WA",1992,507,246,753,198686,3.789899640639
49420,"Yakima, WA",1993,528,345,873,203827,4.28304395394133
49420,"Yakima, WA",1994,528,376,904,208378,4.33826987493881
49420,"Yakima, WA",1995,425,198,623,211869,2.9404962500413
49420,"Yakima, WA",1996,409,310,719,214072,3.35868305990508
49420,"Yakima, WA",1997,406,258,664,216176,3.07157131226408
49420,"Yakima, WA",1998,391,362,753,218573,3.44507327071505
49420,"Yakima, WA",1999,462,197,659,220250,2.99205448354143
49420,"Yakima, WA",2000,333,151,484,222615,2.17415717718932
49420,"Yakima, WA",2001,303,151,454,222757,2.03809532360375
49420,"Yakima, WA",2002,366,168,534,223402,2.39030984503272
49420,"Yakima, WA",2003,494,112,606,225161,2.6914074817575
49420,"Yakima, WA",2004,759,180,939,227280,4.13146779303062
49420,"Yakima, WA",2005,739,41,780,228570,3.4125213282583
49420,"Yakima, WA",2006,653,39,692,230617,3.0006460928726
49420,"Yakima, WA",2007,1093,131,1224,232733,5.25924557325347
49420,"Yakima, WA",2008,617,143,760,235272,3.23030364854296
49420,"Yakima, WA",2009,426,82,508,239604,2.12016493881571
49420,"Yakima, WA",2010,343,281,624,244269,2.55456075064785
49420,"Yakima, WA",2011,298,140,438,245950,1.78084976621265
49420,"Yakima, WA",2012,301,170,471,246207,1.91302440629227
49420,"Yakima, WA",2013,300,58,358,246612,1.45167307349196
49420,"Yakima, WA",2014,352,90,442,247046,1.78914048395845
49420,"Yakima, WA",2015,390,5,395,248065,1.59232459234475
49420,"Yakima, WA",2016,405,17,422,249691,1.69008894994213
49420,"Yakima, WA",2017,412,22,434,250377,1.73338605383082
49420,"Yakima, WA",2018,480,98,578,251446,2.29870429436141
49460,"Yankton, SD",1990,40,16,56,19310,2.90005178663905
49460,"Yankton, SD",1991,32,37,69,19713,3.50022827575711
49460,"Yankton, SD",1992,52,8,60,19935,3.00978179082017
49460,"Yankton, SD",1993,56,50,106,20249,5.2348264111808
49460,"Yankton, SD",1994,54,31,85,20539,4.13846827985783
49460,"Yankton, SD",1995,28,17,45,20685,2.17548948513416
49460,"Yankton, SD",1996,56,13,69,20693,3.33446092881651
49460,"Yankton, SD",1997,51,33,84,20850,4.02877697841727
49460,"Yankton, SD",1998,49,60,109,20956,5.20137430807406
49460,"Yankton, SD",1999,49,12,61,21102,2.89072125864847
49460,"Yankton, SD",2000,43,36,79,21616,3.65470022205773
49460,"Yankton, SD",2001,31,34,65,21527,3.01946392901937
49460,"Yankton, SD",2002,53,0,53,21576,2.45643307378569
49460,"Yankton, SD",2003,38,9,47,21687,2.16719693825794
49460,"Yankton, SD",2004,89,14,103,21869,4.70986327678449
49460,"Yankton, SD",2005,87,48,135,21871,6.17255726761465
49460,"Yankton, SD",2006,96,30,126,21957,5.73848886459899
49460,"Yankton, SD",2007,90,48,138,22064,6.2545322697607
49460,"Yankton, SD",2008,76,38,114,22267,5.11968383706831
49460,"Yankton, SD",2009,47,10,57,22331,2.55250548564775
49460,"Yankton, SD",2010,46,10,56,22435,2.49609984399376
49460,"Yankton, SD",2011,42,0,42,22497,1.86691558874517
49460,"Yankton, SD",2012,50,6,56,22581,2.47996102918383
49460,"Yankton, SD",2013,46,0,46,22640,2.03180212014134
49460,"Yankton, SD",2014,56,32,88,22675,3.88092613009923
49460,"Yankton, SD",2015,64,70,134,22684,5.90724739904779
49460,"Yankton, SD",2016,91,16,107,22657,4.72260228626914
49460,"Yankton, SD",2017,79,79,158,22699,6.96065905987048
49460,"Yankton, SD",2018,55,60,115,22869,5.02864139227776
49620,"York-Hanover, PA",1990,1785,198,1983,340755,5.8194303825329
49620,"York-Hanover, PA",1991,1928,238,2166,345926,6.26145476200112
49620,"York-Hanover, PA",1992,2302,165,2467,350526,7.03799432852342
49620,"York-Hanover, PA",1993,2495,156,2651,355397,7.45926386548001
49620,"York-Hanover, PA",1994,2224,223,2447,360090,6.79552334138688
49620,"York-Hanover, PA",1995,1863,113,1976,364746,5.41746859458363
49620,"York-Hanover, PA",1996,1844,288,2132,368280,5.78907353100902
49620,"York-Hanover, PA",1997,1619,301,1920,370960,5.17576018977787
49620,"York-Hanover, PA",1998,1849,233,2082,373817,5.56957013725968
49620,"York-Hanover, PA",1999,1964,264,2228,376661,5.91513323651772
49620,"York-Hanover, PA",2000,1714,295,2009,382743,5.24895295276465
49620,"York-Hanover, PA",2001,2036,149,2185,385773,5.6639526353581
49620,"York-Hanover, PA",2002,2423,533,2956,389692,7.5854777619248
49620,"York-Hanover, PA",2003,2708,440,3148,395093,7.96774430324
49620,"York-Hanover, PA",2004,2899,188,3087,401403,7.69052548187233
49620,"York-Hanover, PA",2005,2870,246,3116,409066,7.61735270103113
49620,"York-Hanover, PA",2006,2467,436,2903,418043,6.94426171470399
49620,"York-Hanover, PA",2007,1964,65,2029,424919,4.77502771116377
49620,"York-Hanover, PA",2008,1320,80,1400,429399,3.26037089047716
49620,"York-Hanover, PA",2009,1082,91,1173,433022,2.70886929532449
49620,"York-Hanover, PA",2010,858,201,1059,435403,2.43222945179523
49620,"York-Hanover, PA",2011,582,56,638,436643,1.46114789427519
49620,"York-Hanover, PA",2012,695,110,805,437449,1.84021451643506
49620,"York-Hanover, PA",2013,744,184,928,438936,2.11420343740317
49620,"York-Hanover, PA",2014,720,96,816,440496,1.8524572300316
49620,"York-Hanover, PA",2015,707,71,778,441800,1.7609778180172
49620,"York-Hanover, PA",2016,769,109,878,443777,1.97847116907816
49620,"York-Hanover, PA",2017,678,160,838,445722,1.88009566501093
49620,"York-Hanover, PA",2018,788,128,916,448273,2.04339766169276
49660,"Youngstown-Warren-Boardman, OH-PA",1990,1091,312,1403,613793,2.28578690209892
49660,"Youngstown-Warren-Boardman, OH-PA",1991,1130,282,1412,614524,2.29771335212294
49660,"Youngstown-Warren-Boardman, OH-PA",1992,1268,591,1859,615980,3.01795512841326
49660,"Youngstown-Warren-Boardman, OH-PA",1993,1343,324,1667,615878,2.70670489934695
49660,"Youngstown-Warren-Boardman, OH-PA",1994,1446,398,1844,614068,3.00292475751871
49660,"Youngstown-Warren-Boardman, OH-PA",1995,1369,473,1842,611689,3.01133419106768
49660,"Youngstown-Warren-Boardman, OH-PA",1996,1405,434,1839,609750,3.0159901599016
49660,"Youngstown-Warren-Boardman, OH-PA",1997,1347,483,1830,606594,3.01684487482567
49660,"Youngstown-Warren-Boardman, OH-PA",1998,1406,494,1900,603299,3.14935048790069
49660,"Youngstown-Warren-Boardman, OH-PA",1999,1468,244,1712,599330,2.85652311748119
49660,"Youngstown-Warren-Boardman, OH-PA",2000,1280,336,1616,602227,2.68337354519143
49660,"Youngstown-Warren-Boardman, OH-PA",2001,1207,123,1330,599116,2.21993737439828
49660,"Youngstown-Warren-Boardman, OH-PA",2002,1427,195,1622,594958,2.7262428608406
49660,"Youngstown-Warren-Boardman, OH-PA",2003,1275,156,1431,592016,2.41716440096214
49660,"Youngstown-Warren-Boardman, OH-PA",2004,1430,226,1656,588478,2.8140389275385
49660,"Youngstown-Warren-Boardman, OH-PA",2005,1079,149,1228,584222,2.10194070062408
49660,"Youngstown-Warren-Boardman, OH-PA",2006,847,109,956,580420,1.64708314668688
49660,"Youngstown-Warren-Boardman, OH-PA",2007,623,228,851,575543,1.47860368382554
49660,"Youngstown-Warren-Boardman, OH-PA",2008,356,175,531,570952,0.930025641384915
49660,"Youngstown-Warren-Boardman, OH-PA",2009,281,37,318,568156,0.559705433014876
49660,"Youngstown-Warren-Boardman, OH-PA",2010,292,33,325,564828,0.575396403860998
49660,"Youngstown-Warren-Boardman, OH-PA",2011,256,0,256,562291,0.455280273025889
49660,"Youngstown-Warren-Boardman, OH-PA",2012,255,8,263,558507,0.470898305661344
49660,"Youngstown-Warren-Boardman, OH-PA",2013,344,12,356,555848,0.640462860350312
49660,"Youngstown-Warren-Boardman, OH-PA",2014,301,12,313,553051,0.565951422201569
49660,"Youngstown-Warren-Boardman, OH-PA",2015,299,12,311,548873,0.566615592313705
49660,"Youngstown-Warren-Boardman, OH-PA",2016,327,139,466,544688,0.855535646094645
49660,"Youngstown-Warren-Boardman, OH-PA",2017,310,14,324,541875,0.597923875432526
49660,"Youngstown-Warren-Boardman, OH-PA",2018,366,8,374,538952,0.69393934895872
49700,"Yuba City, CA",1990,1095,348,1443,123508,11.6834537034038
49700,"Yuba City, CA",1991,817,56,873,126724,6.88898709005398
49700,"Yuba City, CA",1992,927,82,1009,129970,7.76332999923059
49700,"Yuba City, CA",1993,902,28,930,132075,7.04145371947757
49700,"Yuba City, CA",1994,603,8,611,134686,4.53647743640764
49700,"Yuba City, CA",1995,431,64,495,135533,3.65224705422296
49700,"Yuba City, CA",1996,388,10,398,136412,2.91763187989326
49700,"Yuba City, CA",1997,345,30,375,136720,2.7428320655354
49700,"Yuba City, CA",1998,277,12,289,137357,2.10400634842054
49700,"Yuba City, CA",1999,257,142,399,138484,2.88119927211808
49700,"Yuba City, CA",2000,320,2,322,139564,2.3071852340145
49700,"Yuba City, CA",2001,642,6,648,141387,4.58316535466486
49700,"Yuba City, CA",2002,1033,8,1041,144262,7.21603748734941
49700,"Yuba City, CA",2003,1441,156,1597,147404,10.8341700360913
49700,"Yuba City, CA",2004,3021,25,3046,150226,20.2761173165764
49700,"Yuba City, CA",2005,2961,33,2994,155049,19.310024572877
49700,"Yuba City, CA",2006,1311,38,1349,160384,8.41106344772546
49700,"Yuba City, CA",2007,928,100,1028,163720,6.27901294893721
49700,"Yuba City, CA",2008,199,62,261,165628,1.57582051343976
49700,"Yuba City, CA",2009,169,2,171,165973,1.03028805890115
49700,"Yuba City, CA",2010,150,0,150,167103,0.897649952424552
49700,"Yuba City, CA",2011,78,68,146,166977,0.874371919485917
49700,"Yuba City, CA",2012,101,15,116,167002,0.69460245985078
49700,"Yuba City, CA",2013,154,48,202,167659,1.20482646323788
49700,"Yuba City, CA",2014,270,10,280,168392,1.6627868307283
49700,"Yuba City, CA",2015,242,129,371,169471,2.18916510789457
49700,"Yuba City, CA",2016,257,4,261,170900,1.52720889409011
49700,"Yuba City, CA",2017,299,4,303,173213,1.74929133494599
49700,"Yuba City, CA",2018,470,6,476,174848,2.72236456808199
49740,"Yuma, AZ",1990,488,331,819,107659,7.60735284555866
49740,"Yuma, AZ",1991,513,48,561,109889,5.10515156203078
49740,"Yuma, AZ",1992,615,4,619,114724,5.39555803493602
49740,"Yuma, AZ",1993,637,0,637,118954,5.35501118079258
49740,"Yuma, AZ",1994,770,6,776,120078,6.46246606372524
49740,"Yuma, AZ",1995,767,6,773,121807,6.34610490365907
49740,"Yuma, AZ",1996,879,272,1151,124979,9.20954720393026
49740,"Yuma, AZ",1997,959,98,1057,129087,8.18827612385446
49740,"Yuma, AZ",1998,896,143,1039,131739,7.88680648858728
49740,"Yuma, AZ",1999,919,128,1047,135530,7.72522688703608
49740,"Yuma, AZ",2000,1180,108,1288,160576,8.02112395376644
49740,"Yuma, AZ",2001,1226,84,1310,162873,8.04307650746287
49740,"Yuma, AZ",2002,1563,163,1726,165398,10.4354345276243
49740,"Yuma, AZ",2003,1891,24,1915,168003,11.3986059772742
49740,"Yuma, AZ",2004,2533,167,2700,172824,15.6228301624774
49740,"Yuma, AZ",2005,2276,32,2308,178816,12.9071224051539
49740,"Yuma, AZ",2006,1563,11,1574,183848,8.56142030372917
49740,"Yuma, AZ",2007,967,77,1044,187357,5.57224976915728
49740,"Yuma, AZ",2008,786,41,827,191202,4.32526856413636
49740,"Yuma, AZ",2009,689,60,749,193714,3.86652487688035
49740,"Yuma, AZ",2010,455,0,455,197138,2.30802787894774
49740,"Yuma, AZ",2011,358,2,360,202883,1.77442171103542
49740,"Yuma, AZ",2012,554,94,648,202589,3.19859419810552
49740,"Yuma, AZ",2013,670,4,674,202589,3.32693285420235
49740,"Yuma, AZ",2014,594,0,594,204283,2.90773094187965
49740,"Yuma, AZ",2015,765,3,768,205456,3.73802663343976
49740,"Yuma, AZ",2016,890,7,897,207520,4.32247494217425
49740,"Yuma, AZ",2017,1005,96,1101,209756,5.24895592974694
49740,"Yuma, AZ",2018,1011,4,1015,212128,4.78484688489968
49780,"Zanesville, OH",1990,10,166,176,82150,2.14242239805234
49780,"Zanesville, OH",1991,4,36,40,82153,0.486896400618358
49780,"Zanesville, OH",1992,10,12,22,82524,0.266589113470021
49780,"Zanesville, OH",1993,22,8,30,83069,0.361145553696325
49780,"Zanesville, OH",1994,25,80,105,83573,1.25638663204624
49780,"Zanesville, OH",1995,17,0,17,84105,0.202128292015932
49780,"Zanesville, OH",1996,21,74,95,84327,1.12656681727086
49780,"Zanesville, OH",1997,28,126,154,84420,1.82421227197347
49780,"Zanesville, OH",1998,13,55,68,84680,0.803023145961266
49780,"Zanesville, OH",1999,17,169,186,84944,2.18967790544359
49780,"Zanesville, OH",2000,22,164,186,84732,2.19515649341453
49780,"Zanesville, OH",2001,25,82,107,84789,1.26195614997228
49780,"Zanesville, OH",2002,12,105,117,85247,1.37248231609323
49780,"Zanesville, OH",2003,12,58,70,85418,0.819499402936149
49780,"Zanesville, OH",2004,37,84,121,85589,1.41373307317529
49780,"Zanesville, OH",2005,2,80,82,85696,0.956870799103809
49780,"Zanesville, OH",2006,2,63,65,86023,0.755611871243737
49780,"Zanesville, OH",2007,55,62,117,85939,1.36143078229907
49780,"Zanesville, OH",2008,8,150,158,85874,1.83990497705941
49780,"Zanesville, OH",2009,1,66,67,85779,0.781076953566724
49780,"Zanesville, OH",2010,2,28,30,86213,0.347975363344275
49780,"Zanesville, OH",2011,2,40,42,86236,0.487035576789276
49780,"Zanesville, OH",2012,36,48,84,85786,0.979180752104073
49780,"Zanesville, OH",2013,36,36,72,85640,0.840728631480616
49780,"Zanesville, OH",2014,3,47,50,85900,0.582072176949942
49780,"Zanesville, OH",2015,15,64,79,86174,0.91674983173579
49780,"Zanesville, OH",2016,30,2,32,85973,0.372209879845998
49780,"Zanesville, OH",2017,58,6,64,86148,0.742907554441194
49780,"Zanesville, OH",2018,22,11,33,86183,0.382906141582447
NA,Non-Metropolitan,1990,34910,6711,41621,16831541,2.47279794523864
NA,Non-Metropolitan,1991,35449,5843,41292,17101360,2.41454480813222
NA,Non-Metropolitan,1992,40246,6969,47215,17236261,2.73928318908608
NA,Non-Metropolitan,1993,42039,7820,49859,17401597,2.86519679774218
NA,Non-Metropolitan,1994,46058,8790,54848,17469148,3.1397066416748
NA,Non-Metropolitan,1995,44813,6849,51662,17602271,2.93496219891172
NA,Non-Metropolitan,1996,46373,7759,54132,17713310,3.05600703651661
NA,Non-Metropolitan,1997,46420,8281,54701,17777453,3.07698746271471
NA,Non-Metropolitan,1998,48964,8665,57629,17821828,3.23361890822872
NA,Non-Metropolitan,1999,51396,7426,58822,17849622,3.29541992541915
NA,Non-Metropolitan,2000,50603,6964,57567,18201393,3.16277990371396
NA,Non-Metropolitan,2001,51465,6611,58076,18167272,3.19673751788381
NA,Non-Metropolitan,2002,54699,6251,60950,18186018,3.35147584259512
NA,Non-Metropolitan,2003,56330,5944,62274,18269774,3.40858075201149
NA,Non-Metropolitan,2004,64436,6098,70534,18382850,3.83694584898424
NA,Non-Metropolitan,2005,65631,6072,71703,18424605,3.89169808525067
NA,Non-Metropolitan,2006,58513,6025,64538,18489823,3.49046067125683
NA,Non-Metropolitan,2007,47466,5283,52749,18531808,2.84640332988557
NA,Non-Metropolitan,2008,32422,4197,36619,18560650,1.97293737018908
NA,Non-Metropolitan,2009,23209,2482,25691,18558733,1.3843078619645
NA,Non-Metropolitan,2010,21457,2777,24234,18572301,1.30484639463898
NA,Non-Metropolitan,2011,19219,3234,22453,18529088,1.21177037963228
NA,Non-Metropolitan,2012,20672,3700,24372,18458711,1.32035221744357
NA,Non-Metropolitan,2013,21515,3810,25325,18420844,1.37480128489227
NA,Non-Metropolitan,2014,22220,5742,27962,18371992,1.521990647503
NA,Non-Metropolitan,2015,24092,4272,28364,18389234,1.54242422495684
NA,Non-Metropolitan,2016,25555,4008,29563,18344235,1.6115689752121
NA,Non-Metropolitan,2017,27673,4017,31690,18335954,1.72829840214477
NA,Non-Metropolitan,2018,29027,3967,32994,18335777,1.79943287922841
